AppID,Name,Positive_ratings,Negative_ratings,Price,Rating_difference
263380,Driftmoon,223,28,14.99,195
263340,Continue?9876543210,97,78,9.99,19
262550,Gunman Clive,656,86,1.99,570
264320,Captain Morgane and the Golden Turtle,102,66,4.99,36
263680,Unearthed: Trail of Ibn Battuta - Episode 1 - Gold Edition,429,380,4.99,49
252150,Grimm,30690,912,0.0,29778
237950,UFO: Afterlight,285,164,6.99,121
246420,Kingdom Rush  - Tower Defense,9511,288,9.99,9223
251810,Leadwerks Game Engine,252,90,49.99,162
264730,Deadly 30,1264,399,0.99,865
264240,CONSORTIUM,1082,427,9.99,655
260650,Cold War,157,79,4.99,78
235460,METAL GEAR RISING: REVENGEANCE,46628,2181,29.99,44447
267670,Realms of Arkania 1 - Blade of Destiny Classic,70,32,0.99,38
263400,War of the Human Tanks,450,72,9.99,378
270760,Realms of Arkania 3 - Shadows over Riva Classic,48,14,0.99,34
263360,3089 -- Futuristic Action RPG,385,159,6.99,226
270750,Realms of Arkania 2 - Star Trail Classic,40,11,0.99,29
262770,Freedom Fall,354,29,9.99,325
94400,Nidhogg,6458,774,9.99,5684
237990,The Banner Saga,12728,1551,24.99,11177
260210,Assassin’s Creed® Liberation HD,1254,1112,19.99,142
257970,Loren The Amazon Princess,455,100,19.99,355
267920,Gun Metal,736,190,2.99,546
267900,Guilty Gear Isuka,207,192,9.99,15
245050,SpellForce 2 - Demons of the Past,135,139,19.99,-4
261740,Humans Must Answer,37,22,4.99,15
255370,KickBeat Steam Edition,504,252,9.99,252
247430,Hitman: Contracts,1835,277,8.99,1558
249650,Blackguards,2122,1301,0.99,821
222880,Insurgency,113659,10261,14.99,103398
257630,Blast Em!,136,161,0.0,-25
263560,Paper Sorcerer,474,127,4.99,347
267940,Glacier 3: The Meltdown,122,328,2.99,-206
267960,Hyper Fighters,100,322,2.99,-222
238750,Might & Magic X - Legacy,1949,1016,29.99,933
272040,KAMI,1112,48,3.99,1064
259640,Guise Of The Wolf,77,133,2.99,-56
270850,Car Mechanic Simulator 2014,4023,832,6.99,3191
264460,A-Men,25,28,9.99,-3
235320,Original War,1610,91,4.99,1519
263200,Signs of Life,608,154,9.99,454
232790,Broken Age,6169,1220,14.99,4949
269610,Arcane Worlds,112,111,9.99,1
246700,Strike Vector,1517,726,0.0,791
269150,Luxuria Superbia,176,72,6.99,104
262790,Our Darker Purpose,591,129,14.99,462
249570,The Castle Doctrine,188,189,3.99,-1
269210,Hero Siege,24997,8181,6.99,16816
263320,Saturday Morning RPG,389,115,6.99,274
272060,Serena,4875,1431,0.0,3444
271550,Tribloos 2,235,45,4.99,190
253790,rymdkapsel,199,41,7.99,158
267130,Star Swarm Stress Test,285,30,0.0,255
224480,Octodad: Dadliest Catch,8199,575,14.99,7624
267980,Hostile Waters: Antaeus Rising,304,96,2.99,208
270950,Ski Region Simulator - Gold Edition,358,85,8.99,273
271500,Sniper Art of Victory,510,1207,2.99,-697
269230,Aces Wild: Manic Brawling Action!,266,74,9.99,192
269430,Burning Cars,4,34,5.99,-30
275350,Sentinel 3: Homeworld,101,22,6.99,79
263880,Aqua Kitty - Milk Mine Defender,404,59,6.99,345
253430,CastleMiner Z,7382,2006,3.99,5376
219700,Dogs of War Online,449,251,0.0,198
237890,Agarest: Generations of War,1295,513,14.99,782
268890,Masters of the World - Geopolitical Simulator 3,258,320,34.99,-62
259740,Nightmares from the Deep: The Cursed Heart,1432,132,0.0,1300
271860,Super Killer Hornet: Resurrection,502,299,4.99,203
262260,Jets'n'Guns Gold,1192,170,6.99,1022
252010,Oniken: Unstoppable Edition,688,154,4.99,534
244430,realMyst: Masterpiece Edition,1124,148,17.99,976
263420,Probably Archery,173,207,4.99,-34
262690,Little Racers STREET,851,178,5.99,673
262450,Dead Man's Draw,495,94,6.99,401
252350,Double Dragon: Neon,1794,528,9.99,1266
236130,Horizon,264,187,29.99,77
254880,MoonBase Commander,134,15,5.99,119
266330,Ethan: Meteor Hunter,140,89,9.99,51
250260,Jazzpunk: Director's Cut,5733,455,14.99,5278
267530,The LEGO® Movie - Videogame,3178,515,19.99,2663
272010,Aveyond 3-1: Lord of Twilight,93,47,9.99,46
268670,The Memory of Eldurim,100,142,0.99,-42
269370,Reaper - Tale of a Pale Swordsman,288,136,5.99,152
269270,LOVE,1019,103,2.99,916
236510,Takedown: Red Sabre,2276,3332,4.99,-1056
273570,Descent,368,10,9.99,358
275290,Graviteam Tactics: Operation Star,367,76,29.99,291
273770,Game Tycoon 1.5,100,552,0.49,-452
259870,OMG Zombies!,301,71,4.99,230
270090,//N.P.P.D. RUSH//- The milk of Ultraviolet,254,515,3.99,-261
265380,Grimind,174,95,9.99,79
269470,MorphVOX Pro 4 - Voice Changer (Old),328,257,39.99,71
270790,Etherlords II,325,66,4.99,259
268260,Let's Sing,74,76,2.99,-2
265690,NaissanceE,2237,441,0.0,1796
269570,Gamer To Game Developer Series 1: More Than a Gamer,71,19,24.99,52
270770,Etherlords,84,117,4.99,-33
263300,BlazBlue: Calamity Trigger,2448,399,1.49,2049
271820,Card City Nights,835,106,4.99,729
224040,LocoCycle,242,64,9.99,178
263460,Girls Like Robots,176,75,6.99,101
250180,METAL SLUG 3,6595,763,7.99,5832
257870,Eschalon: Book III,58,19,9.99,39
10270,Disciples III: Reincarnation,1060,414,9.99,646
261960,Cube & Star: An Arbitrary Love,81,54,4.99,27
250600,The Plan,20311,1707,0.0,18604
252430,Dusty Revenge:Co-Op Edition,82,131,14.99,-49
259810,Home Sheep Home: Farmageddon Party Edition,179,10,9.99,169
261680,Journal,267,75,9.99,192
262980,C-RUSH,24,81,1.99,-57
264160,WazHack,581,74,9.99,507
39210,FINAL FANTASY XIV Online,51918,6493,19.99,45425
275830,7 Wonders: Magical Mystery Tour,93,10,6.99,83
253750,Ikaruga,1836,106,9.99,1730
274480,Drox Operative,274,31,19.99,243
275810,7 Wonders of the Ancient World,115,45,6.99,70
242920,Banished,34544,3737,19.99,30807
271900,Hexcells Plus,2061,122,2.99,1939
209060,Drunken Robot Pornography,546,101,7.49,445
264280,99 Levels To Hell,362,225,4.99,137
265890,Hexcells,4820,164,0.89,4656
273580,Descent 2,108,7,9.99,101
235210,STRIDER™ / ストライダー飛竜®,2747,555,14.99,2192
271640,Humanity Asset,149,336,1.99,-187
261720,Holy Avatar vs. Maidens of the Dead,82,61,0.99,21
263820,EvilQuest,563,76,1.99,487
278460,Skyborn,1436,218,14.99,1218
274130,Rambo The Video Game + Baker Team DLC,320,233,0.0,87
246800,BeatBlasters III,33,51,9.99,-18
251870,Go! Go! Nippon! ~My First Trip to Japan~,2684,413,4.99,2271
278890,Angvik,2075,289,2.99,1786
269290,liteCam Game: 100 FPS Game Capture,267,263,14.99,4
233350,Sudeki,680,98,5.99,582
264340,Major Mayhem,230,47,4.99,183
279160,Ultionus: A Tale of Petty Revenge,203,106,6.99,97
277590,Assassin's Creed Freedom Cry,1417,443,14.99,974
265610,Epic Battle Fantasy 4,2695,92,11.99,2603
247000,Talisman: Digital Edition,6029,1681,6.99,4348
239250,Castlevania: Lords of Shadow 2,3609,674,39.99,2935
236470,PAC-MAN MUSEUM™,167,98,0.0,69
273940,Warehouse and Logistics Simulator,100,172,0.99,-72
262080,Iron Soul,11,50,4.99,-39
266250,Procyon,104,14,3.99,90
269030,The Yawhg,1106,240,9.99,866
239160,Thief,15660,5510,19.99,10150
258760,Scania Truck Driving Simulator,1296,329,9.99,967
254700,Resident Evil 4,43939,4257,19.99,39682
266210,One Way Heroics,3659,224,3.49,3435
266290,Helicopter Simulator 2014: Search and Rescue,113,231,6.99,-118
262590,Chuck's Challenge 3D 2020,172,24,9.99,148
213670,South Park™: The Stick of Truth™,49611,1235,29.99,48376
264200,One Finger Death Punch,15610,313,4.99,15297
262150,Vanguard Princess,2014,841,2.49,1173
266110,Tower of Guns,916,219,14.99,697
277910,Mars Colony:Challenger,78,44,4.99,34
273820,Mining & Tunneling Simulator,27,104,1.99,-77
271670,10 Second Ninja,630,106,1.99,524
277870,Diehard Dungeon,352,118,1.99,234
251390,Call of Cthulhu: The Wasted Land,131,63,0.0,68
283290,Nosferatu: The Wrath of Malachi,2311,345,2.99,1966
283390,Incoming Forces,176,149,2.99,27
278930,GIGANTIC ARMY,257,79,5.99,178
204530,Infested Planet,2526,165,14.99,2361
277270,Return to Mysterious Island 2,102,52,1.19,50
277110,Return to Mysterious Island,270,56,7.99,214
269050,Year Walk,1722,168,5.99,1554
257790,Riptide GP2,409,48,6.99,361
262490,Manga Maker Comipo,540,165,49.99,375
275080,Post Master,123,162,4.99,-39
263620,Mitsurugi Kamui Hikae,2582,636,9.99,1946
254460,Obscure,1548,76,6.99,1472
254480,Obscure II (Obscure: The Aftermath),658,158,9.99,500
214550,Eets Munchies,572,136,6.99,436
280640,Dark Shadows - Army of Evil,85,189,4.99,-104
255280,1954 Alcatraz,1049,390,0.99,659
270310,Dominique Pamplemousse,319,105,0.99,214
273760,Towtruck Simulator 2015,51,252,1.99,-201
266170,Windforge,395,190,9.99,205
251470,TowerFall Ascension,2795,155,14.99,2640
251510,Constant C,44,6,9.99,38
285520,Sledgehammer / Gear Grinder,93,32,7.99,61
268400,Panzer Corps Gold,1997,173,29.99,1824
261880,Corporate Lifestyle Simulator,535,110,4.99,425
275570,Summoner,340,72,4.99,268
263500,Dragons and Titans,2681,754,0.0,1927
266230,Last Dream,412,80,9.99,332
281390,ORB,71,20,4.99,51
283310,Soulbringer,134,88,2.99,46
283410,CT Special Forces: Fire for Effect,129,106,2.99,23
281430,Clans,78,52,0.59,26
286810,Hard Truck Apocalypse: Rise Of Clans / Ex Machina: Meridian 113,514,176,5.99,338
277470,The Book of Legends,179,84,9.99,95
284290,Farm Machines Championships 2014,47,73,0.0,-26
285500,Hard Truck Apocalypse / Ex Machina,1720,333,7.99,1387
286830,Hard Truck Apocalypse: Arcade / Ex Machina: Arcade,57,144,4.99,-87
266010,LYNE,7589,328,2.99,7261
285800,Braveland,2355,512,6.99,1843
258180,Deus Ex: The Fall,1427,2610,9.99,-1183
265870,Alpha Kimori™ 1,126,90,9.99,36
267220,Line Of Defense Tactics - Tactical Advantage,1,18,9.99,-17
270330,Ku: Shroud of the Morrigan,23,65,4.99,-42
280560,Danmaku Unlimited 2,403,27,4.99,376
281260,Desert Gunner,30,37,2.99,-7
233150,LUFTRAUSERS,3791,361,9.99,3430
274560,Revolution Ace,1384,536,4.99,848
280500,KRUNCH,34,16,9.99,18
283330,Desert Thunder,97,141,2.99,-44
283430,Litil Divil,202,232,2.99,-30
274980,Influent,1097,375,0.0,722
283880,Heroine's Quest: The Herald of Ragnarok,1112,153,0.0,959
251210,Hive,235,31,9.99,204
262390,Cloudbuilt,749,130,19.99,619
283000,Strategic War in Europe,67,90,1.49,-23
283490,IHF Handball Challenge 12,45,29,2.99,16
252230,YAIBA: NINJA GAIDEN Z,501,274,29.99,227
266130,Breach & Clear,1930,413,14.99,1517
269350,Montas,64,98,9.99,-34
255340,Escape Goat 2,377,18,9.99,359
243120,Betrayer,2998,669,0.0,2329
209160,Call of Duty®: Ghosts,17030,10793,59.99,6237
270050,Quest of Dungeons,517,162,4.99,355
281410,Ubersoldier II,340,118,0.99,222
279420,Gardens Inc. – From Rakes to Riches,73,10,9.99,63
209170,Call of Duty®: Ghosts,15087,10789,59.99,4298
218820,Mercenary Kings: Reloaded Edition,1659,692,19.99,967
281820,Explodemon,63,34,0.89,29
265950,Ether One,312,109,19.99,203
276360,Riding Star - Horse Championship!,59,28,9.99,31
280220,Creeper World 3: Arc Eternal,3944,143,14.99,3801
265240,Crazy Machines: Golden Gears,9,22,9.99,-13
282530,Castlevania: Lords of Shadow – Mirror of Fate HD,1407,284,14.99,1123
276340,My Riding Stables: Life with Horses,171,29,14.99,142
269810,Spate,260,106,0.0,154
276240,My Vet Practice - In the Country,16,7,14.99,9
281860,RefleX,183,24,7.99,159
252050,Construction Machines 2014,36,275,6.99,-239
265990,Rogue's Tale,428,167,6.99,261
256370,MXGP - The Official Motocross Videogame,1044,280,9.99,764
277930,TUG,357,638,0.0,-281
278530,3 Stars of Destiny,126,86,14.99,40
264540,Platformines,198,106,0.99,92
270550,Yet Another Zombie Defense,10433,1620,0.0,8813
235340,Prime World,2215,1592,0.0,623
226840,Age of Wonders III,9041,2221,7.49,6820
260570,Gray Matter,562,64,9.99,498
269490,Bardbarian,1291,165,7.99,1126
281370,Real Horror Stories Ultimate Edition,497,781,1.99,-284
265930,Goat Simulator,53579,5950,9.99,47629
267490,Batman™: Arkham Origins Blackgate - Deluxe Edition,840,1217,19.99,-377
286460,Black Mirror II,439,49,9.99,390
282880,FaeVerse Alchemy,215,113,0.0,102
227560,Scourge: Outbreak,350,192,5.99,158
286480,Black Mirror III,342,37,9.99,305
289280,El Matador,271,120,3.99,151
289440,Perimeter,160,33,3.99,127
283370,Marine Sharpshooter II: Jungle Warfare,177,382,2.99,-205
284710,Abyss: The Wraiths of Eden,1182,122,9.99,1060
289340,Freight Tycoon Inc.,211,192,4.99,19
289380,Konung 3: Ties of the Dynasty,62,26,0.59,36
288040,Actual Sunlight,415,137,4.99,278
240970,Half Minute Hero: The Second Coming,488,41,9.99,447
289600,Marauder,433,169,9.99,264
286320,Oknytt,480,40,4.99,440
287020,Harvester,905,88,5.99,817
277430,Halo: Spartan Assault,3354,865,2.99,2489
269110,Super Motherload,539,165,14.99,374
291290,Motte Island,66,17,4.99,49
283560,Munich Bus Simulator,155,117,14.99,38
286660,Avoid - Sensory Overload,174,32,4.99,142
285160,LEGO® The Hobbit™,6394,1543,19.99,4851
288370,Strike Suit Zero: Director's Cut,266,62,19.99,204
288840,Haunted Past: Realm of Ghosts,124,29,4.99,95
205990,Warlock 2: The Exiled,781,345,19.99,436
277450,Imperial Glory,838,252,4.99,586
258590,Adventure Time: Finn and Jake's Epic Quest,331,122,9.99,209
280910,T.E.C. 3001,350,41,0.0,309
289620,Collapse,520,201,19.99,319
267340,Beware Planet Earth,200,87,9.99,113
291450,Smugglers 5,87,65,9.99,22
277460,Praetorians,467,115,4.99,352
290280,Volt,265,120,0.99,145
280200,Eterium,45,48,0.0,-3
273590,Descent 3,52,25,9.99,27
292670,Princess Isabella - Return of the Curse,71,22,4.99,49
292660,Princess Isabella,104,35,0.74,69
249550,NEStalgia,229,128,9.99,101
264520,Moebius: Empire Rising,228,74,14.99,154
268240,Mechanic Escape,667,111,4.99,556
263740,FootLOL: Epic Soccer League,878,166,9.99,712
289500,UFO: Aftershock,139,46,3.99,93
287070,Battle Academy,236,41,14.99,195
286200,ReignMaker,201,117,14.99,84
289300,Faces of War,778,103,4.99,675
289420,Planet Alcatraz,416,83,3.99,333
289400,Parkan 2,219,90,3.99,129
280830,Foosball - Street Edition,127,52,4.99,75
292060,Titanfall - The Final Hours,100,189,0.99,-89
286540,Nearwood - Collector's Edition,248,26,9.99,222
289260,Dreamscapes: The Sandman - Premium Edition,183,37,6.99,146
289800,Dracula: The Resurrection,187,213,0.54,-26
276890,FATE: Undiscovered Realms,249,70,7.99,179
251060,Wargame: Red Dragon,14379,1750,29.99,12629
289820,Dracula 2: The Last Sanctuary,63,154,0.54,-91
283960,Pajama Sam: No Need to Hide When It's Dark Outside,940,21,6.99,919
246680,Secrets of Rætikon,277,183,9.99,94
282760,Circuits,1848,224,4.99,1624
284000,Putt-Putt® and Pep's Balloon-o-Rama,62,11,4.99,51
293420,Heldric - The legend of the shoemaker,31,17,0.0,14
283980,Spy Fox in Dry Cereal,403,18,6.99,385
263540,Villagers and Heroes,1905,1283,0.0,622
284020,Freddi Fish and Luther's Maze Madness,50,12,4.99,38
283940,Freddi Fish and the Case of the Missing Kelp Seeds,503,17,6.99,486
271570,Space Farmers,1367,468,9.99,899
260130,Agarest: Generations of War Zero,266,87,19.99,179
284950,Pixel Puzzles: Japan,2019,453,0.0,1566
283920,Putt-Putt® Joins the Parade,243,15,6.99,228
250050,Life Goes On: Done to Death,2167,88,12.99,2079
289840,Dracula 3: The Path of the Dragon,71,146,7.99,-75
291030,Always Remember Me,161,106,8.99,55
282400,SuperPower 2 Steam Edition,1866,467,9.99,1399
286120,QuestRun,429,375,2.99,54
293180,Overcast - Walden and the Werewolf,1661,1078,0.51,583
294230,Millie,563,131,3.99,432
283180,The Samaritan Paradox,145,54,4.99,91
278490,Aveyond 3-2: Gates of Night,66,41,9.99,25
273070,The Last Federation,361,114,19.99,247
243220,FRACT OSC,482,82,14.99,400
291270,Vitrum,30,40,1.99,-10
283270,Jagged Alliance 1: Gold Edition,274,74,9.99,200
289360,Konung 2,130,27,0.59,103
295990,Evopollution,35,90,4.99,-55
289460,RC Cars,273,89,2.99,184
289200,Ascension to the Throne,416,55,2.99,361
286520,Viking Brothers,29,13,9.99,16
292160,UFO: Aftermath,182,48,3.99,134
291190,Heroes of Steel RPG,197,55,9.99,142
289220,BorderZone,39,59,2.99,-20
297570,Warrior Kings,69,30,9.99,39
284830,Clockwork Tales: Of Glass and Ink,957,86,9.99,871
297620,Rocko's Quest,34,24,4.99,10
252570,Depths of Fear :: Knossos,273,143,0.0,130
295770,Rogue Shooter: The FPS Roguelike,271,91,4.99,180
245490,Trials Fusion™,1413,641,19.99,772
264080,Vangers,810,68,6.99,742
281280,Mashed,348,95,4.99,253
287720,Nostradamus: The Last Prophecy,130,54,0.99,76
292390,Realms of the Haunting,347,105,2.99,242
292410,Street Racing Syndicate,2806,550,2.99,2256
236930,Blackwell Epiphany,724,15,9.99,709
207230,ArcheBlade™,5673,2071,0.0,3602
286340,FarSky,2868,990,0.0,1878
283660,Rabbit Hole 3D: Steam Edition,199,115,2.99,84
296240,The Promised Land,587,97,0.69,490
275490,Canyon Capers,862,1054,6.99,-192
275470,Chip,943,190,1.49,753
236430,DARK SOULS™ II,35161,4391,39.99,30770
280140,Millennium - A New Hope,286,99,5.99,187
280930,Battlepillars Gold Edition,275,43,4.99,232
281240,Adventure Chronicles: The Search For Lost Treasure,54,31,4.99,23
256290,Child of Light,11491,921,14.99,10570
296220,Farm Frenzy 4,292,73,1.04,219
230840,Daylight,778,765,4.99,13
296210,Brigade E5: New Jagged Union,73,34,3.99,39
281220,BloodRayne Betrayal (Legacy),525,339,0.0,186
250640,[Old Edition] Croixleur Sigma,271,68,0.0,203
279500,Nicolas Eymerich - The Inquisitor - Book 1 : The Plague,58,34,4.99,24
289890,"7,62 High Calibre",305,93,4.99,212
294710,Putt-Putt® and Pep's Dog on a Stick,44,6,4.99,38
264220,Mr. Bree+,193,34,2.99,159
292780,Pajama Sam 2: Thunder And Lightning Aren't So Frightening,239,6,6.99,233
242720,GunZ 2: The Second Duel,7013,3576,0.0,3437
287100,Chaos Domain,259,576,4.99,-317
294530,Freddi Fish 2: The Case of the Haunted Schoolhouse,230,6,6.99,224
266050,Into the Dark: Ultimate Trash Edition,97,125,4.99,-28
274880,Jet Car Stunts,114,42,2.99,72
294770,Haegemonia: Legions of Iron,45,24,4.99,21
292240,Spy Fox 2 Some Assembly Required,137,11,6.99,126
293680,Cinders,660,98,19.99,562
242880,"Sir, You Are Being Hunted",2960,841,19.99,2119
277500,Farming World,117,183,4.99,-66
291130,Akane the Kunoichi,351,374,2.99,-23
283350,Eurofighter Typhoon,50,160,2.99,-110
291050,Planet Stronghold,60,41,18.99,19
358260,Crystal Caves,90,16,4.99,74
358180,Bio Menace,47,9,0.0,38
358350,Secret Agent,78,14,4.99,64
358400,Shadow Warrior (Classic),22,10,0.0,12
298180,The Desolate Hope,1099,101,0.0,998
358410,Rise of the Triad: Dark War,82,13,6.99,69
358170,Arctic Adventure,27,20,0.0,7
296910,8BitBoy™,1405,511,6.99,894
358270,Death Rally (Classic),449,48,0.0,401
358370,Terminal Velocity,57,8,6.99,49
358390,Stargunner,82,16,0.0,66
294650,Putt-Putt® Goes to the Moon,169,14,6.99,155
358200,Math Rescue,44,11,4.99,33
358250,Cosmo's Cosmic Adventure,85,16,4.99,69
358340,Word Rescue,47,21,4.99,26
358290,Hocus Pocus,104,19,4.99,85
358380,Wacky Wheels,99,27,4.99,72
299070,Warrior Kings: Battles,210,19,9.99,191
264060,Full Bore,189,35,14.99,154
286100,You Have to Win the Game,5200,390,0.0,4810
268540,The Whispered World Special Edition,1235,398,1.99,837
295730,Sweezy Gunner,186,41,3.99,145
225600,Blade Symphony,3112,1617,0.0,1495
273600,Descent: FreeSpace – The Great War,153,40,9.99,113
251630,The Impossible Game,1053,187,2.99,866
299110,Theatre Of The Absurd,197,49,4.99,148
266840,Age of Mythology: Extended Edition,23722,2090,29.99,21632
290970,1849,244,94,14.99,150
243930,Bound By Flame,2293,1083,6.99,1210
295930,Swipecart,243,289,2.99,-46
296180,Iron Storm,82,50,0.53,32
225280,Full Mojo Rampage,1032,188,6.49,844
286440,Rover Rescue,42,75,0.0,-33
261510,Tesla Effect: A Tex Murphy Adventure,1039,152,19.99,887
297020,The Culling Of The Cows,2485,866,4.99,1619
296850,Al Emmo and the Lost Dutchman's Mine,34,24,9.99,10
296530,Coldfire Keep,45,63,3.99,-18
252690,Fantasy Grounds Classic,975,235,39.99,740
244410,Supreme Ruler 1936,197,72,9.99,125
265630,Fistful of Frags,30718,2907,0.0,27811
266490,Lili: Child of Geos - Complete Edition,828,132,14.99,696
269330,Chronology,673,97,4.99,576
285420,Deadly Sin 2,91,16,4.99,75
293320,Coma: Mortuary,481,424,5.99,57
260160,The Last Tinker™: City of Colors,689,165,1.19,524
287200,Wildlife Park 3,289,204,9.99,85
296930,Ascendant,158,44,0.0,114
237970,Memento Mori 2,83,31,24.99,52
278080,DYNASTY WARRIORS 8: Xtreme Legends Complete Edition,9026,1682,49.99,7344
252550,Qbeh-1: The Atlas Cube,585,79,9.99,506
282100,Fearless Fantasy,792,260,6.99,532
268520,Orc Attack: Flatulent Rebellion,34,32,9.99,2
298140,Rhiannon: Curse of the Four Branches,83,46,4.99,37
294540,Freddi Fish 3: The Case of the Stolen Conch Shell,230,13,6.99,217
292800,Pajama Sam 3: You Are What You Eat From Your Head To Your Feet,284,8,6.99,276
284790,Nightmares from the Deep 2: The Siren`s Call,800,35,0.0,765
238460,BattleBlock Theater®,63907,1802,14.99,62105
227060,Hegemony Rome: The Rise of Caesar,261,173,14.99,88
294670,Putt-Putt® Travels Through Time,246,18,6.99,228
292260,Spy Fox 3 Operation Ozone,98,13,6.99,85
294720,Putt-Putt® and Fatty Bear's Activity Pack,72,15,4.99,57
244450,Men of War: Assault Squad 2,31410,3179,29.99,28231
269790,DreadOut,3534,1101,14.99,2433
301150,The Treasures of Montezuma 4,438,90,6.99,348
300540,Sweet Lily Dreams,73,67,14.99,6
290990,Flower Shop: Summer In Fairbrook,84,39,9.99,45
290460,Legionwood 2: Rise of the Eternal's Realm - Director's Cut,27,22,5.99,5
284930,Speed Kills,200,206,4.99,-6
301750,RADical ROACH Remastered,578,499,0.0,79
277510,Shiny The Firefly,65,44,0.99,21
292570,Chompy Chomp Chomp,390,164,1.99,226
279520,Rage Runner,26,25,4.99,1
248570,Toribash,13665,1740,0.0,11925
301190,Frederic: Resurrection of Music,789,151,2.99,638
292420,Panzer Elite Action Gold Edition,76,114,9.99,-38
293880,Dark Scavenger,198,30,4.99,168
282800,100% Orange Juice,21261,1598,1.74,19663
201810,Wolfenstein: The New Order,42568,4282,19.99,38286
266030,DRAKERZ-Confrontation,134,125,0.0,9
290040,Retro Game Crunch,321,83,9.99,238
279540,Pretentious Game,225,62,1.99,163
295250,Stranded,160,302,0.49,-142
300970,Fiesta Online NA,382,264,0.0,118
237930,Transistor,27006,1594,19.99,25412
284390,The Last Door - Collector's Edition,1878,105,9.99,1773
299420,CubeGun,185,131,0.0,54
239430,Q.U.B.E: Director's Cut,1438,285,2.49,1153
262410,World of Guns: Gun Disassembly,14480,2823,0.0,11657
291910,Firefighters 2014,328,228,24.99,100
255390,Max: The Curse of Brotherhood,1237,66,14.99,1171
274310,Always Sometimes Monsters,1773,602,9.99,1171
300220,Victim of Xen,267,172,9.99,95
263760,Turbo Dismount™,4685,358,9.99,4327
285310,RollerCoaster Tycoon®: Deluxe,5678,338,5.99,5340
285330,RollerCoaster Tycoon® 2: Triple Thrill Pack,3799,476,9.99,3323
302490,Ballad of Solar,157,24,6.99,133
296650,The Great Jitters: Pudding Panic,48,26,4.99,22
9940,Blade Kitten,830,176,2.99,654
268200,Antisquad,154,132,5.99,22
275610,"Warhammer 40,000: Kill Team",599,469,0.0,130
302460,I Am Vegend - Zombiegeddon,34,42,1.99,-8
301260,Gardens Inc. 2: The Road to Fame,45,6,9.99,39
289180,A.I.M.2 Clan Wars,342,94,2.99,248
289240,Perimeter: Emperor's Testament,24,12,3.99,12
277630,Panzer Tactics HD,137,51,9.99,86
293860,White Noise Online,441,227,4.99,214
245620,Tropico 5,10395,2877,19.99,7518
294140,They Breathe,1036,195,1.99,841
301690,Cobi Treasure Deluxe,188,178,2.99,10
261110,Killer is Dead - Nightmare Edition,5828,1891,19.99,3937
301200,Frederic: Evil Strikes Back,658,121,7.99,537
292230,Game Character Hub,218,97,14.99,121
272990,GAUGE,154,85,3.99,69
301700,Numba Deluxe,164,95,2.99,69
261470,Distant Worlds: Universe,1295,400,29.99,895
95400,ibb & obb,5064,469,11.99,4595
243470,Watch_Dogs™,24247,8758,29.99,15489
288270,liteCam HD 5.0: Screen/Stream Capture,33,42,19.99,-9
239120,Final Fantasy III (3D Remake),2205,467,15.99,1738
265830,Monochroma,514,176,19.99,338
293940,Kill The Bad Guy,214,129,9.99,85
278360,A Story About My Uncle,25589,2277,14.99,23312
293920,Spirited Heart Deluxe,35,41,19.99,-6
294750,Anomaly Defenders,403,107,1.99,296
244950,Where is my Heart?,132,38,7.99,94
294680,Putt-Putt® Enters the Race,140,6,6.99,134
279560,Dracula 4 and  5 - Special Steam Edition,73,50,7.99,23
294690,Putt-Putt® Joins the Circus,67,10,6.99,57
292820,Pajama Sam 4: Life Is Rough When You Lose Your Stuff!,47,75,6.99,-28
250620,Among the Sleep - Enhanced Edition,5446,776,16.99,4670
288650,HTR+ Slot Car Simulation,34,20,6.99,14
294550,Freddi Fish 4: The Case of the Hogfish Rustlers of Briny Gulch,106,3,6.99,103
301670,Salammbô: Battle for Carthage,54,19,4.99,35
302470,Battle Mages,111,39,3.99,72
289090,Ampu-Tea,1277,762,4.99,515
295750,The Floor is Jelly,337,71,9.99,266
295630,Defense Zone 2,112,20,3.99,92
263080,Pixel Boy and the Ever Expanding Dungeon,160,75,0.0,85
281580,Wings Over Europe,59,43,1.99,16
296050,Battlepaths,587,257,2.99,330
283020,The Campaign Series: Fall Weiss,25,46,1.49,-21
290770,The Fall,3094,416,9.99,2678
287580,Pandora: First Contact,372,219,29.99,153
302250,Manhunter,232,515,0.0,-283
299500,International Snooker,367,221,5.99,146
283680,Astebreed: Definitive Edition,1295,170,19.99,1125
287860,8-Bit Commando,176,140,1.99,36
260790,1001 Spikes,561,122,14.99,439
233290,Murdered: Soul Suspect,12690,2184,19.99,10506
253710,theHunter Classic,20447,16976,0.0,3471
301220,Legends of Persia,22,151,19.99,-129
302080,Bus Driver,1462,381,7.99,1081
293720,Dark Raid,29,107,3.99,-78
281920,Splatter - Zombiecalypse Now,2035,224,6.99,1811
302060,Trucks & Trailers,310,148,4.99,162
224600,Defiance,9674,2994,0.0,6680
299840,Metal Planet,13,42,0.0,-29
299780,Noir Syndrome,117,60,4.99,57
279260,Richard & Alice,290,105,5.99,185
205090,BIT.TRIP FLUX,78,77,0.0,1
268220,Meltdown,678,119,6.99,559
306200,The Happy Hereafter,290,80,3.99,210
247730,Nether: Resurrected,7101,10182,0.0,-3081
284770,Enigmatis 2: The Mists of Ravenwood,1283,38,9.99,1245
249610,Galactic Arms Race,41,39,2.99,2
270510,EPOCH,71,19,1.99,52
302380,Floating Point,3582,148,0.0,3434
302260,Truffle Saga,49,68,1.99,-19
285840,Enemy Mind,666,110,9.99,556
294570,Freddi Fish 5: The Case of the Creature of Coral Cove,106,9,6.99,97
261530,Lifeless Planet Premier Edition,2521,790,19.99,1731
287120,Ionball 2: Ionstorm,462,186,4.99,276
292840,Pajama Sam's Sock Works,47,6,4.99,41
302240,Chernobyl Commando,114,386,0.0,-272
298340,FLASHOUT 2,123,93,4.99,30
301300,Chicken Invaders 4,394,10,4.99,384
303340,Concursion,45,33,4.99,12
305390,World War 2: Time of Wrath,29,35,0.99,-6
301460,Electronic Super Joy: Groove City,457,108,4.99,349
116100,Super Toy Cars,217,161,9.99,56
292300,Spy Fox In: Hold the Mustard,13,18,4.99,-5
285440,Crimzon Clover WORLD IGNITION,1367,94,0.0,1273
294700,Putt-Putt®: Pep's Birthday Surprise,45,35,6.99,10
297750,Close Combat - Gateway to Caen,285,137,39.99,148
273620,Freespace 2,216,63,9.99,153
270630,Haunt the House: Terrortown,1254,208,4.99,1046
302950,Heileen 1: Sail Away,64,52,5.99,12
291710,The Lost Crown,331,72,9.99,259
285010,Pixel Puzzles: UndeadZ,629,224,4.99,405
292380,Racer 8,599,738,4.99,-139
292860,Pajama Sam's Lost & Found,18,10,4.99,8
303390,Dead Bits,4993,3459,0.51,1534
268750,Magicite,6321,1092,9.99,5229
286360,Shadows on the Vatican Act I: Greed,515,183,0.69,332
281750,Munin,676,139,0.54,537
270570,Reversion - The Escape (1st Chapter),1186,345,0.99,841
280680,Krita,2270,132,14.99,2138
256190,Enemy Front,3119,1675,19.99,1444
305780,Echo of the Wilds,137,42,6.99,95
262900,Smooth Operators,196,73,2.99,123
262830,Crimsonland,2353,202,13.99,2151
280460,Pulstar,64,48,1.99,16
305480,Heileen 2: The Hands Of Fate,23,20,9.99,3
297490,Spy Chameleon - RGB Agent,258,35,9.99,223
283600,World of Subways 2 – Berlin Line 7,169,57,9.99,112
287450,Rise of Nations: Extended Edition,10727,662,19.99,10065
302340,Tex Murphy: Martian Memorandum,33,12,5.99,21
302310,Dungeon of Elements,95,115,9.99,-20
291330,Final Slam 2,103,366,3.99,-263
302350,Tex Murphy: Under a Killing Moon,115,5,9.99,110
300300,Ichi,538,84,4.99,454
258070,Probability 0,48,16,6.99,32
277490,Battle Group 2,396,78,7.99,318
307760,Zoo Park,165,122,4.99,43
306410,Crystals of Time,651,356,0.99,295
302320,Storm over the Pacific,15,16,0.99,-1
297760,Qvadriga,316,62,19.99,254
275670,Space Run,1699,268,4.99,1431
272470,The Incredible Adventures of Van Helsing II,1585,726,14.99,859
296730,Viktor,159,64,7.99,95
307090,Fancy Skulls,224,85,8.99,139
280040,A Wizard's Lizard,305,132,9.99,173
266390,Farm for your Life,487,110,9.99,377
303790,Faery - Legends of Avalon,479,180,6.99,299
298400,Knightmare Tower,503,35,3.99,468
303470,Rush for Glory,92,48,14.99,44
301540,Rhythm Destruction,61,69,4.99,-8
223830,Xenonauts,3546,481,24.99,3065
307640,Stick RPG 2: Director's Cut,677,133,19.99,544
285480,The Entente Gold,267,321,1.99,-54
299540,Heroes Rise: The Prodigy,319,66,3.99,253
269250,WORLD END ECONOMiCA episode.01,564,101,12.99,463
304290,Heroes Rise: The Hero Project,133,31,4.99,102
292930,Black Mirror I,849,177,9.99,672
300320,The Few,93,90,7.99,3
256390,MotoGP™14,267,239,9.99,28
260309,Company of Heroes 2 - The Western Front Armies,160,27,0.0,133
216260,Don Bradman Cricket 14,607,74,19.99,533
260230,Valiant Hearts: The Great War™ / Soldats Inconnus : Mémoires de la Grande Guerre™,20709,941,14.99,19768
255220,GRID Autosport,6668,1897,0.0,4771
250760,Shovel Knight: Treasure Trove,13659,523,39.99,13136
238090,Sniper Elite 3,19115,4182,29.99,14933
230230,Divinity: Original Sin (Classic),10666,961,0.0,9705
283230,Spoiler Alert,903,303,2.99,600
293840,Cult of the Wind,219,219,9.99,0
262240,SUGURI,154,28,5.99,126
306490,Railroad Pioneer,139,91,4.99,48
284180,Magicians & Looters,110,13,2.99,97
274010,Ship Simulator: Maritime Search and Rescue,89,59,11.99,30
291480,Warface,52847,25146,0.0,27701
265170,Acceleration of SUGURI X-Edition HD,179,42,5.99,137
302790,Momodora III,1045,68,1.99,977
296770,Real Boxing™,796,457,4.99,339
237310,Elsword,6654,2250,0.0,4404
286770,Shadow Ops: Red Mercury,182,51,1.39,131
279990,Bridge Constructor Playground,151,70,1.49,81
305070,FIST OF AWESOME,207,131,0.0,76
301990,School Bus Fun,59,29,1.19,30
294660,Putt-Putt® Saves The Zoo,563,22,6.99,541
306040,The Howler,1616,466,0.0,1150
305640,Shattered Planet,414,190,14.99,224
11480,Soldiers: Heroes of World War II,501,82,4.99,419
311850,Zombie Solitaire,104,41,8.99,63
223490,Blockscape,413,468,9.99,-55
255960,Bad Mojo Redux,123,20,5.99,103
307130,Asteria,133,100,4.99,33
304670,Aeon Command,298,84,2.99,214
311080,Echelon,57,71,3.99,-14
306630,Civil War II,221,62,39.99,159
306680,Lexica,266,89,4.99,177
285130,Battleplan: American Civil War,137,149,9.99,-12
275530,Z,850,272,6.99,578
308460,War in a Box: Paper Tanks,136,56,4.99,80
307070,Memories of a Vagabond,941,228,0.54,713
241240,Contraption Maker,1057,99,9.99,958
252830,Claire,252,127,9.99,125
291390,Three Dead Zed,109,55,5.99,54
285960,Q*bert: Rebooted,106,63,0.0,43
281060,Reversion - The Meeting (2nd Chapter),138,45,0.54,93
292910,Deponia: The Complete Journey,5047,753,2.99,4294
252750,MouseCraft,246,28,9.99,218
307270,Super Lemonade Factory,22,21,0.99,1
288060,Whispering Willows,1221,267,9.99,954
305860,AutoTileGen,27,18,9.99,9
313740,Sakura Spirit,5684,1547,9.99,4137
281840,4PM,76,159,2.99,-83
313730,Sunrider: Mask of Arcadius,2540,198,0.0,2342
302730,Namariel Legends: Iron Lord Premium Edition,106,22,6.99,84
278640,Terrian Saga: KR-17,196,69,4.99,127
311800,Black Ice,516,25,19.99,491
298820,Millennium 2 - Take Me Higher,46,11,0.59,35
313020,Soul Gambler,2274,338,2.99,1936
284870,9 Clues: The Secret of Serpent Creek,1192,134,9.99,1058
302650,Cyto,72,22,3.99,50
308330,Lost Chronicles of Zerzura,91,13,9.99,78
264560,Quest for Infamy,166,31,9.99,135
302970,Radiant Defense,85,18,4.99,67
284200,Robot Rescue Revolution,39,18,4.99,21
300360,Evil Pumpkin: The Lost Halloween,54,35,9.99,19
312300,Heroes Rise: HeroFall,124,13,3.99,111
304500,Rooms: The Main Building,139,28,9.99,111
286930,Crouching Pony Hidden Dragon,27,54,1.99,-27
292180,X-Plane 10 Global - 64 Bit,713,304,0.0,409
271730,Light,197,143,12.99,54
279920,Infinity Runner,85,39,6.99,46
311190,Super Panda Adventures,827,42,4.99,785
312220,Tales of Adventure 2,14,27,9.99,-13
299050,Blood II: The Chosen + Expansion,204,212,4.99,-8
299030,Blood: One Unit Whole Blood,1203,118,0.0,1085
293900,Pivvot,207,23,4.99,184
255070,Abyss Odyssey,1520,915,14.99,605
313870,A Vampyre Story,99,57,19.99,42
313210,Alpha Zylon,103,61,4.99,42
312150,Wild Warfare,698,304,0.0,394
267730,Ground Pounders,17,28,4.99,-11
277890,Shantae: Risky's Revenge - Director's Cut,1126,182,9.99,944
246720,Wayward Manor,28,51,6.99,-23
313330,4x4 Dream Race,17,37,4.99,-20
255420,Magic 2015 - Duels of the Planeswalkers,1824,2215,0.0,-391
268850,EVGA Precision X1,3306,886,0.0,2420
303590,Hidden in Plain Sight,433,5,5.99,428
311040,Rulers of Nations,80,82,19.99,-2
310450,Steel & Steam: Episode 1,31,66,0.0,-35
302590,Of Guards And Thieves,3624,616,0.0,3008
310070,The Nightmare Cooperative,61,57,4.99,4
304350,Wildlife Park 2,340,142,6.99,198
307930,Wildlife Park 2 - Dino World,42,26,3.99,16
307900,Wildlife Park 2 - Marine World,26,11,3.99,15
306480,Wildlife Park 2 - Crazy Zoo,38,15,3.99,23
314280,The Forgotten Ones,959,617,0.0,342
307770,Wildlife Park 2 - Horses,55,17,3.99,38
260530,So Many Me,94,6,14.99,88
303840,Point Perfect,139,63,4.99,76
297290,Detective Case and Clown Bot in: Murder in the Hotel Lisbon,192,53,5.99,139
307990,Wildlife Park 2 - Fantasy,37,43,0.99,-6
307920,Wildlife Park 2 - Farm World,24,9,3.99,15
305490,Heileen 3: New Horizons,45,26,24.99,19
303910,Time of Fury,21,17,1.69,4
314290,Obludia,32,35,2.99,-3
292620,Pressured,268,274,2.99,-6
302170,The Cameron Files: The Secret at Loch Ness,42,27,2.99,15
314380,Lantern Forge,151,128,9.99,23
248310,Freedom Planet,4091,205,14.99,3886
311860,Data Hacker: Initiation,138,81,1.99,57
269890,AR-K,268,206,7.99,62
290260,Sokobond,470,35,9.99,435
253150,Halfway,620,213,12.99,407
274250,OlliOlli,658,176,12.99,482
307290,Velvet Sundown,1100,723,0.0,377
302270,Dungeon Defenders Eternity,800,799,0.0,1
308360,LogiGun,50,11,4.99,39
292400,Unrest,129,61,9.99,68
303860,Machines At War 3,54,15,14.99,39
301420,Third Eye Crime,34,15,4.99,19
299720,Terrorhedron Tower Defense,951,186,1.99,765
311060,Battle Mages: Sign of Darkness,93,24,4.99,69
274290,Gods Will Be Watching,1913,782,9.99,1131
311870,Super Trench Attack!,1139,106,4.99,1033
233980,UnEpic,6890,591,12.99,6299
311480,Vertical Drop Heroes HD,586,135,6.99,451
312350,Commander: The Great War,199,48,29.99,151
308000,Gold Rush! Classic,258,104,1.49,154
312210,The Fifth Day,371,553,14.99,-182
314510,Fall of the New Age Premium Edition,88,63,6.99,25
298260,Only If,3768,2215,0.0,1553
307190,Nicole,79,36,18.99,43
274900,Murder Miners,5257,854,2.99,4403
288160,The Room,20504,467,4.99,20037
314230,Rodina,1206,82,14.99,1124
313980,Proxy Blade Zero,118,44,9.99,74
296470,Mount Your Friends,7163,352,4.99,6811
251150,The Legend of Heroes: Trails in the Sky,6250,469,19.99,5781
313360,The Maker's Eden,83,33,8.99,50
291930,Industry Empire,80,150,11.99,-70
298600,Lovely Planet,2282,221,5.99,2061
311680,Flower Shop: Winter In Fairbrook,67,33,9.99,34
313650,Time Mysteries 2: The Ancient Spectres,309,204,9.99,105
288880,Pineview Drive,359,195,3.99,164
300610,Pure Pool,288,215,9.99,73
275510,Z Steel Soldiers,118,106,12.99,12
314570,The Sun at Night,20,21,4.99,-1
244590,Epigenesis,756,392,0.0,364
286140,Eidolon,247,160,4.95,87
313140,Blackbay Asylum,295,246,19.99,49
265790,Residue: Final Cut,60,37,1.99,23
307010,Northmark: Hour of the Wolf,249,46,9.99,203
292200,Crazy Plant Shop,203,61,4.99,142
293540,Guns and Robots,1122,591,0.0,531
314250,Jet Gunner,451,159,0.99,292
312990,The Expendabros,17068,492,0.0,16576
247950,Sacred 3,1101,3107,14.99,-2006
302750,The Counting Kingdom,102,3,6.99,99
293740,Road Not Taken,270,57,14.99,213
288020,Rex Rocket,178,57,0.99,121
296070,MIND: Path to Thalamus Enhanced Edition,902,461,11.99,441
308040,Back to Bed,2024,470,5.99,1554
295550,Royal Quest,958,405,0.0,553
305260,Battle Islands,2587,817,0.0,1770
312630,OTTTD,244,76,7.99,168
283580,New York Bus Simulator,42,45,9.99,-3
314770,Pe-2: Dive Bomber,8,6,9.99,2
314470,Heroes of a Broken Land,164,31,14.99,133
298520,Orbital Gear,1476,301,9.99,1175
45760,Ultra Street Fighter® IV,10946,1310,29.99,9636
298480,Victory At Sea,396,136,24.99,260
317380,War on Folvos,71,30,3.99,41
311100,Echelon: Wind Warriors,58,24,3.99,34
263960,Wyv and Keep: The Temple of the Lost Idol,74,18,14.99,56
301680,Psichodelya,39,60,0.0,-21
314320,GamersGoMakers,303,89,8.99,214
307980,Cricket Captain 2014,35,22,9.99,13
313620,The Terminal 2,45,130,4.99,-85
305920,Another Perspective,275,40,5.99,235
306620,Frontline : Road to Moscow,31,26,9.99,5
303510,Dungeons: The Eye of Draconus,89,98,2.99,-9
316020,Hangeki,33,4,9.99,29
264260,Global Outbreak: Doomsday Edition,52,21,0.0,31
270170,Depression Quest,2292,1615,0.0,677
303870,Blinding Dark,19,40,9.99,-21
249230,Risen 3 - Titan Lords,3921,1372,14.99,2549
314200,Bionic Heart,82,28,9.99,54
317470,Cubic Castles,3133,1134,0.0,1999
314020,Morphopolis,3960,792,3.99,3168
315920,Stonerid,126,67,4.99,59
305980,Heavy Fire: Afghanistan,179,145,2.99,34
319180,Platypus II,349,222,3.99,127
310390,Advanced Tactics Gold,115,22,29.99,93
304170,Kick-Ass 2,52,187,3.99,-135
312510,Mega Coin Squad,68,13,14.99,55
307340,Platypus,409,42,3.99,367
307350,Nux,184,285,6.99,-101
314360,Aritana and the Harpy's Feather,103,11,9.99,92
260550,Haunted,73,24,14.99,49
272600,Detective Grimoire,1569,80,6.99,1489
313340,Mountain,13803,1811,0.99,11992
285580,ACE - Arena: Cyber Evolution,716,356,0.0,360
315850,Amazing Princess Sarah,132,68,4.99,64
289520,King's Bounty: Dark Side,1067,389,3.24,678
297410,Trace Vector,41,10,6.99,31
307050,Shan Gui (山桂),1635,635,0.99,1000
314340,Chess 2: The Sequel,50,53,5.99,-3
269730,The Golf Club,700,393,29.99,307
319510,Five Nights at Freddy's,31124,2664,4.99,28460
248530,Depth Hunter 2: Deep Dive,715,243,3.74,472
294440,Shadowgate,544,83,14.99,461
257710,Max Gentlemen,762,116,0.0,646
301320,NoLimits 2 Roller Coaster Simulation,953,52,39.99,901
306950,Heroes & Legends: Conquerors of Kolhar,52,39,9.99,13
284850,Grim Legends: The Forsaken Bride,1323,51,9.99,1272
275390,Guacamelee! Super Turbo Championship Edition,5507,447,4.99,5060
314460,Jamsouls,31,29,3.99,2
315930,Bravada,48,10,9.99,38
295710,Darkwind: War on Wheels,226,230,0.0,-4
299260,Commando Jack,277,273,7.99,4
315550,Taxi,165,173,4.99,-8
317970,Dusk 12,82,90,3.99,-8
302210,Curse: The Eye of Isis,102,37,0.59,65
250700,Super Time Force Ultra,801,96,14.99,705
313830,See No Evil,237,114,0.99,123
265770,Cannons Lasers Rockets,127,391,0.0,-264
286690,Metro 2033 Redux,57108,7598,19.99,49510
262850,The Journey Down: Chapter Two,469,18,14.99,451
287390,Metro: Last Light Redux,47058,5906,19.99,41152
320110,Train Town,45,26,2.99,19
308380,Airship Dragoon,24,29,3.99,-5
251890,World of Diving,371,338,19.99,33
261760,Lichdom: Battlemage,1599,1215,9.99,384
319300,Trainz Trouble,32,13,1.99,19
303680,FATE: The Traitor Soul,344,30,7.99,314
261180,Lethal League,5625,344,13.99,5281
316660,Toast Time,58,18,4.99,40
312360,To End All Wars,112,63,39.99,49
298830,Millennium 3 - Cry Wolf,39,5,0.59,34
262750,GoD Factory: Wingmen,201,95,19.99,106
250400,How to Survive,13796,2911,14.99,10885
312640,Power-Up,149,106,2.99,43
302180,Voyage: Journey to the Moon,116,33,4.99,83
304410,Hexcells Infinite,3455,101,4.99,3354
301380,Date Warp,141,15,9.99,126
306550,Runers,225,49,9.99,176
266430,Anarchy Arcade,1536,698,0.0,838
318570,Hunters Of The Dead,90,57,4.99,33
313590,Boo Bunny Plague,200,67,1.99,133
304730,Train Fever,2175,1227,19.99,948
310080,Hatoful Boyfriend,6375,415,9.99,5960
257730,Infinity Wars: Animated Trading Card Game,2602,771,0.0,1831
271370,Transport Giant,214,163,2.99,51
314030,Guilty Gear X2 #Reload,607,80,9.99,527
265550,Dead Rising 3 Apocalypse Edition,11329,3860,29.99,7469
308580,Orborun,313,95,5.99,218
312050,Red Johnson's Chronicles - 1+2 - Steam Special Edition,23,37,0.99,-14
252970,McDROID,134,50,24.99,84
317710,Velocibox,568,74,4.99,494
246070,Hack 'n' Slash,441,384,13.37,57
39520,The Guild Gold Edition,313,113,9.99,200
276870,Dwelvers,147,107,14.99,40
319320,Time Mysteries 3: The Final Enigma,318,61,9.99,257
288470,Fable Anniversary,9035,1679,34.99,7356
321840,Rising Angels: Reborn,467,117,0.0,350
321030,ONE DAY for Ched,141,167,3.99,-26
246940,Lords of the Black Sun,77,307,29.99,-230
257690,J.U.L.I.A.: Among the Stars,726,116,19.99,610
306640,Battle Academy 2: Eastern Front,168,14,39.99,154
292630,Uriel's Chasm,481,2247,4.99,-1766
316720,planetarian ~the reverie of a little planet~,1902,49,9.99,1853
272510,NARUTO SHIPPUDEN: Ultimate Ninja STORM Revolution,6299,1197,4.49,5102
319560,Reprisal Universe,306,90,6.99,216
319270,Great Permutator,119,18,6.99,101
317410,Color Symphony,957,347,0.0,610
302610,Boson X,1426,109,2.99,1317
320630,Season Match,131,37,3.99,94
319550,The Collider,759,169,0.0,590
319850,Bridge Constructor Medieval,370,80,1.49,290
313190,Pacific Liberation Force,3,13,4.99,-10
321610,Demonlisher,13,13,4.99,0
316970,The Waste Land,48,46,9.99,2
313480,Blitzkrieg Anthology,1016,108,4.99,908
313500,Blitzkrieg 2 Anthology,867,158,4.99,709
290730,My Lands: Black Gem Hunting,2765,513,0.0,2252
306700,Iron Fisticle,312,54,0.89,258
312750,Final Fantasy IV (3D Remake),1962,354,15.99,1608
282440,Quake Live™,12366,2021,9.99,10345
323280,Sea Legends: Phantasmal Light Collector's Edition,96,26,4.99,70
320970,IGT Slots Paradise Garden,77,44,19.99,33
323250,Hexus,53,20,4.99,33
263860,SPACECOM,310,131,1.99,179
311250,Doorways: The Underworld,264,113,3.39,151
291960,Elminage Gothic,123,61,9.99,62
297120,Heavy Bullets,1166,254,9.99,912
300550,Shadowrun: Dragonfall - Director's Cut,5034,592,14.99,4442
289130,ENDLESS™ Legend,14023,2611,29.99,11412
240760,Wasteland 2: Director's Cut,6559,1404,29.99,5155
263520,Enola,99,49,14.99,50
215080,WAKFU,6609,2185,0.0,4424
303430,Roundabout,499,37,9.99,462
321710,Battle Of Europe,17,5,9.99,12
321150,Melissa K. and the Heart of Gold Collector's Edition,526,207,9.99,319
230860,Cannon Brawl,702,69,14.99,633
298840,Millennium 4 - Beyond Sunset,32,5,5.99,27
311140,The Stalin Subway,319,218,3.99,101
282030,Carmageddon 2: Carpocalypse Now,598,84,9.99,514
299660,6180 the moon,437,43,3.99,394
260330,Flockers™,141,43,1.99,98
319250,Magicmaker,509,51,9.99,458
317290,Bionic Heart 2,22,18,14.99,4
276750,Fritz Chess 14,75,30,39.99,45
232890,Stronghold Crusader 2,9410,4048,39.99,5362
221540,DG2: Defense Grid 2,2287,403,14.99,1884
315670,Raiden III Digital Edition,253,89,9.99,164
258970,Gauntlet™ Slayer Edition,6886,1639,19.99,5247
249190,Ancient Space,151,186,19.99,-35
295490,Schrodinger’s Cat And The Raiders Of The Lost Quark,84,39,9.99,45
317510,Beyond Gravity,781,105,1.99,676
289930,TransOcean: The Shipping Company,793,310,24.99,483
294460,Fenix Rage,126,33,14.99,93
316840,The Sacred Tears TRUE,56,20,1.99,36
273730,Driving School Simulator,48,148,2.99,-100
258520,The Vanishing of Ethan Carter,7488,961,19.99,6527
320320,Darkstone,319,95,0.54,224
324170,Pyrite Heart,192,92,4.99,100
302440,Roadside Assistance Simulator,45,40,11.99,5
265120,Meridian: New World,235,259,1.04,-24
253330,Neverending Nightmares,1914,616,3.74,1298
236150,Starpoint Gemini 2,2774,1208,5.24,1566
296630,Kraven Manor,446,152,0.0,294
321410,Command: Modern Air / Naval Operations WOTY,509,92,0.0,417
305050,Outland,3103,732,9.99,2371
263020,STARWHAL,608,77,11.99,531
286220,Pier Solar and the Great Architects,65,52,14.99,13
316480,Shadow Puppeteer,113,39,14.99,74
321290,Dandelion - Wishes brought to you -,611,98,29.99,513
241260,Sherlock Holmes: Crimes and Punishments,5037,517,29.99,4520
278620,TinyKeep,271,136,9.99,135
253610,Wrack,405,166,9.99,239
321830,Cavern Kings,153,69,4.99,84
312720,Khet 2.0,137,15,9.99,122
310700,Super Win the Game,538,69,7.99,469
321870,Silence of the Sleep,484,155,4.99,329
312610,METAL SLUG X,2382,311,7.99,2071
284890,Left in the Dark: No One on Board,548,111,9.99,437
304460,Qora,316,149,0.99,167
262210,Last Knight: Rogue Rider Edition,182,42,7.99,140
315340,A.R.E.S. Extinction Agenda EX,145,53,9.99,92
316260,Disney Universe,197,40,19.99,157
316030,Disney Alice in Wonderland,140,59,19.99,81
301980,Disney Pirates of the Caribbean: At Worlds End,183,59,19.99,124
319170,Disney G-Force,427,27,19.99,400
318740,Disney The Princess and the Frog,29,12,19.99,17
301760,Disney•Pixar Cars 2: The Video Game,365,148,19.99,217
311770,LEGO® Pirates of the Caribbean: The Video Game,2708,280,19.99,2428
319400,Disney Winnie the Pooh,185,22,5.99,163
318950,Disney Tangled,63,21,19.99,42
251170,Damned,2702,1115,19.99,1587
319080,Disney Princess: My Fairytale Adventure,160,21,19.99,139
302690,Metal Dead,403,72,4.99,331
297860,Split/Second,1313,344,19.99,969
286880,Disney Planes,50,11,19.99,39
300820,Disney•Pixar Toy Story 3: The Video Game,590,244,19.99,346
301830,Disney•Pixar Brave: The Video Game,108,9,19.99,99
214490,Alien: Isolation,45136,3467,39.99,41669
245300,Disney Epic Mickey 2:  The Power of Two,437,158,19.99,279
273110,Counter-Strike Nexon: Studio,26469,13468,0.0,13001
242640,Styx: Master of Shadows,7068,1470,19.99,5598
281450,Disciples Sacred Lands Gold,244,42,7.99,202
275180,Costume Quest 2,700,91,14.99,609
302850,Team Indie,57,52,0.0,5
307690,Sleeping Dogs: Definitive Edition,44496,3697,19.99,40799
327400,Sid Meier's Colonization (Classic),673,38,2.09,635
327390,Sid Meier's Covert Action (Classic),105,11,2.09,94
292120,FINAL FANTASY® XIII,10648,3723,15.99,6925
327380,Sid Meier's Pirates! Gold Plus (Classic),49,37,2.09,12
307570,A Golden Wake,184,66,9.99,118
321920,Schein,222,75,4.99,147
293660,TRI: Of Friendship and Madness,400,58,14.99,342
322130,Disney Princess: Enchanted Journey,184,18,19.99,166
302510,Ryse: Son of Rome,26961,4413,2.49,22548
320650,Season Match 2,55,39,3.99,16
327740,TRON 2.0,496,53,9.99,443
321480,Sigils of Elohim,947,85,0.0,862
261640,Borderlands: The Pre-Sequel,30025,7029,39.99,22996
270190,1HEART,106,69,9.99,37
268050,The Evil Within,19146,3482,19.99,15664
325090,Deep Dungeons of Doom,538,146,4.99,392
311910,DIG IT! - A Digger Simulator,117,74,11.99,43
221180,Eufloria HD,589,60,14.99,529
251730,Legend of Grimrock 2,2939,288,23.99,2651
201210,Pox Nora,504,183,0.0,321
317300,Roommates,161,61,24.99,100
327650,May’s Mysteries: The Secret of Dragonville,25,42,0.0,-17
262000,Gabriel Knight: Sins of the Fathers 20th Anniversary Edition,831,92,19.99,739
306660,Ultimate General: Gettysburg,2109,488,14.99,1621
226580,F1 2014,2429,450,0.0,1979
284750,Enigmatis: The Ghosts of Maple Creek,1147,214,9.99,933
316180,A City Sleeps™,53,40,9.99,13
320690,The Treasures of Montezuma 3,232,109,3.99,123
314980,Supreme Ruler Ultimate,809,253,19.99,556
292370,DarkEnd,180,163,1.99,17
327930,Darklands,179,16,6.99,163
284460,DeadCore,1663,290,2.49,1373
327950,Sword of the Samurai,126,12,1.39,114
320840,Wings! Remastered Edition,367,100,14.99,267
223410,Perpetuum,524,203,0.0,321
327940,Dragonsphere,26,5,1.39,21
250580,Paranautical Activity: Deluxe Atonement Edition,966,449,9.99,517
248610,Door Kickers,8635,490,19.99,8145
326180,Sinister City,999,516,0.99,483
323700,Poltergeist: A Pixelated Horror,29,14,7.99,15
279580,Devil's Dare 悪魔の挑戦,104,47,12.99,57
256010,Jagged Alliance Flashback,343,398,19.99,-55
301970,Screencheat,1508,127,14.99,1381
327260,Super Life of Pixel,298,72,9.99,226
328780,Vampires: Guide Them to Safety!,37,9,4.99,28
317610,Prophour23,49,24,9.99,25
329020,Battlegrounds of Eldhelm,145,61,0.0,84
307960,IL-2 Sturmovik: Battle of Stalingrad,5506,1355,49.99,4151
329000,Data Hacker: Corruption,57,61,1.99,-4
328470,Slave Zero,154,28,6.99,126
328460,Redline,64,31,1.39,33
285980,Kromaia,80,27,19.99,53
317030,Fatty Bear's Birthday Surprise,155,12,6.99,143
317360,Double Action: Boogaloo,10304,809,0.0,9495
327910,7th Legion,43,35,1.39,8
318430,Squishy the Suicidal Pig,2908,553,5.99,2355
308420,Ziggurat,3179,504,14.99,2675
65980,Sid Meier's Civilization®: Beyond Earth™,12323,8735,39.99,3588
328450,Deadlock II: Shrine Wars,40,17,1.39,23
317020,Pajama Sam: Games to Play on Any Day,36,4,4.99,32
311720,Sproggiwood,445,101,14.99,344
324770,eXperience 112,52,39,9.99,13
313400,REVOLVER360 RE:ACTOR,331,24,9.99,307
311120,The Stalin Subway: Red Veil,237,262,2.99,-25
318220,Enforcer: Police Crime Action,1092,1205,19.99,-113
285090,Robowars,127,154,3.19,-27
249050,Dungeon of the ENDLESS™,9940,1396,11.99,8544
246090,Spacebase DF-9,762,3397,9.99,-2635
274620,Skara - The Blade Remains,370,263,0.0,107
320790,Fabula Mortis,34,51,7.99,-17
325320,Mythos: The Beginning - Director's Cut,45,22,5.99,23
264690,Coin Crypt,506,77,9.99,429
284730,Dark Arcana: The Carnival,572,70,9.99,502
302710,BlazeRush,1214,167,9.99,1047
326990,Deep Eclipse: New Space Odyssey,62,38,0.99,24
329830,The Moon Sliver,675,234,0.99,441
319970,The Detail,468,173,2.99,295
265300,Lords Of The Fallen™,10687,7067,29.99,3620
284050,Sanitarium,828,50,9.99,778
320670,Season Match 3 - Curse of the Witch Crow,108,26,4.99,82
297110,Cosmic DJ,939,130,2.99,809
270490,The Forest of Doom (Standalone),221,51,4.99,170
313160,Farming Simulator 15,12529,1160,12.99,11369
321800,Icewind Dale: Enhanced Edition,2095,239,19.99,1856
328920,F-117A Nighthawk Stealth Fighter 2.0,90,17,1.39,73
328900,B-17 Flying Fortress: The Mighty 8th,59,16,9.99,43
284140,Majestic Nights,67,43,4.99,24
264300,Guns n Zombies,667,289,7.99,378
310110,NS2: Combat,125,126,0.0,-1
308270,Buzz Aldrin's Space Program Manager,348,97,29.99,251
274940,Depth,28186,3913,19.99,24273
209660,Call of Duty®: Advanced Warfare - Gold Edition,13493,8403,59.99,5090
209650,Call of Duty®: Advanced Warfare - Gold Edition,14813,8585,59.99,6228
273830,Aviator - Bush Pilot,12,58,1.99,-46
317330,Defenders of Time,18,26,0.0,-8
313660,Alea Jacta Est,81,29,24.99,52
250900,The Binding of Isaac: Rebirth,201024,4749,14.99,196275
316160,Broken Sword 4 - the Angel of Death,136,176,5.99,-40
298160,Eldevin,1240,338,0.0,902
253290,FOTONICA,713,97,14.99,616
322930,aerofly RC 7,154,34,39.99,120
329630,Command HQ,56,6,1.39,50
329640,Eradicator,69,12,1.39,57
329650,NAM,178,62,6.99,116
305960,Dragon: The Game,251,510,17.99,-259
319230,Gold Rush! Anniversary,105,81,2.49,24
327410,A Bird Story,7488,1406,3.99,6082
305740,Pitiri 1977,63,46,3.99,17
331390,Winged Sakura: Mindy's Arc,140,36,9.99,104
315540,The Joylancer: Legendary Motor Knight,67,81,9.99,-14
298850,Millennium 5 - The Battle of the Millennium,29,16,9.99,13
294370,Crowntakers,458,157,9.99,301
328100,Gunspell - Steam Edition,173,152,4.99,21
296510,Magnetic By Nature,57,24,0.99,33
332800,Five Nights at Freddy's 2,14402,988,7.99,13414
270830,Global ATC Simulator,62,39,29.99,23
324420,Desert Ashes,41,34,4.99,7
293440,Elliot Quest,129,46,9.99,83
291170,Royal Defense,239,82,0.49,157
294020,Merchants of Kaidan,326,157,14.99,169
313690,LEGO® Batman™ 3: Beyond Gotham,5023,612,19.99,4411
204630,Retro City Rampage™ DX,2030,270,14.99,1760
289650,Assassin's Creed® Unity,36075,11764,29.99,24311
330470,Over The Void,112,55,4.99,57
294860,Valkyria Chronicles™,10737,1098,19.99,9639
320150,Deadlings: Rotten Edition,225,45,3.99,180
260410,Get Off My Lawn!,1220,432,0.0,788
287260,Toybox Turbos,1418,253,14.99,1165
259410,Sneaky Sneaky,250,29,4.99,221
319450,Chariot,293,68,1.49,225
331510,Amphora,151,40,13.99,111
314810,Randal's Monday,995,302,1.99,693
317620,Space Hulk: Ascension,617,231,0.0,386
298930,Darkness Within 1: In Pursuit of Loath Nolder,361,130,7.99,231
332480,Phoenix Force,608,118,0.99,490
324750,StuntMANIA Reloaded,58,46,4.99,12
332360,Spriter Pro,271,80,59.99,191
328680,Crab Cakes Rescue,45,30,1.04,15
282070,This War of Mine,81265,6228,19.99,75037
328600,Frozen Synapse Prime,214,122,0.0,92
321560,The Sun and Moon,143,21,6.99,122
326730,Whisper of a Rose,43,45,9.99,-2
296570,Lords of Xulima,923,217,19.99,706
316600,QP Shooting - Dangerous!!,446,33,3.99,413
325420,Homebrew - Patent Unknown,714,225,14.99,489
331920,Airline Tycoon Deluxe,352,89,9.99,263
326590,Cinemaware Anthology: 1986-1991,82,25,9.99,57
317850,Company of Heroes 2 - Ardennes Assault,512,334,19.99,178
226560,Escape Dead Island,744,462,14.99,282
302010,The Blue Flamingo,280,322,9.99,-42
330680,Solar Struggle,5,20,5.99,-15
289950,Construction Simulator 2015,4960,1133,14.99,3827
328270,Leviathan: The Last Day of the Decade,517,121,14.99,396
295790,Never Alone (Kisima Ingitchuna),6347,1494,14.99,4853
262470,Rollers of the Realm,562,65,9.99,497
331470,Everlasting Summer,56398,2563,0.0,53835
330350,Robotex,273,599,4.99,-326
303690,FATE: The Cursed King,325,44,7.99,281
310880,Basketball Pro Management 2015,23,39,9.99,-16
259470,Particulars,58,30,0.0,28
306020,Bloons TD 5,9019,530,9.99,8489
269530,Voice of Pripyat,32,51,6.99,-19
328730,Letter Quest: Grimm's Journey,352,27,0.0,325
330460,Celestial Command,397,163,19.99,234
332490,Battle Fleet 2,247,86,4.49,161
300040,Divine Souls F2P MMO,444,446,0.0,-2
333220,Cherry Tree High I! My! Girls!,116,52,0.0,64
253510,WARMACHINE: Tactics,493,625,0.0,-132
326150,Death Skid Marks,582,45,9.99,537
256030,Shadows: Heretic Kingdoms,252,170,29.99,82
329110,Gems of War - Puzzle RPG,6867,1677,0.0,5190
327310,The Marvellous Miss Take,255,56,19.99,199
310640,European Fishing,6,23,2.99,-17
292480,Magical Battle Festa,233,136,9.99,97
331120,Passing Pineview Forest,1110,553,0.0,557
227160,Kinetic Void,276,1251,19.99,-975
325180,AppGameKit Classic: Easy Game Development,514,105,19.99,409
293340,The Good Life,78,77,1.79,1
263480,Final Rush,69,81,4.99,-12
333120,Inside The Gear,47,74,0.89,-27
332570,Amazing Frog?,6820,583,15.99,6237
330720,Flashpoint Campaigns: Red Storm Player's Edition,182,18,49.99,164
327010,Motorama,129,241,19.99,-112
332810,Midnight Mysteries: Witches of Abraham - Collector's Edition,36,8,13.99,28
248390,Craft The World,11308,1508,18.99,9800
326480,If My Heart Had Wings,3971,334,14.99,3637
331400,Luna: Shattered Hearts: Episode 1,15,41,0.99,-26
333870,Feel-A-Maze,87,23,4.99,64
310790,Geometry Wars™ 3: Dimensions Evolved,1207,136,14.99,1071
334710,Ilamentia,64,31,2.99,33
266150,Lost Saga NA,417,275,0.0,142
230310,Akaneiro: Demon Hunters,136,236,0.0,-100
312370,"Warhammer 40,000: Armageddon",678,161,39.99,517
331670,The Jackbox Party Pack,1414,125,24.99,1289
314210,Tesla Breaks the World!,8,46,9.99,-38
257260,Inherit the Earth: Quest for the Orb,92,6,5.99,86
323780,Fireworks Simulator,142,93,11.99,49
279440,Joe Dever's Lone Wolf HD Remastered,520,168,14.99,352
303800,The Witcher Adventure Game,965,291,9.99,674
318530,Wings of Vi,978,229,14.99,749
321660,Mining Industry Simulator,24,51,0.0,-27
303830,Motorcycle Club,36,85,9.99,-49
315080,Foresight,35,8,4.99,27
241560,The Crew™,10423,4705,29.99,5718
320400,Magnifico,90,57,4.99,33
330840,Game of Thrones - A Telltale Games Series,7988,2521,0.0,5467
205020,Lumino City,1084,159,12.99,925
328500,Potatoman Seeks the Troof,557,196,1.35,361
324080,Rising World,3778,736,14.99,3042
332710,1Quest,90,77,3.99,13
328830,Rugby Union Team Manager 2015,46,35,4.99,11
297350,The Old City: Leviathan,494,187,5.99,307
336010,MXGP - The Official Motocross Videogame Compact,112,42,4.99,70
332070,School of Dragons,2821,2105,0.0,716
314220,Bombing Bastards,72,46,9.99,26
326630,Club Manager 2015,46,54,0.0,-8
331220,Thief Town,130,39,7.99,91
280320,Adventurer Manager,338,217,4.99,121
334190,Insanity's Blade,204,70,5.99,134
244770,StarMade,2006,888,14.99,1118
325470,1953: NATO vs Warsaw Pact,17,53,1.99,-36
315320,Skilltree Saga,58,118,0.99,-60
317440,Quantum Rush Champions,92,69,9.99,23
250560,Fight The Dragon,1047,282,9.99,765
330990,Demon Hunter: Chronicles from Beyond,283,161,9.99,122
329190,Volo Airsport,128,58,0.99,70
239840,Dead State: Reanimated,1706,612,19.99,1094
333880,Braveland Wizard,316,84,7.99,232
310460,Corto Maltese - Secrets of Venice,8,24,9.99,-16
331650,Carmageddon TDR 2000,282,99,4.99,183
324070,iO,172,38,4.99,134
318330,Mecha Ace,117,17,4.99,100
294160,Galcon 2: Galactic Conquest,710,133,0.0,577
298950,Darkness Within 2: The Dark Lineage,143,63,9.99,80
335320,Bet On Soldier,167,73,0.79,94
333430,Sinking Island,148,62,7.99,86
299440,Rooks Keep,57,26,7.99,31
289690,LARA CROFT AND THE TEMPLE OF OSIRIS™,2419,1233,19.99,1186
307230,"I, Zombie",1944,366,1.99,1578
337040,Deadnaut,100,51,9.99,49
288120,Dungeonmans,865,79,14.99,786
321950,Yury,234,260,1.99,-26
312400,Frontline : Longest Day,3,13,4.99,-10
265670,Imagine Me,139,292,2.99,-153
329690,BasketBelle,125,20,4.99,105
335900,Angels of Fasaria: Version 2.0,24,35,4.99,-11
300620,Flyhunter Origins,27,4,3.99,23
305800,POP: Methodology Experiment One,51,32,3.99,19
252290,Elegy for a Dead World,196,106,0.0,90
300840,JUJU,94,5,9.99,89
328890,Fritz for Fun 13,19,11,19.99,8
335790,Words for Evil,356,89,2.99,267
292140,FINAL FANTASY® XIII-2,2661,1870,19.99,791
294810,BlazBlue: Continuum Shift Extend,1308,127,2.99,1181
257510,The Talos Principle,24527,1115,29.99,23412
335890,Nanofights,288,244,0.0,44
331980,Last Inua,152,109,7.99,43
319140,Xeodrifter™,583,182,9.99,401
283820,KAMUI,142,14,7.99,128
325150,Run or Die,130,21,4.99,109
335330,Brick-Force,1665,2353,0.0,-688
330620,It's A Wipe!,93,29,4.99,64
277680,"About Love, Hate and the other ones",682,74,6.99,608
336930,Redux: Dark Matters,22,16,9.99,6
323490,Oblivious Garden ~Carmina Burana,494,49,14.99,445
317040,Strife: Veteran Edition,471,52,9.99,419
337420,Final Dusk,287,91,2.99,196
248860,NEO Scavenger,4220,455,14.99,3765
334230,Town of Salem,30573,3847,4.99,26726
331440,bit Dungeon II,1736,368,3.99,1368
335670,LISA: The Painful,11857,460,9.99,11397
286260,fault - milestone one,2912,210,14.99,2702
318650,SunAge: Battle for Elysium,105,43,14.99,62
313130,Metrocide,90,76,12.99,14
320430,Ascension: Deckbuilding Game,1066,147,12.99,919
312600,Rime Berta,91,43,14.99,48
336090,Sky Mercenaries,79,35,9.99,44
325870,Clash of Puppets,41,20,4.99,21
222420,THE KING OF FIGHTERS '98 ULTIMATE MATCH FINAL EDITION,1965,237,14.99,1728
286040,Dead Effect,2551,964,4.99,1587
338030,Mission Control: NanoMech,3,9,8.99,-6
333260,Marvin's Mittens,182,7,5.99,175
336610,Outcast 1.1,463,49,5.99,414
311340,METAL GEAR SOLID V: GROUND ZEROES,11600,2368,19.99,9232
324120,Verde Station,228,80,0.0,148
339120,Fork Parker's Holiday Profit Hike,556,112,0.0,444
314160,Microsoft Flight Simulator X: Steam Edition,19289,3175,24.99,16114
339350,Choice of Robots,1860,63,5.99,1797
244210,Assetto Corsa,65561,5809,19.99,59752
302830,BLOCKADE 3D,15518,11164,0.0,4354
336280,Chronicles of a Dark Lord: Episode 1 Tides of Fate Complete,63,33,0.0,30
277850,Sportsfriends,46,14,14.99,32
337150,Sentinels of the Multiverse,1275,149,9.99,1126
322170,Geometry Dash,182534,12372,3.99,170162
322300,The Repopulation,619,496,19.99,123
337880,One Late Night: Deadline,44,114,0.99,-70
339510,Psy High,115,31,4.99,84
326190,Alchemy Mysteries: Prague Legends,871,248,1.99,623
339820,Starwalker,10,20,4.99,-10
339000,Ukrainian Ninja,434,153,0.0,281
335100,Dwarf Tower,186,74,0.99,112
337410,Karos,329,221,0.0,108
337930,Nameless ~The one thing you must recall~,648,45,29.99,603
338830,Star Nomad,27,16,0.99,11
333600,NEKOPARA Vol. 1,24363,1144,9.99,23219
297470,Xsyon - Prelude,261,94,29.99,167
336770,Pilot Brothers 2,58,11,4.99,47
336380,Catmouth Island,41,37,0.99,4
334300,Fake Colours,129,23,14.99,106
337070,"Dimmdrive :: Gaming Ramdrive @ 10,000+ MB/s",268,160,14.99,108
338590,The Race for the White House,31,18,14.99,13
340220,Shadows of War,49,97,2.99,-48
333760,Vintage Year,70,18,3.99,52
340290,Dr.Green,28,12,2.99,16
333660,Towers of Altrac - Epic Defense Battles,69,45,2.99,24
340460,Spartans Vs Zombies Defense,337,397,0.0,-60
326670,Warhammer Quest,721,334,14.99,387
306930,BattleSpace,28,53,0.0,-25
339290,Castle,178,86,0.51,92
304910,Sky Gamblers: Storm Raiders,189,47,9.99,142
335420,ルナティックドーン 前途への道標,37,5,15.99,32
337270,Ostrich Island,213,37,4.99,176
335690,dUpLicity ~Beyond the Lies~,23,37,9.99,-14
332500,GRAV,3350,3532,19.99,-182
340280,Cubot,249,23,1.99,226
339500,Blasted Fortress,4,10,4.99,-6
326950,Sword of Asumi,272,96,12.99,176
329770,4089: Ghost Within,59,42,5.99,17
340300,Teddy Floppy Ear - Mountain Adventure,605,80,4.99,525
273960,Mechs & Mercs: Black Talons,60,80,9.99,-20
340800,Unhack,248,42,3.99,206
341380,Countless Rooms of Death,13,25,0.99,-12
323450,Alphadia Genesis,98,23,9.99,75
340650,Elements: Soul of Fire,98,96,0.0,2
322080,Disorder,64,22,3.99,42
308440,Pushcat,84,10,4.99,74
334690,Squirreltopia,215,70,1.99,145
266410,iRacing,2096,334,9.99,1762
322900,"War, the Game",301,138,6.99,163
342360,Train of Afterlife,90,90,9.99,0
339470,Retention,221,444,0.99,-223
333330,Song of the Myrne: What Lies Beneath,67,21,4.99,46
340750,Gunslugs 2,17,18,8.99,-1
337850,Avernum 2: Crystal Souls,223,28,19.99,195
299680,Tengami,1276,302,6.99,974
314150,Double Dragon Trilogy,469,380,5.99,89
342630,Witch's Pranks: Frog's Fortune Collector's Edition,182,35,6.99,147
303260,TRISTOY,65,56,6.99,9
335220,But to Paint a Universe,19,14,4.99,5
320610,Questerium: Sinister Trinity HD Collector's Edition,143,38,6.99,105
341780,Chronicles of a Dark Lord: Episode II War of The Abyss,33,20,0.0,13
343270,Disillusions Manga Horror,310,216,0.99,94
337940,X-note,124,127,14.99,-3
338050,Anoxemia,265,152,8.99,113
342610,HyperRogue,351,19,4.99,332
328670,Deer Hunt Legends,10,37,1.24,-27
340310,Teddy Floppy Ear - Kayaking,439,131,4.99,308
342380,Sakura Angels,1872,358,9.99,1514
340200,Bloop,165,191,0.0,-26
343740,InMind VR,327,89,0.0,238
304240,Resident Evil,15590,1251,4.99,14339
339800,HuniePop,26390,1002,9.99,25388
301910,Saints Row: Gat out of Hell,6642,2225,14.99,4417
332580,Mimpi,227,40,3.99,187
327640,CaesarIA,804,563,0.0,241
336040,Combat Monsters,134,58,0.0,76
258910,Citizens of Earth,284,93,14.99,191
259660,Void Destroyer,207,133,3.99,74
340330,Deity Quest,20,7,9.99,13
314830,Blackguards 2,694,350,0.99,344
338060,Mahjong Pretty Girls Battle,242,139,14.99,103
342500,Human Extinction Simulator,13,25,19.99,-12
258050,Survivor Squad,533,272,2.99,261
330000,Kingdoms CCG,71,67,0.0,4
345650,Without Within,1778,232,0.0,1546
341720,Among Ripples,971,453,0.0,518
337760,Decisive Campaigns: The Blitzkrieg from Warsaw to Paris,84,9,39.99,75
295690,PARTICLE MACE,1206,165,4.99,1041
338140,Venetica - Gold Edition,395,104,9.99,291
345860,Super Galaxy Squadron EX Turbo,336,66,9.99,270
337960,ClusterPuck 99,88,26,4.99,62
334140,Roche Fusion,91,6,5.99,85
290790,Grey Goo,2772,1281,29.99,1491
336020,Pahelika: Secret Legends,28,33,9.99,-5
329490,Phantom Breaker: Battle Grounds,2414,471,11.99,1943
341470,Loot Hunter,68,31,6.99,37
313120,Stranded Deep,27382,8796,14.99,18586
239140,Dying Light,316493,16568,29.99,299925
274700,868-HACK,85,9,5.65,76
346250,The Old Tree,2934,326,0.0,2608
343800,Shadowgate: MacVenture Series,37,24,2.99,13
316790,Grim Fandango Remastered,5895,625,14.99,5270
343830,Déjà Vu II: MacVenture Series,14,7,2.99,7
343810,The Uninvited: MacVenture Series,48,7,2.99,41
333730,Dark Gates,17,24,3.99,-7
341440,BANZAI PECAN: The Last Hope For the Young Century,41,51,2.99,-10
345280,Lost in a Forest,46,45,1.99,1
251490,Gravity Ghost,279,9,14.99,270
343820,Déjà Vu: MacVenture Series,39,15,2.99,24
250420,8BitMMO,2641,1805,0.0,836
344030,Ghost Pirates of Vooju Island,41,33,9.99,8
346450,samurai_jazz,63,29,0.99,34
342230,Air Guardians,77,99,0.99,-22
297000,Heroes® of Might & Magic® III - HD Edition,12889,3726,14.99,9163
346320,Streets of Chaos,31,58,0.0,-27
312840,Fahrenheit: Indigo Prophecy Remastered,3967,963,9.99,3004
214420,Gear Up,6339,2179,0.0,4160
279140,Making History: The Great War,330,99,29.99,231
341060,The Lady,88,123,0.0,-35
330180,Pix the Cat,296,66,4.99,230
284810,Nightmares from the Deep 3: Davy Jones,727,35,0.0,692
319630,Life is Strange - Episode 1,151230,6092,0.0,145138
331340,Tulpa,126,110,2.99,16
342510,Bret Airborne,42,24,4.99,18
336710,Supreme League of Patriots - Episode 2: Patriot Frames,31,11,5.99,20
336730,Supreme League of Patriots - Episode 3: Ice Cold in Ellis,27,14,5.99,13
343750,Firefly Online Cortex,276,381,0.0,-105
282900,Hyperdimension Neptunia Re;Birth1,10911,598,14.99,10313
331760,Supreme League of Patriots,65,34,5.99,31
333250,Forward to the Sky,1703,366,3.99,1337
335660,CAFE 0 ~The Drowned Mermaid~,102,57,6.99,45
341860,SickBrick,111,93,0.0,18
259570,EDEN STAR,635,408,19.99,227
340050,Survivalist,1933,476,4.99,1457
341160,Steam Heroes,31,77,5.99,-46
335240,Transformice,19816,2929,0.0,16887
334840,Drive to Hell,55,16,4.99,39
340720,The Tiny Tale 2,29,5,6.99,24
341530,Stardust Vanguards,78,18,3.99,60
338190,Just Get Through,185,28,4.99,157
262190,Zombeer,188,63,4.99,125
315810,eden*,2572,101,19.99,2471
343360,Particula,1541,682,0.51,859
340070,Battle Ranch: Pigs vs Plants,482,489,1.99,-7
332630,The Guilt and the Shadow,43,12,8.99,31
346080,Astro Emporia,32,45,0.99,-13
346210,Garden Rescue,96,30,3.99,66
341390,Vulture for NetHack,122,50,2.99,72
273750,Formula Truck 2013,151,37,9.99,114
343100,Overture,926,277,4.99,649
208750,Apotheon,2923,325,14.99,2598
346240,Ski Park Tycoon,50,25,9.99,25
347560,Terra Incognita ~ Chapter One: The Descendant,664,357,1.99,307
335920,Ephemerid: A Musical Adventure,197,17,1.99,180
345090,Ancient Planet Tower Defense,726,147,4.99,579
323320,Grow Home,4579,423,7.99,4156
310510,Deathtrap,1596,310,19.99,1286
344340,Front Office Football Seven,116,26,14.99,90
297060,Freaking Meatbags,134,21,9.99,113
346200,Drew and the Floating Labyrinth,28,22,4.99,6
341070,Stay Dead Evolution,45,67,5.99,-22
324710,To Be or Not To Be,225,20,4.99,205
338800,Seven Kingdoms 2 HD,250,61,9.99,189
340120,Moorhuhn (Crazy Chicken),282,38,0.0,244
313010,Cities XXL,804,1369,9.99,-565
262960,Castle In The Darkness,923,255,9.99,668
342980,Destination Sol,1049,275,0.0,774
332790,Darkness Assault,289,302,0.99,-13
304650,SUNLESS SEA,6997,1399,18.99,5598
348650,The Asskickers-Steam Edition,22,60,9.99,-38
338550,Terra Lander Remastered,130,93,2.99,37
338320,Pixel Heroes: Byte & Magic,372,111,1.49,261
344860,Crystal Story II,262,16,2.99,246
347940,Forsaken Isle,208,163,7.99,45
321260,Wickland,444,398,0.99,46
345580,Universal Combat CE,105,156,9.99,-51
335840,Goats on a Bridge,129,40,4.99,89
315060,Bloop Reloaded,229,119,0.0,110
348450,Lex Mortis,70,81,4.99,-11
329890,MyRPG Master,23,47,0.0,-24
335010,Steam and Metal,50,17,4.99,33
346630,Plazma Being,296,92,4.99,204
336670,HIT,181,298,0.0,-117
273350,Evolve Stage 2,31246,14787,0.0,16459
345200,Tasty Blue,457,47,7.99,410
349950,GunWorld,21,46,1.99,-25
336200,Starlaxis Supernova Edition,32,21,8.99,11
273840,Stock Car Extreme,480,70,14.99,410
341090,On A Roll 3D,228,32,3.99,196
326650,The Legend of Candlewind: Nights & Candles,6,44,9.99,-38
320760,Tokyo School Life,624,42,14.99,582
338890,Harold,39,14,9.99,25
298630,The Escapists,13760,1495,17.99,12265
336060,Raptor: Call of The Shadows - 2015 Edition,324,120,4.99,204
328760,SanctuaryRPG: Black Edition,1386,119,7.99,1267
330370,Reload,70,22,4.99,48
296830,Lucius II,1153,729,19.99,424
323720,Decay: The Mare,1308,404,0.84,904
301920,War of the Human Tanks - ALTeR,88,5,6.49,83
321890,Aveyond 3-4: The Darkthrop Prophecy,23,5,9.99,18
342490,Shipwreck,169,40,2.99,129
346180,David.,569,157,1.99,412
345220,Agent Awesome,539,321,1.99,218
325610,Total War: ATTILA,23432,5601,44.99,17831
339130,Morningstar: Descent to Deadrock,469,33,9.99,436
266510,Hand of Fate,9151,1014,19.99,8137
328060,Tales Runner,341,260,0.0,81
345750,Idol Hands,63,84,4.99,-21
326380,Mystery of Neuschwanstein,59,15,11.99,44
345540,Inbetween Land,189,46,6.99,143
237350,Frozen Cortex,191,77,24.99,114
279940,The Book of Unwritten Tales 2,781,73,29.99,708
338960,Rescue Team,116,12,4.99,104
340470,You Are Not a Banana: Better Edition,88,51,0.99,37
270450,Robot Roller-Derby Disco Dodgeball,3537,287,9.99,3250
341500,Camera Obscura,1113,422,1.99,691
329130,Reassembly,3341,213,14.99,3128
312790,Agarest: Generations of War 2,138,93,19.99,45
349540,PeriAreion,18,35,0.0,-17
333950,Medieval Engineers,3777,3192,9.99,585
346120,Boring Man - Online Tactical Stickman Combat,4697,654,0.0,4043
346560,Hero of the Kingdom II,2046,120,7.99,1926
344230,Pixel Puzzles 2: Birds,234,66,4.99,168
315840,Catacomb Kids,506,53,15.99,453
253390,Hot Tin Roof: The Cat That Wore A Fedora,130,72,7.49,58
340130,Moorhuhn Invasion (Crazy Chicken Invasion),43,13,0.0,30
348960,Odysseus: Long Way Home,48,26,3.99,22
343840,Trash TV,109,15,6.99,94
294060,Aaru's Awakening,92,38,14.99,54
301050,Night Shift,75,39,4.99,36
341310,Greyfox RPG,1273,444,1.99,829
339040,Disney's Chicken Little,293,112,9.99,181
320520,Oscura: Lost Light,77,38,6.99,39
331970,Disney's Treasure Planet: Battle of Procyon,199,6,9.99,193
331750,Disney•Pixar WALL-E,594,29,19.99,565
332260,Disney•Pixar Cars Mater-National Championship,249,23,19.99,226
319740,There Came an Echo,271,97,14.99,174
345640,Block Legend DX,66,47,4.99,19
331450,Disney•Pixar Finding Nemo,82,36,9.99,46
331160,Disney•Pixar Cars,1311,159,19.99,1152
338300,Disney's Chicken Little: Ace in Action,33,14,19.99,19
287290,Resident Evil Revelations 2,16954,4665,5.99,12289
340990,Disney Bolt,94,30,19.99,64
273500,Over 9000 Zombies!,1208,185,1.99,1023
314660,Oddworld: New 'n' Tasty,2679,393,19.99,2286
349500,Cubicle Quest,498,173,4.99,325
296280,TownCraft,40,58,9.99,-18
341690,The Great Fusion,43,23,2.99,20
316610,A Good Snowman Is Hard To Build,709,33,9.99,676
244160,Homeworld Remastered Collection,9545,1236,34.99,8309
333510,Isbarah,44,11,13.99,33
317100,Republique,441,129,9.99,312
333970,A Druid's Duel,80,29,7.99,51
346140,Hidden Object Bundle 5 in 1,129,67,9.99,62
350010,Time Mysteries: Inheritance - Remastered,310,393,9.99,-83
322520,DYNASTY WARRIORS 8 Empires,874,436,49.99,438
323470,DRAGON BALL XENOVERSE,14499,1837,5.99,12662
348870,Night Mysteries: The Amphora Prisoner,89,48,0.99,41
338980,MOAI: Build Your Dream,140,35,6.99,105
347440,Pneuma: Breath of Life,133,57,19.99,76
328940,The Deer God,294,166,14.99,128
341930,Space Station Alpha,36,41,5.99,-5
345130,Dark Matter,88,60,2.99,28
222440,THE KING OF FIGHTERS 2002 UNLIMITED MATCH,3133,171,14.99,2962
344300,Heckabomb,181,108,5.99,73
339160,Tales of the Orient: The Rising Sun,298,60,9.99,238
351470,Sometimes: Success Requires Sacrifice,410,159,0.0,251
346950,The Dark Stone from Mebara,117,84,7.99,33
322680,BLACKHOLE,864,132,8.99,732
349240,Edolie,21,10,9.99,11
353360,how do you Do It?,2200,407,0.0,1793
306440,Oblitus,67,63,14.99,4
337980,Vagrant Hearts,82,30,9.99,52
351340,Belladonna,496,192,6.99,304
333650,Pahelika: Revelations,30,40,13.99,-10
339400,Runestone Keeper,2034,364,9.99,1670
354140,Five Nights at Freddy's 3,6678,811,7.99,5867
351790,Invisible Apartment,288,121,0.0,167
339790,rFactor,569,62,24.99,507
345060,Stay Alight,155,36,3.99,119
341510,Crayon Chronicles,39,13,3.99,26
349550,Mighty Dungeons,53,32,4.99,21
342240,SCHAR: Blue Shield Alliance,14,12,1.99,2
340520,Tallowmere,695,65,3.99,630
310810,Shiftlings,71,26,0.0,45
342570,HIS (Heroes In the Sky),211,331,0.0,-120
301560,White Night,240,76,14.99,164
346810,Marble Age,565,109,5.99,456
335000,Tormentum - Dark Sorrow,2254,144,11.99,2110
289780,Requiem: Rise of the Reaver,448,202,0.0,246
323630,Ubinota,201,20,0.0,181
286280,Steel Armor: Blaze of War,227,47,29.99,180
336080,Vietnam ‘65,314,66,9.99,248
342890,Synonymy,35,39,1.99,-4
338540,Navy Field 2 : Conqueror of the Ocean,612,762,0.0,-150
353560,Plug & Play,3885,716,2.99,3169
279720,The I of the Dragon,579,284,6.99,295
350500,Fly in the House,95,92,9.99,3
341730,Dustoff Heli Rescue,302,55,3.99,247
301640,Zombie Army Trilogy,13206,1866,44.99,11340
349690,ARMED SEVEN,60,3,4.99,57
275100,Shelter 2,3331,597,14.99,2734
268320,Grapple,296,30,6.99,266
311560,Assassin’s Creed® Rogue,10220,1863,19.99,8357
347430,Frankenstein: Master of Death,1567,314,4.99,1253
274170,Hotline Miami 2: Wrong Number,40872,2841,14.99,38031
222180,Mushroom Men: Truffle Trouble,25,16,2.99,9
325060,Parallax,125,24,4.99,101
261570,Ori and the Blind Forest,46417,2229,0.0,44188
255710,Cities: Skylines,187151,13180,29.99,173971
348180,Starship Traveller,41,27,4.99,14
355520,The Albino Hunter (Original),245,81,4.99,164
355760,Drizzlepath,300,265,1.99,35
282210,Sid Meier's Starships,1076,1143,14.99,-67
352190,Spirit of War,43,29,9.99,14
293760,Automation - The Car Company Tycoon Game,7502,607,29.99,6895
334620,Soccertron,44,15,1.99,29
340540,TDP4:Team Battle,429,398,0.0,31
336110,Bloody Streets,96,24,4.99,72
296870,Dreaming Sarah,2241,220,5.99,2021
347590,Heroes of Hellas 3: Athens,151,11,2.99,140
278810,LA Cops,86,74,2.24,12
355410,Radium,118,31,2.99,87
344880,In Exilium,49,28,0.0,21
334070,Hektor,610,359,9.99,251
342300,Zombie Kill of the Week - Reborn,867,85,6.99,782
346470,Tennis Elbow 2013,601,41,14.99,560
353090,Chicken Invaders 5,808,25,4.99,783
234630,Project CARS,10892,2950,14.99,7942
350630,Dodge,58,17,1.99,41
354960,An Imp? A Fiend!,36,30,0.99,6
354970,Shin Samurai Jazz,57,34,0.99,23
337730,Battletank LOBA,4,8,9.99,-4
353600,Spellbind,4,16,9.99,-12
337630,Bermuda,114,99,2.99,15
345120,Vox Populi Vox Dei 2,401,59,2.99,342
356430,Chris Sawyer's Locomotion™,419,76,5.99,343
281940,Woolfe - The Red Hood Diaries,840,587,9.99,253
356880,Eron,181,120,0.49,61
339200,Oceanhorn: Monster of Uncharted Seas,1485,374,14.99,1111
356380,Orbit HD,49,33,1.99,16
318130,Doom & Destiny,1954,77,0.99,1877
318480,Burnstar,41,4,4.99,37
344800,World of Mixed Martial Arts 3,104,42,19.99,62
307430,Othello,71,30,0.0,41
342620,It came from space and ate our brains,401,95,14.99,306
265970,Worlds of Magic,230,266,2.49,-36
343180,Top Trumps Turbo,71,141,2.99,-70
347670,Karate Master 2 Knock Down Blow,517,92,9.99,425
344500,Three Fourths Home: Extended Edition,122,75,4.99,47
305500,Trapped Dead: Lockdown,92,73,0.99,19
348700,Walkover,79,51,0.0,28
348530,Incognito,13,18,0.0,-5
358610,Exowar,19,72,0.0,-53
343070,World of Subways 4 – New York Line 7,211,104,14.99,107
342580,12 Labours of Hercules,2715,185,2.99,2530
341120,Glorkian Warrior: The Trials Of Glork,301,32,3.99,269
348620,Voices from the Sea,1146,88,0.0,1058
352610,The Way We All Go,114,19,5.99,95
347630,16 Bit Arena,41,24,0.0,17
335070,VRC PRO,514,96,44.99,418
356260,Stalingrad,304,36,4.99,268
351080,The Corporate Machine,52,32,9.99,20
348290,Hospital Manager,109,129,4.99,-20
356290,Cuban Missile Crisis: Ice Crusade,46,15,4.99,31
357290,Red Lake,382,503,0.51,-121
350220,199CentsSTUDIO,65,245,0.0,-180
245370,Etherium,339,564,9.99,-225
234920,Dyscourse,344,97,14.99,247
346670,Sky Battles,41,34,3.99,7
356270,Cuban Missile Crisis,160,49,4.99,111
304030,ArcheAge,3698,3392,0.0,306
351860,Cultures - Northland,397,84,0.54,313
354310,Claws & Feathers,66,5,6.99,61
279800,Grim Legends 2: Song of the Dark Swan,1098,41,9.99,1057
354240,"Please, Don’t Touch Anything",3788,521,4.99,3267
291650,Pillars of Eternity,18448,2498,29.99,15950
334850,1931: Scheherazade at the Library of Pergamum,115,46,0.49,69
312230,Spirits of Xanadu,324,90,4.99,234
327670,Ironcast,643,201,14.99,442
351870,Cultures - 8th Wonder of the World,306,67,0.54,239
355070,TDP5 Arena 3D,105,119,0.0,-14
344630,Princess Evangile All Ages Version,205,21,34.99,184
341150,Age of Fear 2: The Chaos Lord GOLD,245,61,4.99,184
350810,Pixel Puzzles 2: Anime,699,237,4.99,462
345660,RIDE,1569,442,19.99,1127
347040,Keebles,57,22,9.99,35
339840,The Moment of Silence,52,31,14.99,21
357600,Unium,280,17,1.99,263
351240,Venusian Vengeance,69,9,3.99,60
352780,An Octave Higher,234,47,11.99,187
354730,Deadly Sin,35,25,4.99,10
282590,Star Ruler 2,565,125,19.99,440
355430,//SNOWFLAKE TATTOO//,40,69,4.99,-29
270810,Jones On Fire,130,82,2.99,48
346900,AdVenture Capitalist,46142,6194,0.0,39948
322290,Gurumin: A Monstrous Adventure,755,63,9.99,692
351400,The Defenders: The Second Wave,50,39,2.99,11
346420,The Spatials,225,94,9.99,131
311730,DEAD OR ALIVE 5 Last Round: Core Fighters,5921,2948,0.0,2973
349320,The Rainy Port Keelung 雨港基隆,327,50,24.99,277
336420,Bloodsports.TV,430,131,9.99,299
346040,Joe's Diner,80,129,2.39,-49
329970,KeeperRL,853,109,15.99,744
339690,Paperbound,26,3,9.99,23
348400,BattleLore: Command,75,41,6.99,34
322920,theHunter: Primal,2320,1740,0.0,580
339610,Freestyle 2: Street Basketball,8611,3157,0.0,5454
359810,Hare In The Hat,259,124,1.99,135
335300,DARK SOULS™ II: Scholar of the First Sin,70117,12505,39.99,57612
342990,15 Days,44,90,9.99,-46
357900,Make it indie!,573,663,0.99,-90
331200,Grass Simulator,573,412,4.99,161
357930,R.O.O.T.S,35,27,1.99,8
355840,Survarium,13947,11886,0.0,2061
344910,Sun Blast: Star Fighter,392,244,1.99,148
324260,VoidExpanse,525,206,14.99,319
359560,Shutter,149,48,0.57,101
355080,Crazy Steam Bros 2,11,23,0.0,-12
334420,Out There: Ω Edition,1183,375,14.99,808
230190,War for the Overworld,5919,962,29.99,4957
341020,Chronicles of Teddy,206,89,14.99,117
357370,Return NULL - Episode 1,57,37,0.0,20
270150,RUNNING WITH RIFLES,11623,1570,14.99,10053
359320,Elite Dangerous,64084,18659,29.99,45425
354680,Adventures of Bertram Fiddle 1: A Dreadly Business,395,63,4.99,332
339850,Overclocked: A History of Violence,71,22,14.99,49
356530,The Confines Of The Crown,202,26,19.99,176
332390,Undefeated,129,27,5.99,102
321360,Primal Carnage: Extinction,6258,1386,12.99,4872
279740,3D ParticleGen Visual FX,43,25,9.99,18
242840,In Verbis Virtus,1292,335,19.99,957
354050,Starlight Tactics™,15,12,9.99,3
335830,Distant Star: Revenant Fleet,190,98,9.99,92
342350,Into The Gloom,169,42,2.99,127
339700,"I, Gladiator",96,55,7.99,41
359800,Copa Petrobras de Marcas,1551,865,0.0,686
305380,Blue Estate The Game,1275,125,12.99,1150
346780,Luminosity,52,8,4.99,44
325520,Fire: Ungh’s Quest,465,78,0.99,387
334560,Square Heroes,213,35,12.99,178
361380,World War I,163,50,4.99,113
327980,Dragon Fantasy: The Volumes of Westeria,36,7,9.99,29
300080,Total War Battles: KINGDOM,1863,1719,0.0,144
352140,Finders,118,34,5.99,84
361990,Lakeview Cabin Collection,1513,110,9.99,1403
252450,StarDrive 2,1140,869,29.99,271
327890,I Am Bread,4359,1247,12.99,3112
339190,Dead Synchronicity: Tomorrow Comes Today,1013,195,0.99,818
277520,Albedo: Eyes from Outer Space,137,122,14.99,15
340340,Domestic Dog,382,94,2.99,288
357780,Defend Your Life: TD,829,212,4.99,617
349440,The Undying Plague,55,86,0.99,-31
332380,Asguaard,79,14,9.99,65
271590,Grand Theft Auto V,1171197,210154,0.0,961043
307780,Mortal Kombat X,38951,7905,19.99,31046
297130,Titan Souls,8343,2278,14.99,6065
363490,Escape Machines,278,388,1.99,-110
357200,500 Years Act 1,20,45,7.99,-25
354930,Slinki,13,8,0.99,5
340730,Sunrider Academy,957,187,9.99,770
353550,House of Caravan,507,238,4.99,269
324570,Halo: Spartan Strike,954,221,2.99,733
343390,Elementary My Dear Majesty!,118,44,0.99,74
361630,404Sight,1357,243,0.0,1114
288930,The Charnel House Trilogy,478,115,5.99,363
359220,MX vs. ATV Unleashed,334,127,9.99,207
344840,Gratuitous Space Battles 2,114,163,9.99,-49
275200,Westerado: Double Barreled,1591,147,14.99,1444
363660,Island Flight Simulator,6,34,6.99,-28
361320,Casino Inc.,170,34,5.29,136
362920,Atlantis 2: Beyond Atlantis,25,55,3.99,-30
331790,Data Hacker: Reboot,112,78,1.99,34
360890,The Lost Valley,120,218,4.99,-98
365050,Escape,169,112,0.0,57
342650,Fermi's Path,35,18,8.99,17
365110,After All,19,16,2.99,3
363920,SWR JST DX Selective Memory Erase Effect,18,12,4.99,6
333580,"Slow Down, Bull",14,3,1.99,11
283040,Paper Dungeons,44,40,9.99,4
342090,The Clans - Saga of the Twins,21,40,9.99,-19
354380,Assassin’s Creed® Chronicles: China,2292,813,9.99,1479
329460,JumpJet Rex,415,56,9.99,359
318230,Convoy,1057,276,14.99,781
364770,Super Furball,47,9,3.99,38
348200,Nimble Writer,461,62,9.99,399
350070,Environmental Station Alpha,923,153,7.99,770
365290,House of Nightmares B-Movie Edition,3,1,0.99,2
307210,Will Fight for Food: Super Actual Sellout: Game of the Hour,49,37,4.99,12
316080,Parcel,109,18,4.99,91
285740,Kitty Powers' Matchmaker,1049,51,9.99,998
340810,Deepworld,431,291,0.0,140
319780,Airport Simulator 2015,62,94,17.99,-32
324140,Kalimba,399,25,9.99,374
360450,Kiai Resonance,154,40,4.99,114
320300,Car Mechanic Simulator 2015,12885,1081,19.99,11804
333210,Kaiju-A-GoGo,201,98,9.99,103
247080,Crypt of the NecroDancer,20795,856,14.99,19939
335560,Light Bound,19,3,9.99,16
352640,The Indie Mixtape,43,14,0.99,29
363620,Tea Party Simulator 2015™,461,210,9.99,251
352120,Fair Strike,50,15,3.99,35
363330,Mind Snares: Alice's Journey,621,88,9.99,533
359580,Uncanny Valley,273,213,9.99,60
362660,Blue Rose Reprise,84,51,15.99,33
364890,The Lost Battalion: All Out Warfare,46,50,4.99,-4
345820,Shantae and the Pirate's Curse,2185,148,19.99,2037
262280,Dungeons 2,3903,905,19.99,2998
363060,Let's Explore the Farm (Junior Field Trips),30,2,6.99,28
351150,DRAGON: A Game About a Dragon,404,189,4.99,215
362090,Siralim,215,32,9.99,183
366700,Breakout Invaders,32,33,3.99,-1
361190,Sparkle 3 Genesis,313,193,4.99,120
363050,Let's Explore the Airport (Junior Field Trips),51,3,6.99,48
264380,Narcissu 1st & 2nd,3674,189,0.0,3485
363070,Let's Explore the Jungle (Junior Field Trips),25,2,6.99,23
364940,Pony World 3,230,102,4.99,128
361830,in Space,82,19,0.99,63
358070,Earthtongue,175,16,4.99,159
264000,Son of Nor,125,76,19.99,49
364930,Koi-Koi Japan [Hanafuda playing cards],991,73,9.99,918
329430,State of Decay: YOSE,7872,1892,19.99,5980
354950,East Tower - Akio (East Tower Series Vol. 1),49,22,2.49,27
220200,Kerbal Space Program,99479,5321,9.99,94158
293240,Cosmochoria,412,49,9.99,363
354430,STAR WARS™ - X-Wing Special Edition,257,81,9.99,176
366610,Not without my donuts,23,24,1.99,-1
360870,Ultimate Tic-Tac-Toe,1223,256,0.0,967
361690,STAR WARS™ X-Wing vs TIE Fighter - Balance of Power Campaigns™,178,54,9.99,124
361670,STAR WARS™ - X-Wing Alliance™,329,62,9.99,267
355250,STAR WARS™: TIE Fighter Special Edition,412,88,9.99,324
347710,Perils of Man,171,46,9.99,125
328710,One Last Day,65,38,12.99,27
267750,Shadowrun Chronicles - Boston Lockdown,786,545,0.0,241
364270,Lilly and Sasha: Curse of the Immortals,307,78,0.0,229
312540,Ys VI: The Ark of Napishtim,843,93,19.99,750
242860,Verdun,30759,5104,19.99,25655
290650,Time Ramesside (A New Reckoning),66,296,0.49,-230
362490,Exanima,7068,1542,14.99,5526
355050,Sky Force Anniversary,1696,140,9.99,1556
363460,Spermination,367,60,1.99,307
362400,Regimental Chess,91,78,0.99,13
329240,The Weaponographist,58,22,9.99,36
312450,Order of Battle: World War II,1884,580,0.0,1304
299360,Block N Load,12067,3340,0.0,8727
297920,Space Colony: Steam Edition,374,111,4.49,263
296490,GemCraft - Chasing Shadows,3367,139,9.99,3228
348730,Abyss Raiders: Uncharted,58,80,4.99,-22
284990,Solarix,266,164,19.99,102
251130,Chroma Squad,3552,259,14.99,3293
322210,"Guns, Gore & Cannoli",2586,241,9.99,2345
358960,Canabalt,217,35,2.99,182
329610,R.B.I. Baseball 15,68,90,0.0,-22
329380,Stealth Inc 2: A Game of Clones,729,224,1.49,505
360010,Remnants Of Isolation,74,16,1.99,58
341950,Lux Delux,256,68,9.99,188
331460,ROOMS: The Toymaker's Mansion,104,10,14.99,94
356310,METAL SLUG DEFENSE,956,823,0.0,133
362620,Software Inc.,5125,324,15.99,4801
289760,ROCKETSROCKETSROCKETS,417,132,6.99,285
365210,Hollywood Visionary,75,9,4.99,66
350080,Wolfenstein: The Old Blood,13788,1689,19.99,12099
357300,Snakebird,886,67,6.99,819
365070,One Manga Day,541,365,0.0,176
365280,Alexia Crow and the Cave of Heroes,28,31,5.99,-3
351140,Rustbucket Rumble,210,163,0.0,47
353260,Snails,3,3,0.0,0
367670,Controller Companion,2176,216,2.99,1960
365420,Apollo4x,15,36,1.99,-21
358190,Blake Stone: Aliens of Gold,73,8,4.99,65
365620,WarBirds - World War II Combat Aviation,31,31,14.99,0
363790,Egg Returns Home,388,107,0.0,281
334030,Epic Arena,191,99,0.0,92
318860,Malebolgia,79,47,12.99,32
366670,The Travels of Marco Polo,32,13,6.99,19
323670,Super Indie Karts,320,66,14.99,254
317940,Karmaflow: The Rock Opera Videogame - Act I & Act II,136,57,4.99,79
359040,The Music Machine,340,42,4.99,298
272890,Vertiginous Golf,617,456,9.99,161
356210,Tony Tough and the Night of Roasted Moths,18,12,9.99,6
354600,Decisive Campaigns: Case Blue,42,5,39.99,37
361970,Weather Lord: The Successor's Path,21,9,4.99,12
342100,Sym,31,5,7.99,26
359630,Independence War® 2: Edge of Chaos,51,19,5.99,32
359650,Star Trek™ : 25th Anniversary,101,11,9.99,90
269650,Dex,2655,389,19.99,2266
287140,Selfie : Sisters of the Amniotic Lens,111,74,0.0,37
355530,Last Word,309,64,9.99,245
364810,Star Trek™: Starfleet Academy,82,17,9.99,65
358770,The Reject Demon: Toko Chapter 0 — Prelude,155,29,4.99,126
368250,Valiant: Resurrection,38,13,6.99,25
362780,18 Wheels of Steel: Extreme Trucker 2,102,33,9.99,69
287960,Yomi,112,24,14.99,88
360380,Tiny Bridge: Ratventure,626,326,4.99,300
366800,Mainland,198,42,0.0,156
357720,Inside My Radio,397,53,14.99,344
340350,Quintet,272,89,0.0,183
320820,Toren,822,466,9.99,356
346830,FINAL FANTASY IV: THE AFTER YEARS,280,166,15.99,114
368650,Dark Echo,693,54,2.99,639
369000,Pongo,351,150,0.99,201
336150,Virtual Pool 4,444,90,24.99,354
361020,Luxor HD,93,11,9.99,82
365400,Spoko and Poko,8,9,3.99,-1
285820,Action Henk,706,95,14.99,611
355970,Home is Where One Starts...,460,138,2.99,322
368950,Jigoku Kisetsukan: Sense of the Seasons,1635,118,0.0,1517
300340,Lemma,195,35,14.99,160
278910,Interplanetary,623,167,0.0,456
335450,Curse of the Assassin,19,2,4.99,17
282640,LOST ORBIT,46,2,11.99,44
243970,"Invisible, Inc.",4701,419,19.99,4282
368990,Despair,644,1232,0.99,-588
335460,An Assassin in Orlandes,69,13,4.99,56
326410,Windward,2699,676,9.99,2023
350530,Airport Firefighters - The Simulation,94,107,17.99,-13
363970,Clicker Heroes,51870,5804,0.0,46066
369640,Treeker: The Lost Glasses Remake,38,26,2.99,12
344480,Quell,327,7,3.99,320
371400,Downpour,8,6,0.99,2
226860,Galactic Civilizations III,7594,2317,39.99,5277
315660,Trainz: A New Era,1550,575,19.99,975
368220,Close Combat - Panthers in the Fog,108,48,39.99,60
332200,Axiom Verge,4480,389,19.99,4091
348430,Quell Reflect,123,4,3.99,119
338180,Batla,1969,1155,0.0,814
359260,Green Moon,15,12,6.99,3
330660,Luna's Wandering Stars,63,43,9.99,20
364480,Red Goblin: Cursed Forest,13,18,4.99,-5
371500,Grey Cubes,402,53,0.0,349
310360,Higurashi When They Cry Hou - Ch.1 Onikakushi,3412,157,0.0,3255
370080,Breezeblox,73,9,2.99,64
351090,Regency Solitaire,613,36,9.99,577
292030,The Witcher® 3: Wild Hunt,617738,25020,39.99,592718
367110,Dustbowl,92,27,8.99,65
353330,Love at First Sight,1149,50,9.99,1099
371190,Making History: The Calm and the Storm Gold Edition,132,23,4.99,109
266310,GameGuru Classic,1454,538,12.49,916
363430,D Series OFF ROAD Driving Simulation,24,39,7.99,-15
286940,S.K.I.L.L. - Special Force 2 (Shooter),8105,3413,0.0,4692
304950,Castaway Paradise - live among the animals,405,158,14.99,247
351800,Dev Guy,1383,353,0.0,1030
296710,Monstrum,2512,236,17.99,2276
346340,Gran Vitreous,24,7,4.99,17
310740,NEON STRUCT,258,56,17.99,202
365860,Spaceman Sparkles 2,53,16,1.49,37
356420,Interloper,321,58,0.0,263
369370,Crossfire: Dungeons,34,38,3.99,-4
363410,Always The Same Blue Sky...,170,55,2.99,115
287600,Sunset,180,79,19.99,101
352620,Porcunipine,114,34,0.99,80
353980,Ankh - Anniversary Edition,75,18,7.99,57
263060,Blockstorm,5196,1280,4.99,3916
354180,Bunker - The Underground Game,44,27,3.99,17
370300,8-Bit Adventures 1: The Forgotten Journey Remastered Edition,94,19,9.99,75
372930,New York Mysteries: Secrets of the Mafia,252,20,6.99,232
371420,Teddy Floppy Ear - The Race,765,221,4.99,544
370310,Tompi Jones,36,69,3.99,-33
343930,Fort Defense,263,84,4.99,179
370070,Wyrmsun,194,49,0.0,145
371330,Two Digits,271,103,1.99,168
359900,The Incredible Adventures of Van Helsing III,695,410,14.99,285
339280,Strife®,3644,1170,0.0,2474
332610,Mystik Belle,171,20,8.99,151
367300,Pixel Star,105,16,2.99,89
370150,LOOP: A Tranquil Puzzle Game,120,4,4.99,116
345890,NASCAR '15 Victory Edition,739,218,9.99,521
361620,True Bliss,39,49,5.99,-10
370640,Midnight's Blessing,24,18,0.49,6
373140,Grail to the Thief,21,15,0.0,6
354650,MISSING: An Interactive Thriller - Episode One,533,100,0.0,433
362610,High On Racing,124,136,4.99,-12
359280,Heroes of Loot,56,26,4.99,30
368360,60 Seconds!,9064,1724,8.99,7340
370040,Lilly and Sasha: Nexus of Souls,39,22,0.0,17
367000,Fine Sweeper,383,53,5.99,330
344410,Magnetic: Cage Closed,214,100,14.99,114
238370,Magicka 2,8850,1949,14.99,6901
278570,Labyrinthine Dreams,255,66,1.99,189
361850,Portal of Evil: Stolen Runes Collector's Edition,372,35,4.99,337
235800,Audiosurf 2,4667,1018,14.99,3649
373290,Stones of Sorrow,51,42,2.99,9
348550,GUILTY GEAR XX ACCENT CORE PLUS R,4701,164,14.99,4537
269670,BADLAND: Game of the Year Edition,2301,362,9.99,1939
371550,A Bastard's Tale,261,60,4.99,201
333980,AKIBA'S TRIP: Undead ＆ Undressed,2610,395,19.99,2215
357890,Vortex Attack: ボルテックスアタック,78,15,7.99,63
363500,Ossuary,33,3,9.99,30
293520,Carnivores: Dinosaur Hunter Reborn,573,209,14.99,364
329860,Catlateral Damage,1117,132,9.99,985
356540,East Tower - Takashi (East Tower Series Vol. 2),23,16,2.99,7
375180,Lunch Truck Tycoon,169,91,0.99,78
278440,0RBITALIS,207,83,9.99,124
373440,Stargazer,74,30,4.99,44
343440,Crash Drive 2,1103,133,1.24,970
346850,Chip's Challenge 1,618,63,0.0,555
352960,Star Horizon,83,59,9.99,24
373180,Kung Fury: Street Rage,2183,235,0.0,1948
350310,BLADESTORM: Nightmare,244,141,59.99,103
335120,Serpent in the Staglands,114,58,13.99,56
369290,Airport Madness: World Edition,243,71,9.99,172
322970,Subject 13,166,117,9.99,49
373870,Sister’s Secrecy: Arcanum Bloodlines - Premium Edition,33,22,6.99,11
352130,Locoland,95,26,4.99,69
345080,Flame Over,118,46,11.99,72
244910,Homesick,1012,280,14.99,732
366210,Sleep Attack,47,15,6.99,32
348300,Chip's Challenge 2,93,15,4.99,78
371850,Football Mogul 2014,27,13,0.99,14
352520,The Silent Age,6162,442,9.99,5720
257170,Rebuild 3: Gangs of Deadsville,1437,236,14.99,1201
326120,Horizon Shift,242,71,4.99,171
373670,Arkhelom 3D,18,23,3.99,-5
365900,Pixel Dungeon,344,40,4.99,304
332250,The Next Penelope,184,74,12.99,110
343340,Tiamat X,39,70,1.99,-31
284160,BeamNG.drive,127265,4196,24.99,123069
371900,Pillar,33,16,7.99,17
351490,Intergalactic Bubbles,927,234,1.99,693
375200,Sakura Fantasy,933,127,9.99,806
357280,Alter World,354,175,7.99,179
345610,The Fruit of Grisaia,883,58,39.99,825
362830,3D MiniGolf,28,45,4.99,-17
351710,Hyperdimension Neptunia Re;Birth2: Sisters Generation,2817,235,14.99,2582
347620,Gaokao.Love.100Days,6206,344,9.99,5862
369180,SoulCraft,57,62,0.99,-5
371100,Waste Walkers,155,38,9.99,117
368720,Sirius,100,101,4.99,-1
341940,Hatred,10229,2532,5.99,7697
246110,MASSIVE CHALICE,1271,485,19.99,786
260430,The Four Kings Casino and Slots,2414,1115,0.0,1299
340860,RaidersSphere4th,109,43,19.99,66
371390,Flix The Flea,78,121,2.99,-43
370550,Sparkle 2,164,16,7.99,148
341680,stratO,50,9,4.99,41
359440,Artifact Adventure,115,39,6.99,76
356510,Soccer Rage,549,116,9.99,433
371890,Gunslugs,85,28,4.99,57
375020,Al Emmo's Postcards from Anozira,19,14,4.99,5
369890,Riddled Corpses,148,72,7.99,76
348840,UFHO2,22,3,0.0,19
278970,Digger Online,8680,9621,3.99,-941
368610,The Enchanted Cave 2,534,62,9.99,472
349720,Audition Online,914,579,0.0,335
339210,RESCUE 2: Everyday Heroes,155,95,24.99,60
375330,Butsbal,35,34,0.0,1
343090,SimpleRockets,293,51,7.99,242
371670,Rolling Sun,394,418,1.99,-24
356170,Tile Rider,10,4,3.99,6
349680,Supercharged Robot VULKAISER,263,17,4.99,246
312530,Duck Game,32180,1165,12.99,31015
367120,Seduce Me the Otome,1858,292,0.0,1566
375510,New kind of adventure,612,879,1.99,-267
371000,Cave Coaster,32,27,4.99,5
313080,The Masterplan,327,189,19.99,138
303550,Adventures of Pip,210,27,9.99,183
290890,You Must Build A Boat,803,168,4.99,635
325120,Notch - The Innocent LunA: Eclipsed SinnerS,572,119,9.99,453
375420,The Architect,21,11,0.0,10
375460,16bit Trader,681,963,0.53,-282
372210,Spooky Cats,340,64,2.99,276
337680,Star Hammer: The Vanguard Prophecy,108,37,19.99,71
375130,Tin Star,268,12,4.99,256
371570,Tap Heroes,947,317,2.99,630
331570,Wimp: Who Stole My Pants?,36,9,3.99,27
360640,12 Labours of Hercules II: The Cretan Bull,1814,200,2.99,1614
376730,Monument,591,171,1.99,420
286160,Tabletop Simulator,50562,3498,19.99,47064
358090,D4: Dark Dreams Don’t Die -Season One-,1530,366,14.99,1164
362860,Sylvio,108,29,12.99,79
376920,Tiki Man,170,59,1.94,111
365800,AdvertCity,49,35,19.99,14
367780,Aero's Quest,57,36,4.99,21
377460,Chicken Invaders 3,235,17,4.99,218
355240,NEO AQUARIUM - The King of Crustaceans -,248,62,8.99,186
374410,TransPlan,240,19,2.99,221
336230,Way to Go!,24,3,4.99,21
374010,Sherlock Holmes Consulting Detective: The Case of the Mummy's Curse,38,18,3.99,20
371280,Rolling Shapes,22,15,0.99,7
375770,Quantum Conscience,36,16,4.99,20
322540,Galactic Inheritors,37,43,19.99,-6
343710,Kholat,4143,2003,3.99,2140
377760,Fox & Flock,158,27,1.99,131
342020,BiT Evolution,95,77,9.99,18
336250,Monster Jam Battlegrounds,57,69,0.0,-12
372820,Shot In The Dark,78,86,0.0,-8
377120,Chronicle Keepers: The Dreaming Garden,75,48,4.99,27
275060,Alone in the Dark: Illumination™,67,253,19.99,-186
354620,Miner Warfare,110,22,0.53,88
351250,Avalanche 2: Super Avalanche,203,32,4.99,171
352400,LEGO® Jurassic World,5805,572,19.99,5233
378110,Hack RUN,162,32,2.99,130
322850,Pro Cycling Manager 2015,231,146,4.99,85
351640,Eternal Senia,11400,285,0.0,11115
367550,Rugby League Team Manager 2015,34,16,4.99,18
341540,TRIP Steam Edition,136,154,4.99,-18
375120,Super Star Path,262,60,4.99,202
377600,Tcheco in the Castle of Lucio,834,95,0.99,739
372740,Second Warfare,24,73,14.99,-49
379960,Mahjong Pretty Girls Battle : School Girls Edition,157,92,14.99,65
381870,Koala Kids,201,19,1.99,182
380580,SpaceCorn,243,152,0.99,91
371970,Barony,3214,276,14.99,2938
371180,Super 3-D Noah's Ark,678,83,1.99,595
208650,Batman™: Arkham Knight,73952,14371,19.99,59581
355130,MotoGP™15,650,181,14.99,469
352160,Curse of Mermos,152,112,0.0,40
329050,Devil May Cry 4 Special Edition,10442,1105,24.99,9337
355810,Centauri Sector,28,17,4.99,11
352070,Fort Meow,223,15,7.99,208
380120,Celia's Quest,29,14,3.99,15
363610,Botology,115,225,0.99,-110
294190,A-Men 2,13,13,8.99,0
380560,Spandex Force: Champion Rising,39,21,9.99,18
368370,Her Story,7138,829,1.99,6309
340360,Tomb of Tyrants,250,51,7.99,199
363090,NOBUNAGA'S AMBITION: Kakushin with Power Up Kit,165,43,54.99,122
379600,Diner Mania,88,39,3.99,49
316930,Kings of Kung Fu,442,241,0.99,201
363130,Toukiden: Kiwami,836,390,59.99,446
367260,Dwarven Brawl Bros,30,6,4.99,24
345240,SHOGUN: Total War™ - Collection,634,87,9.99,547
366970,Mighty Switch Force! Hyper Drive Edition,234,17,9.99,217
366250,METAL SLUG,2415,301,7.99,2114
379290,Sumo Revise,66,71,0.0,-5
350910,Streets of Fury EX,557,23,9.99,534
345260,Medieval: Total War™ - Collection,1116,507,9.99,609
359230,Lethis - Path of Progress,775,338,19.99,437
377660,Blockwick 2,166,3,9.99,163
371410,Hostile Dimension,10,12,1.99,-2
375250,Pizza Express,183,36,6.99,147
363110,NOBUNAGA'S AMBITION: Tendou with Power Up Kit,112,33,54.99,79
373330,All Is Dust,580,722,0.0,-142
263640,CDF Ghostship,42,62,9.99,-20
382080,Action Alien,170,158,5.99,12
373810,Hot Pinball Thrills,14,27,1.19,-13
356550,East Tower - Kuon (East Tower Series Vol. 3),20,9,8.99,11
378370,Nomad,2736,1833,0.0,903
351480,Age of Fear: The Undead King,311,38,4.99,273
362130,Ashes of Immortality,64,16,11.99,48
364840,N2O: Nitrous Oxide,27,6,4.99,21
380690,Don'Yoku,18,18,3.99,0
265810,The Sandbox,319,235,4.99,84
378510,"Witches, Heroes and Magic",6,18,7.99,-12
366960,SECTOR,28,95,0.0,-67
351510,Quiplash,1583,186,9.99,1397
380550,Incandescent,85,40,0.99,45
300570,Infinifactory,2091,117,24.99,1974
274230,RONIN,1524,659,12.99,865
369040,Yargis - Space Melee,108,78,2.99,30
383100,Fragile Allegiance,79,4,5.29,75
370050,Scarab Tales,40,4,4.99,36
380000,MiniOne Racing,24,16,4.99,8
349140,Corrosion: Cold Winter Waiting [Enhanced Edition],156,73,7.99,83
368760,Playing History: Vikings,18,23,0.99,-5
375010,Energy Balance,192,87,2.99,105
374380,Revolution Under Siege Gold,96,33,24.99,63
246760,Legends of Eisenwald,1258,386,19.99,872
344440,Sacra Terra: Angelic Night,271,44,2.99,227
360150,How To Survive: Third Person Standalone,694,536,9.99,158
242130,Vector Thrust,343,349,24.99,-6
369580,NotTheNameWeWanted,2333,342,2.99,1991
252130,Divide By Sheep,2246,223,4.99,2023
327220,Anna's Quest,1653,221,1.99,1432
294040,Loot Hero DX,1047,365,2.99,682
383670,Deadlands Noir - That Old Time Religion,27,9,0.99,18
352700,Subspace Continuum,475,66,0.0,409
300400,Unpossible,111,19,2.99,92
361930,Farm Frenzy: Hurricane Season,81,8,1.04,73
345440,Vapour,67,106,9.99,-39
384950,Macabre,15,11,0.0,4
252950,Rocket League®,493188,62447,0.0,430741
367580,Hook,8240,251,1.99,7989
384300,CPUCores :: Maximize Your FPS,8416,3358,14.99,5058
366590,Prompt,43,4,2.0,39
382380,The Amber Throne,137,30,14.99,107
365260,Crash Dive,142,19,3.99,123
367570,oO,816,91,0.99,725
385230,Ninjahtic,62,18,1.99,44
348950,Ame no Marginal -Rain Marginal-,314,53,12.99,261
383520,Lilly and Sasha: Guardian Angels,40,32,0.0,8
370510,Marble Mayhem: Fragile Ball,701,346,1.99,355
356910,Battle Fantasia -Revised Edition-,113,59,14.99,54
360590,"Once Bitten, Twice Dead!",16,102,4.99,-86
383330,Star Chronicles: Delta Quadrant,168,117,1.99,51
274920,FaceRig,6860,1614,0.0,5246
319280,Yatagarasu Attack on Cataclysm,187,95,14.99,92
340270,TIMEframe,424,216,5.99,208
385400,Weapons Genius,458,591,0.99,-133
320540,Coffin Dodgers,487,219,10.99,268
254840,Ground Control II: Operation Exodus,172,25,4.99,147
384980,Battle for Blood - Epic battles within 30 seconds!,557,204,0.0,353
381590,Shred! Remastered,63,44,4.99,19
341550,Super Cyborg,587,82,4.99,505
254820,Ground Control Anthology,117,17,4.99,100
379320,Clandestinity of Elsie,107,29,0.0,78
375170,Gunpowder,31,7,1.99,24
351050,Cricket Captain 2015,41,21,9.99,20
304050,Trove,70446,16935,0.0,53511
327520,Traverser,69,28,14.99,41
370540,Gary Grigsby's War in the East,470,50,79.99,420
286570,F1 2015,5383,3165,0.0,2218
333490,Replay - VHS is not dead,40,4,9.99,36
381560,Epic Cards Battle(TCG),384,373,0.0,11
370920,Cosmophony,85,15,4.99,70
370600,Hello Kitty and Sanrio Friends Racing,56,34,19.99,22
265590,The Red Solstice,1706,648,9.99,1058
323380,The Magic Circle,1219,99,19.99,1120
332400,Girlfriend Rescue,170,30,4.99,140
373390,Contradiction: Spot The Liar,2535,113,12.99,2422
365350,How to Take Off Your Mask,139,25,11.99,114
359250,City of Fools,57,24,7.99,33
364350,The Apotheosis Project,45,34,0.99,11
375930,Trap Them,40,9,4.99,31
324760,Monster Truck Destruction,147,170,4.99,-23
386880,Rake,2928,1258,4.99,1670
269770,Secrets of Grindea,5223,514,14.99,4709
363600,Holy Potatoes! A Weapon Shop?!,1364,517,0.99,847
293260,Card Hunter,4157,680,0.0,3477
347400,001 Game Creator,204,57,79.99,147
362810,Fighties,223,42,4.99,181
372030,Starship Rubicon,36,6,9.99,30
368890,AR-K: The Great Escape,99,11,7.99,88
317820,Guild of Dungeoneering Ultimate Edition,1855,549,19.99,1306
372940,Lost Lands: The Four Horsemen,236,15,6.99,221
383630,SEEP Universe,43,14,2.99,29
369060,Amygdala,11,23,9.99,-12
385860,Tachyon Project,42,17,9.99,25
319480,Odallus: The Dark Call,1023,126,9.99,897
293160,AntharioN,121,57,14.99,64
333640,Caves of Qud,4913,224,19.99,4689
370090,Axis Football 2015,259,116,3.99,143
378480,Badland Bandits,64,87,0.0,-23
361950,MOAI 2: Path to Another World,45,13,7.99,32
383560,Squarelands,82,80,3.99,2
377290,Biodrone Battle,140,133,1.99,7
323900,March of War: FaceOff - M,323,109,0.0,214
359960,Choice Chamber,198,71,9.99,127
270910,Worms World Party Remastered,680,660,2.99,20
356370,Soccer Manager 2015,356,160,0.0,196
387880,Ninjahtic Mind Tricks,21,14,1.99,7
312440,Legions of Steel,22,21,19.99,1
385070,Atonement: Scourge of Time,254,108,5.99,146
384680,MechaNika,632,62,3.99,570
358810,Luckslinger,100,21,9.99,79
382480,Super Dungeon Run,84,50,4.99,34
343630,CroNix,209,235,0.0,-26
354200,Aberoth,891,487,0.0,404
385590,Lethal RPG: War,155,44,0.0,111
385150,Stranded In Time,83,26,0.99,57
331500,Executive Assault,1228,198,12.99,1030
380360,Tap Tap Infinity,676,229,0.0,447
386160,Vampire of the Sands,61,26,4.99,35
368730,No Time To Explain Remastered,1852,496,14.99,1356
296550,Niko: Through The Dream,143,44,9.99,99
376560,Big Fish Legend,101,23,0.0,78
388340,Super Hipster Lumberjack,328,101,0.5,227
370360,TIS-100,3358,109,6.99,3249
319570,Heroes of SoulCraft - Arcade MOBA,194,286,0.0,-92
386600,Pixel Fodder,111,26,0.0,85
310890,Breach & Clear: Deadline Rebirth (2016),453,381,9.99,72
373360,Cast of the Seven Godsends - Redux,94,61,9.99,33
388390,Glow Ball - The billiard puzzle game,29,98,2.99,-69
368710,Power of Love,76,36,0.9,40
341870,TEMBO THE BADASS ELEPHANT,390,136,14.99,254
368160,WORLD END ECONOMiCA episode.02,212,11,12.99,201
284220,Diadra Empty,60,19,5.99,41
372150,Yasai Ninja,15,33,1.99,-18
385700,Battle For The Sun,24,40,4.99,-16
316430,Battle of Empires : 1914-1918,1382,632,8.99,750
389270,Through Abandoned: The Underground City,255,68,0.99,187
378660,Blues and Bullets,847,511,4.99,336
364690,SUPER DISTRO,405,692,0.99,-287
382920,RETSNOM,66,20,4.99,46
368600,Terra Nova: Strike Force Centauri,61,3,5.99,58
369420,9 Clues 2: The Ward,735,62,9.99,673
375850,Island Defense,57,51,1.99,6
312780,Way of the Samurai 4,1288,318,24.99,970
327500,Zenzizenzic,73,12,9.99,61
389460,Robot vs Birds Zombies,35,82,0.99,-47
388090,Five Nights at Freddy's 4,9527,744,7.99,8783
327060,FEIST,376,121,9.99,255
295910,Olympia Rising,72,28,4.99,44
343280,Zotrix,121,79,12.99,42
385900,Arevan,21,20,4.99,1
364510,Transcendence,142,11,14.99,131
361550,Cradle,1206,517,12.99,689
387850,Airport Madness 4,104,37,9.99,67
345180,Victor Vran ARPG,5061,803,19.99,4258
383750,Funk of Titans,74,26,6.99,48
386260,Microcosmum: survival of cells,1074,198,7.99,876
388270,Baseball Mogul 2015,35,12,4.99,23
313810,Legend of Kay Anniversary,193,82,19.99,111
358030,Another Star,38,3,2.99,35
356790,Galacide,76,12,9.99,64
341030,Colonial Conquest,144,87,9.99,57
369110,The Swindle,357,210,14.99,147
383960,Machina of the Planet Tree -Planet Ruler-,145,33,12.99,112
345390,King's Quest,2257,265,0.0,1992
389900,Hogs of War,196,149,5.29,47
356670,Spooky's Jump Scare Mansion,12105,929,0.0,11176
314560,Kyn,88,59,19.99,29
390910,Collisions,191,58,4.99,133
352220,King of Dragon Pass,336,82,11.99,254
379990,Hush,13,33,9.99,-20
316010,Magic Duels,16976,7015,0.0,9961
389400,The chronicles of Emerland. Solitaire.,109,33,3.99,76
320140,Absolute Drift,2365,303,11.99,2062
377720,Idol Magical Girl Chiru Chiru Michiru Part 2,68,12,19.99,56
383080,Sakura Clicker,12459,2383,0.0,10076
377710,Idol Magical Girl Chiru Chiru Michiru Part 1,155,19,19.99,136
386110,Raywin,24,53,2.99,-29
301500,BOMB: Who let the dogfight?,47,28,7.99,19
389570,Mitos.is: The Game,9485,2258,0.0,7227
350780,MANOS: The Hands of Fate ~ Director's Cut,155,36,1.99,119
391070,Stellar 2D,379,587,1.99,-208
371310,Karos Returns,360,134,0.0,226
378830,The Princess' Heart,31,18,4.99,13
391160,The Deletion,158,51,1.99,107
357750,Damn virgins,25,4,2.99,21
370780,Fated Souls,33,25,4.99,8
388160,Project Druid - 2D Labyrinth Explorer-,29,100,1.99,-71
348340,Siege Wars,97,47,1.99,50
377470,ENKI,96,60,4.99,36
365020,Gynophobia,449,225,1.59,224
381220,Hydraulic Empire,36,32,7.99,4
388500,Super Space Meltdown,6,19,3.99,-13
386420,Job the Leprechaun,139,34,2.99,105
391590,Dream Chamber,29,22,0.99,7
280010,Gunjitsu,696,167,3.99,529
320340,Cosmonautica,540,574,9.99,-34
229580,Dream,544,424,8.99,120
360550,Cursed Sight,165,30,4.99,135
226100,PixelJunk™ Nom Nom Galaxy,709,232,9.99,477
301860,Submerged,3247,1054,19.99,2193
292600,Duet,692,41,4.99,651
391270,Fingerbones,2541,686,0.0,1855
389700,My Bones,167,192,0.99,-25
362410,Adam's Venture Chronicles,174,81,9.99,93
324730,Caverns of the Snow Witch (Standalone),24,8,4.99,16
375430,The Logomancer,6,5,3.99,1
381610,Dandy: Or a Brief Glimpse Into the Life of the Candy Alchemist,37,12,9.99,25
386990,Asphyxia,178,59,5.99,119
380700,Zombie Killtime,23,19,1.99,4
376140,SAGA,66,58,0.0,8
347830,Fairy Fencer F,2107,235,9.99,1872
382300,Kidnapped,301,238,2.99,63
383710,Princess Kaguya: Legend of the Moon Warrior,25,54,10.99,-29
374950,ADventure Lib,42,59,1.99,-17
385710,INK,1273,288,4.99,985
377310,The Tower Of Elements,185,136,1.99,49
352580,Hidden: On the trail of the Ancients,53,27,9.99,26
368780,President for a Day - Corruption,25,33,0.99,-8
373970,Letter Quest: Grimm's Journey Remastered,408,36,1.99,372
370200,Two Steps Back,8,13,2.99,-5
372830,Fitz the Fox,100,23,3.99,77
360390,Nightside,68,47,2.99,21
386700,The Oil Blue: Steam Legacy Edition,122,46,4.99,76
367350,Demon Hearts,51,15,3.99,36
360650,12 Labours of Hercules III: Girl Power,814,130,2.99,684
378270,Putrefaction,287,133,0.99,154
370700,Black Home,44,16,4.99,28
354560,We Are Legion,41,97,9.99,-56
315860,Celestian Tales: Old North,290,127,12.99,163
387070,One Final Breath™,20,94,3.99,-74
390660,Call of Tomsk-7,371,83,0.99,288
240620,Wanderlust Adventures,148,98,9.99,50
391740,Blaster Shooter GunGuy!,178,228,1.99,-50
337210,Royal Bounty HD,94,61,2.99,33
387860,the static speaks my name,4336,983,0.0,3353
272330,Shadow Blade: Reload,287,39,9.99,248
317250,Airscape - The Fall of Gravity,2185,478,4.99,1707
385390,Hidden Mysteries: Civil War,13,20,4.99,-7
356050,Beyond Eyes,1031,500,0.0,531
365660,OlliOlli2: Welcome to Olliwood,467,93,14.99,374
389250,Planet Alcatraz 2,205,15,4.99,190
392450,Silver Creek Falls: Chapter 1,517,81,0.0,436
379760,Gravity Error,48,6,4.99,42
386900,The Cat Machine,127,10,14.99,117
365450,Hacknet,19858,1371,9.99,18487
368770,President for a Day - Floodings,27,24,0.99,3
363580,PING 1.5+™,17,5,4.99,12
365680,BRAWL,52,25,14.99,27
349460,Lord of the Dark Castle,40,19,0.49,21
357070,UBERMOSH,2298,274,0.49,2024
386840,Sentinel 4: Dark Star,45,9,6.99,36
377520,Pike and Shot : Campaigns,215,69,39.99,146
383590,Expert Rifleman - Reloaded,18,11,14.99,7
391260,Labyronia RPG,874,323,1.99,551
391170,Void Invaders,296,47,2.99,249
352010,Beach Bounce,228,111,3.99,117
392920,Arvale,69,17,4.99,52
390570,Three Digits,75,74,1.99,1
377680,Sakura Beach,1114,275,9.99,839
391340,Ferrum's Secrets: Where Is Grandpa?,46,66,4.99,-20
381900,Bard's Gold,102,28,7.99,74
325790,Fallen: A2P Protocol,86,139,9.99,-53
335820,Dream Of Mirror Online,293,224,0.0,69
271360,Industry Giant 2,656,109,2.99,547
363510,STAR-BOX: RPG Adventures in Space,41,43,4.99,-2
373730,Way of Gold and Steel,72,41,8.99,31
385800,NEKOPARA Vol. 0,15877,1004,2.99,14873
376760,Big Thinkers Kindergarten,44,10,6.99,34
381140,Cruel Arena,209,107,0.99,102
372800,RPG MO,2110,558,0.0,1552
340170,FINAL FANTASY TYPE-0™ HD,1718,1064,29.99,654
386070,Planetary Annihilation: TITANS,10393,1903,29.99,8490
365770,Volume,508,158,19.99,350
376770,Big Thinkers 1st Grade,51,6,6.99,45
307620,Curses 'N Chaos,69,48,9.99,21
384360,Fingered,655,222,1.87,433
382490,Relic Hunters Zero: Remix,6338,423,0.0,5915
339230,ZOMBI,1461,829,19.99,632
354640,The Settlers Online,398,675,0.0,-277
347510,Rats - Time is running out!,247,39,0.0,208
337180,Velocity 2X,84,47,0.0,37
355350,Reign of Bullets,73,19,9.99,54
375950,Viridi,7517,658,0.0,6859
343560,Bob Was Hungry,520,69,9.99,451
391660,Incitement 3,94,50,5.99,44
330270,Warlocks vs Shadows,172,113,13.99,59
390940,The Musketeers: Victoria's Quest,33,14,3.99,19
269690,RymdResa,218,72,11.99,146
381170,Lost in Paradise,40,34,2.99,6
319910,Trine 3: The Artifacts of Power,5016,2776,21.99,2240
391580,Egyptian Senet,237,62,3.99,175
358650,Gryphon Knight Epic,216,45,12.99,171
393950,Get Over Here,12,18,9.99,-6
388440,Big Journey to Home,18,26,2.99,-8
330670,DiscStorm,28,4,11.99,24
346940,Shadowrun: Hong Kong - Extended Edition,3578,562,19.99,3016
384570,Zanzarah: The Hidden Portal,589,260,7.99,329
322950,Pure Hold'em,53,48,19.99,5
363670,Seeders,27,17,4.99,10
314070,Super Mega Baseball: Extra Innings,819,90,12.99,729
392930,A Sirius Game,31,29,4.99,2
365120,Curse of the Crescent Isle DX,66,27,0.99,39
290490,The Flock,124,178,16.99,-54
354920,Pester,51,46,0.99,5
391000,Farm Frenzy Collection,200,8,2.99,192
363980,Forget Me Not: My Organic Garden,323,63,9.99,260
388420,In Between,322,56,1.19,266
367710,Afterlife Empire,44,43,4.99,1
355500,Leadwerks Game Launcher,33,13,0.0,20
350970,Planet of the Eyes,421,86,9.99,335
337350,Flywrench,267,10,6.99,257
230290,Universe Sandbox,16835,706,29.99,16129
385060,The Last Warlock,51,7,4.99,44
293460,I Shall Remain,105,47,9.99,58
395380,ANKI,86,47,0.99,39
363440,Mega Man Legacy Collection,3020,496,14.99,2524
391030,Hard to Be a God,69,13,7.99,56
387970,Clown House (Palyaço Evi),539,566,0.0,-27
393980,Pretty Girls Mahjong Solitaire,544,164,4.99,380
380840,Teeworlds,3789,474,0.0,3315
325370,Nova-111,129,36,4.99,93
359310,Evoland 2,3281,466,19.99,2815
332530,Shutshimi,106,54,4.99,52
310490,Crookz - The Big Heist,245,56,9.99,189
391210,Arclight Cascade,33,8,0.0,25
308173,Hegemony III: Clash of the Ancients,374,91,29.99,283
369080,Age of Survival,26,203,18.99,-177
378100,Nyctophobia,262,329,1.99,-67
356570,Party Hard,7645,960,9.99,6685
359390,Amnesia™: Memories,2758,235,9.99,2523
297720,Corpse of Discovery,115,62,1.99,53
394140,Sound Shift,116,24,0.0,92
385260,Lamia Must Die,114,76,0.0,38
395930,Farm Frenzy: Heave Ho,76,10,0.74,66
356130,Heroes of Scene,333,341,0.0,-8
352900,Giana Sisters: Dream Runners,25,22,9.99,3
348510,Autobahn Police Simulator,620,1455,9.99,-835
277650,Kult: Heretic Kingdoms,100,34,4.99,66
386870,Playing History 2 - Slave Trade,79,63,1.99,16
344850,Big Pharma,1351,407,24.99,944
349220,The Black Watchmen,630,73,9.99,557
384310,Dead In Bermuda,368,123,14.99,245
378580,Untamed: Life Of A Cougar,76,49,14.99,27
394680,Mountain Crime: Requital,325,47,2.99,278
331600,One Piece Pirate Warriors 3,6676,1642,5.99,5034
369400,Let the Cat in,778,231,0.0,547
362680,Fran Bow,11175,334,14.99,10841
316890,Calvino Noir,235,128,6.99,107
268870,Satellite Reign,3476,1402,29.99,2074
310850,Onikira - Demon Killer,138,217,1.39,-79
381910,Xenocide,23,6,2.99,17
390880,Redemption: Eternal Quest,51,59,0.99,-8
386050,Proto Raider,79,21,11.99,58
362140,Ashes of Immortality II,18,19,4.99,-1
356890,One More Line,167,65,2.99,102
315330,All Guns On Deck,167,305,12.99,-138
388800,Azure Striker Gunvolt,1216,182,7.49,1034
356520,Port of Call,1032,125,0.0,907
385330,Stray Cat Crossing,526,40,2.99,486
363240,Caveman Craig,83,24,4.99,59
397500,Labyronia RPG 2,452,150,1.99,302
340830,Razenroth,454,106,4.99,348
382130,Exile's End,33,13,9.99,20
398920,Tisnart Tiles,20,9,0.99,11
287920,Mortal Online,1526,1405,0.0,121
385490,MiniDrivers,68,56,0.0,12
380150,STASIS,1336,303,4.99,1033
399430,Tinboy,299,178,4.99,121
361160,Steamalot: Epoch's Journey,9,2,4.99,7
322440,Red Goddess: Inner World,36,38,9.99,-2
394030,Trigonarium,28,4,2.99,24
298360,Immortal Defense,152,23,9.99,129
377330,Close Your Eyes [Old Version],664,95,0.0,569
398450,Absent,266,58,0.0,208
234140,Mad Max,58282,5340,19.99,52942
399090,It's time to get out from the solar system,12,46,2.99,-34
290340,Armello,11820,2597,19.99,9223
392470,NOBUNAGA'S AMBITION: Sphere of Influence,456,92,59.99,364
287700,METAL GEAR SOLID V: THE PHANTOM PAIN,69864,7030,19.99,62834
384550,Painters Guild,332,176,9.99,156
378080,Rack N Ruin,59,18,9.99,41
388490,One Way To Die,180,150,0.0,30
365820,Company of Heroes 2 - The British Forces,274,93,12.99,181
387840,Alpha Runner,330,90,0.99,240
393660,Streamline,32,23,2.99,9
318020,Act of Aggression - Reboot Edition,1873,1014,29.99,859
305820,Cute Things Dying Violently,37,13,2.99,24
399520,Comedy Quest,241,45,0.0,196
296970,Renowned Explorers: International Society,2469,208,19.99,2261
359050,Shower With Your Dad Simulator 2015: Do You Still Shower With Your Dad,9099,462,0.99,8637
323460,Raiden IV: OverKill,466,87,14.99,379
399230,Kitchen Simulator 2015,38,100,0.49,-62
360840,Lumini,128,20,12.99,108
385830,Burgers,302,348,0.99,-46
377070,Noctropolis,50,9,9.99,41
347520,Legends of Atlantis: Exodus,66,11,6.99,55
399420,The Prism,142,67,0.51,75
398640,Bowl Bound College Football,61,52,19.99,9
294730,Marine Park Empire,73,19,1.74,54
396030,InCell VR,177,85,0.0,92
286750,Zoo Empire,98,32,6.99,66
294590,Wars and Warriors: Joan of Arc,237,19,1.74,218
394550,Gunman Clive 2,95,11,2.99,84
397800,BattleQuiz,10,19,2.99,-9
391390,Mayhem Triple,33,5,4.99,28
395400,Freedom Cry,28,27,4.99,1
388620,DungeonUp,348,75,4.99,273
397690,Hyperspace Invaders II: Pixel Edition,308,73,4.99,235
388050,Snik,60,47,2.99,13
392820,Wild Island Quest,151,148,0.51,3
314410,Rampage Knights,3093,244,11.99,2849
396530,Fireflies,20,36,1.99,-16
368050,Almightree: The Last Dreamer,113,34,4.99,79
355630,Leo’s Fortune - HD Edition,271,22,6.99,249
399900,Mad Snowboarding,16,14,4.99,2
386360,SMITE®,81293,20315,0.0,60978
390610,Circa Infinity,244,17,7.99,227
331190,Master Spy,272,64,9.99,208
322910,"Warhammer 40,000: Regicide",1270,580,9.99,690
344770,fault - milestone two side:above,2413,68,14.99,2345
379530,Fate Tectonics,145,48,4.99,97
252110,Lovers in a Dangerous Spacetime,3057,213,14.99,2844
393150,The Dreamatorium of Dr. Magnus 2,58,21,7.99,37
274350,Dropsy,1576,103,9.99,1473
282660,Easy™ eSports,7977,1924,0.0,6053
365480,Ravenmark: Scourge of Estellion,56,31,14.99,25
390200,Queen's Quest: Tower of Darkness,177,96,9.99,81
384000,Cross of the Dutchman,255,88,8.99,167
402180,Sakura Swim Club,2407,406,9.99,2001
312280,Simply Chess,2359,774,0.0,1585
399790,Destiny Warriors RPG,515,526,1.99,-11
401420,Match 3 Revolution,25,18,3.99,7
363940,Solar Shifter EX,40,50,0.99,-10
400790,The Juicer,243,32,1.99,211
384120,WonderCat Adventures,37,15,2.99,22
355860,Albino Lullaby: Episode 1,255,103,9.99,152
391490,Braveland Pirate,316,42,9.99,274
382090,Dungeon Nightmares II : The Memory,204,53,8.99,151
356580,Aerannis,92,38,0.99,54
297740,Overruled!,34,32,3.89,2
383780,Judgement,9,11,4.99,-2
375290,Superstatic,21,12,4.99,9
357480,Frozen Free Fall: Snowball Fight,1149,793,0.0,356
397870,Arcane Sorcery,30,24,0.0,6
391540,Undertale,175161,6074,9.99,169087
691630,STELLATUM,98,54,9.99,44
372340,SnarfQuest Tales,5,6,19.99,-1
353640,Train Valley,2614,303,9.99,2311
400580,Black Closet,225,19,19.99,206
367600,Skyshine's BEDLAM,518,360,0.0,158
380020,Three Heroes,647,286,3.99,361
371120,Discouraged Workers,61,38,14.99,23
384660,RED Fuse: Rolling Explosive Device,9,2,4.99,7
373240,Black Sails - The Ghost Ship,164,75,9.99,89
390220,Toilet Tycoon,102,47,4.99,55
238240,Edge of Space,934,1788,14.99,-854
287840,TY the Tasmanian Tiger 4,206,46,5.99,160
402160,Star Command Galaxies,180,234,14.99,-54
376680,Splendor,709,162,9.99,547
338760,Death Ray Manta SE,150,49,1.99,101
346090,I Can't Escape: Darkness,52,11,11.99,41
403900,Clergy Splode,208,279,1.99,-71
365560,Battle of the Bulge,105,39,9.99,66
401190,Dinosaur Hunt,2386,1208,0.99,1178
402210,Airport Madness: Time Machine,82,24,6.99,58
378770,ESCHATOS,180,6,14.99,174
397580,Moonbase 332,37,93,4.99,-56
392070,Pumped BMX +,228,54,0.99,174
401840,ChargeShot,66,19,9.99,47
398710,Timberman,10132,671,0.99,9461
391520,Labyrinth Simulator,72,57,4.99,15
280600,BloodLust Shadowhunter,251,68,9.99,183
403740,GabeN: The Final Decision,426,261,0.99,165
370020,Templar Battleforce,818,52,9.99,766
392780,Mondrian - Abstraction in Beauty,19,8,4.99,11
282140,SOMA,30933,1310,29.99,29623
404480,SC2VN - The eSports Visual Novel,823,65,0.0,758
402190,Gamer Simulator,17,16,0.99,1
307590,Penarium,303,56,9.99,247
396640,TowerClimb,288,28,14.99,260
370170,Dale Hardshovel HD,17,14,0.99,3
323040,Laserlife,87,26,9.99,61
236690,Blood Bowl 2,6072,1684,19.99,4388
397990,Woof Blaster,108,24,0.0,84
402850,Miner Mayhem,70,41,2.99,29
385890,Golden Rush,230,282,0.0,-52
373600,Weapon of Choice,56,9,4.99,47
400160,Concrete Jungle,500,68,6.99,432
402890,Nyctophilia,194,109,0.0,85
250110,Assault Android Cactus+,1679,102,19.99,1577
297080,Navpoint,13,10,4.99,3
334100,Extreme Exorcism,45,11,5.99,34
373610,Shoot 1UP,100,24,3.99,76
403090,Rescue Team 2,36,2,4.99,34
373630,Game Type,32,9,2.99,23
229810,A Fistful of Gun,295,166,9.99,129
397210,Kanji Training Game,75,19,4.99,56
373620,Explosionade,51,15,3.99,36
392950,Lost Lands: A Hidden Object Adventure,4505,560,0.0,3945
375620,CortexGear: AngryDroids,24,90,5.99,-66
368970,Haywire on Fuel Station Zeta,17,8,3.99,9
394280,Dark Heritage: Guardians of Hope,178,138,9.99,40
348360,Doodle God,806,247,14.99,559
400110,Else Heart.Break(),480,236,24.99,244
276730,Tango Fiesta – 80’s Action Film meets 2D Top Down Multiplayer Co-Op Roguelike Military Shooter,41,31,9.99,10
395520,Missing Translation,2666,372,0.0,2294
339640,Jagged Alliance Online: Reloaded,80,71,0.0,9
400660,Reverse Crawl,465,55,0.89,410
349760,Snail Bob 2: Tiny Troubles,149,4,4.99,145
401090,MODO indie,80,27,14.99,53
382890,FINAL FANTASY V (Old ver.),1058,321,0.0,737
392940,Epic Quest of the 4 Crystals,114,30,4.99,84
388660,Project Tarvotan,18,21,0.99,-3
344130,Cataegis : The White Wind,246,122,4.99,124
397270,A Kiss For The Petals - Remembering How We Met,1400,102,7.99,1298
387870,Mold on Pizza 🍕,110,25,5.99,85
382120,Journey To The Center Of The Earth,425,222,0.0,203
398180,Euclidean,155,83,4.99,72
371220,VERLIES II,61,50,2.99,11
399920,Blowy Fish,24,20,1.99,4
293600,Arson and Plunder: Unleashed,38,53,0.99,-15
310470,Grand Ages: Medieval,885,1005,19.99,-120
339910,Uncraft World,397,71,9.99,326
381780,80 Days,1592,153,12.99,1439
384090,Sketch Tales,96,49,1.0,47
399040,Legends of Solitaire: Curse of the Dragons,101,15,4.99,86
386560,Psycho Starship Rampage,119,17,9.99,102
374060,Stairs,230,92,12.99,138
406090,Enigmoon,565,189,19.99,376
394600,Mighty Gunvolt,231,80,0.99,151
385530,Astro Lords,119,58,0.0,61
377430,Who Is Mike - A Visual Novel,382,40,0.0,342
348470,SAMURAI WARRIORS 4-II,969,302,49.99,667
342260,Nevermind,319,93,19.99,226
370240,NBA 2K16,3804,3582,0.0,222
370460,Arcana Heart 3 LOVE MAX!!!!!,361,77,29.99,284
354040,Hypership Out of Control,29,3,1.99,26
404860,Inside Me,29,10,0.0,19
323580,Jotun: Valhalla Edition,6257,1758,14.99,4499
321960,Might & Magic® Heroes® VII,2903,2505,29.99,398
248330,Dino Run DX,1071,77,5.99,994
312920,Rugby League Live 3,117,35,19.99,82
349020,Hyperspace Pinball,32,19,2.99,13
319470,Ninja Pizza Girl,247,61,6.99,186
397940,No Time To Live,102,39,1.99,63
334120,Armikrog,800,620,4.99,180
388060,The Escapists: The Walking Dead,466,242,4.99,224
399000,Porradaria Upgrade,41,19,0.0,22
400410,OASE - Other Age Second Encounter,8,9,19.99,-1
399780,Expand,361,47,5.99,314
370270,Jim Power -The Lost Dimension,38,21,19.99,17
383720,Swords & Crossbones: An Epic Pirate Story,51,26,4.99,25
348280,ORBIT,18,7,6.99,11
397770,Meridian: Age of Invention,60,25,2.99,35
403560,Eaten Alive,173,315,1.99,-142
395560,Lost Horizon 2,87,89,14.99,-2
303210,The Beginner's Guide,15849,2313,9.99,13536
395250,The Adventures of Fatman,82,30,0.99,52
375030,Korwin The Game,179,47,1.99,132
306290,"7,62 Hard Life",372,94,0.0,278
347160,Steredenn,741,102,12.99,639
365890,Heroes of Normandie,151,60,29.99,91
367270,Angels Fall First,1966,445,17.99,1521
379640,Bloo Kid 2,232,25,3.99,207
404660,Vicky Saves the Big Dumb World,22,13,0.99,9
400740,VERGE:Lost chapter,125,166,0.99,-41
402170,Puzzle Ball,27,34,2.99,-7
397740,Hylics,2870,60,2.99,2810
361600,Luna Sky,69,88,12.99,-19
382070,Neoncube,64,19,0.99,45
399670,Game Corp DX,2657,372,2.99,2285
370480,Pixel Galaxy,150,21,2.99,129
404050,Black & White Bushido,114,53,12.99,61
406080,Ant War: Domination,126,90,4.99,36
386590,Novus Inceptio,675,520,12.99,155
378750,Sayonara Umihara Kawase,128,8,14.99,120
401120,Anode,85,11,3.99,74
351230,Counter Spell,119,20,9.99,99
233450,Prison Architect,56684,5947,29.99,50737
363960,Devils & Demons,40,59,1.99,-19
347610,Hidden Object Bundle 4 in 1,283,22,7.99,261
382140,SKYHILL,2956,880,9.99,2076
330820,2064: Read Only Memories,1199,309,19.99,890
407680,Last Days of Spring Visual Novel,71,50,2.99,21
407120,Soccer Manager 2016,482,212,0.0,270
327880,Sublevel Zero Redux,439,58,14.99,381
399910,Ookibloks,49,5,1.99,44
403510,Fairy Tale Mysteries 2: The Beanstalk,239,73,9.99,166
354160,WRC 5 FIA World Rally Championship,458,273,9.99,185
341800,Keep Talking and Nobody Explodes,10774,234,14.99,10540
407290,There Was A Caveman,98,42,6.99,56
371450,Awe,185,61,0.99,124
306350,Slipstream 5000,283,92,2.99,191
407150,Trap Them - Sniper Edition,15,12,3.99,3
400370,Normality,244,116,2.99,128
396310,Masochisia,327,55,7.99,272
398830,Goggles - World of Vaporia,7,5,7.99,2
407230,Legend of Mysteria RPG,514,220,1.99,294
404690,This Book Is A Dungeon,179,69,4.99,110
352760,Kaiju Panic,23,7,9.99,16
380140,The Secret of Tremendous Corporation,270,61,0.0,209
370220,Animal Gods,18,28,9.99,-10
381260,Orion Trail,135,57,7.99,78
402390,Hyperdrive Massacre,195,155,9.99,40
323680,Caffeine,8,40,10.99,-32
361360,Goosebumps: The Game,185,32,9.99,153
348490,Beyond Sol,143,40,9.99,103
397460,The Jackbox Party Pack 2,1631,70,24.99,1561
376870,Minecraft: Story Mode - A Telltale Games Series,6110,1955,0.0,4155
261490,Bedlam,660,206,0.0,454
404270,All My Gods,80,13,3.99,67
402840,Crusaders of the Lost Idols,2348,455,0.0,1893
409630,Rumble,17,17,1.99,0
372950,Professor Why™ Chemistry 1,11,1,9.99,10
385250,Paint it Back,464,8,7.99,456
381100,The Men of Yoshiwara: Kikuya,341,106,29.99,235
230070,The Age of Decadence,2565,576,12.99,1989
375820,Human Resource Machine,3396,222,14.99,3174
403190,Planetbase,6681,1761,14.99,4920
274190,Broforce,47708,1458,14.99,46250
324390,The Body Changer,41,12,29.99,29
392620,Lucadian Chronicles,21,7,0.0,14
404920,Emergency 2016,117,148,0.0,-31
388450,Spooky Bonus,245,7,9.99,238
403460,SkyScrappers,10,12,9.99,-2
398840,War of Beach,279,235,0.0,44
409420,Knight Adventure,25,32,0.99,-7
243160,Mushroom 11,523,106,14.99,417
404580,Relive,106,47,0.0,59
360740,Downwell,6838,222,2.99,6616
394450,"Warhammer 40,000: Deathwatch - Enhanced Edition",565,252,0.0,313
396090,Rogue State,187,63,7.99,124
362930,Garfield Kart,11192,1472,0.54,9720
382160,Dark Years,27,83,14.99,-56
410770,Roads of Rome,59,11,3.99,48
379520,DELTAZEAL,44,13,11.99,31
411060,Roads of Rome 2,39,2,3.99,37
330450,Runes of Brennos,28,14,0.0,14
374240,Eternal Step,39,19,9.99,20
402300,Dungeon Manager ZV,48,24,9.99,24
263920,Zombie Grinder,208,93,8.99,115
406150,Refunct,15798,707,2.99,15091
399640,Flamebreak,462,29,9.99,433
351300,Ceres,78,70,19.99,8
391910,All Fall Down,8,4,0.99,4
393240,Sir! I'd Like To Report A Bug!,19,12,1.99,7
306670,Overlord: Fellowship of Evil,144,473,9.99,-329
410210,Ampersand,335,693,1.99,-358
402120,Deathstate: Abyssal Edition,299,52,9.99,247
364640,FreeCell Quest,316,132,9.99,184
351970,Tales of Zestiria,6643,1459,7.49,5184
402630,The Coma: Cutting Class,264,29,0.0,235
411530,Roads of Rome 3,27,9,3.99,18
310060,Knights of Pen and Paper 2,2041,292,7.99,1749
395160,Toby: The Secret Mine,413,171,9.99,242
398000,Twinsen's Little Big Adventure 2 Classic,584,14,9.99,570
372780,Pulse,37,33,7.99,4
290300,Rebel Galaxy,6365,1106,19.99,5259
408990,Timber and Stone,399,423,4.99,-24
397330,Twinsen's Little Big Adventure Classic,265,48,9.99,217
377900,Empire TV Tycoon,652,181,9.99,471
278550,A-Train 9 V4.0 : Japan Rail Simulator,77,38,59.99,39
361200,COAST GUARD,64,55,17.99,9
366220,Wurm Unlimited,2047,822,29.99,1225
404080,Murder,183,187,0.49,-4
395920,Playing History - The Plague,27,19,0.99,8
395600,Armor Clash,59,24,6.99,35
412480,Turtle Odyssey,99,5,2.99,94
332330,PixelJunk™ Shooter Ultimate,139,24,9.99,115
395170,DISTRAINT: Deluxe Edition,9907,710,4.99,9197
330570,Noct,304,268,0.0,36
368230,Kingdom: Classic,17367,1824,0.0,15543
405780,Alpha Polaris : A Horror Adventure Game,325,89,0.0,236
348540,Divine Slice of Life,194,88,12.99,106
409090,The Big Secret of a Small Town,71,39,6.99,32
396790,Dracula's Legacy,546,143,2.99,403
410710,System Shock: Enhanced Edition,1430,159,9.99,1271
389870,Mugen Souls,195,80,19.99,115
412930,Farm Mania: Hot Vacation,49,4,3.99,45
411570,Zombie Exodus,130,19,7.99,111
393920,Auto Dealership Tycoon,93,91,5.99,2
385600,Heavy Fire: Shattered Spear,41,33,3.99,8
246900,Viscera Cleanup Detail,15086,1107,12.99,13979
409590,KINGDOMS,2937,740,9.99,2197
335700,I am Weapon: Revival,197,85,15.99,112
403860,ALPAGES : THE FIVE BOOKS,80,138,0.51,-58
405610,Flight of the Paladin,194,183,1.99,11
235540,Warhammer: End Times - Vermintide,15805,3953,29.99,11852
404630,One Hundred Ways,34,26,4.99,8
363890,RPG Maker MV,5791,520,15.99,5271
350770,Giana Sisters 2D,146,82,7.99,64
407020,Star Sky,197,59,3.99,138
410910,Deathless: The City's Thirst,23,7,3.99,16
335190,200% Mixed Juice!,592,214,6.99,378
378630,Shadows on the Vatican Act II: Wrath,81,22,6.99,59
319050,Chaos Reborn,827,256,9.99,571
408750,Starsphere,30,7,3.99,23
391780,Uebergame,258,231,0.0,27
395140,Miracle Fly,79,12,7.99,67
391630,Necromonads,19,21,0.0,-2
282050,MX vs. ATV Supercross Encore,442,295,29.99,147
402020,The Park,1949,833,5.19,1116
408170,Networm,21,1,1.99,20
406930,Epic Showdown,16,27,4.99,-11
413680,Statues,171,84,0.99,87
373420,Divinity: Original Sin - Enhanced Edition,19842,2148,39.99,17694
395270,A Wolf in Autumn,229,81,1.99,148
368590,Albert and Otto,410,212,4.99,198
410430,Morphine,471,171,0.74,300
377970,Void And Meddler,180,91,3.99,89
409670,Pink Hour,893,69,0.0,824
397430,Zoombinis,826,61,9.99,765
279640,The Troma Project,176,165,6.99,11
382350,Devil's Bluff,114,74,3.99,40
251290,The Legend of Heroes: Trails in the Sky SC,2338,50,29.99,2288
384110,Pathologic Classic HD,2416,375,12.99,2041
375320,Colortone,125,57,0.51,68
415330,When In Rome,12,4,4.99,8
390290,Bulb Boy,875,107,8.99,768
375040,Death Tractor,49,24,0.99,25
407620,Indie Game Battle,78,101,0.0,-23
390920,Army of Pixels,43,10,4.99,33
269990,Infinite Space III: Sea of Stars,81,34,4.99,47
300580,GALAK-Z,373,138,19.99,235
291770,The Last Crown: Midnight Horror,96,27,4.99,69
400470,The Seven Years War (1756-1763),78,44,19.99,34
410440,Vertigo Void,35,8,4.99,27
404410,Endless Sky,5064,442,0.0,4622
414470,Nightmare on Azathoth,16,14,0.99,2
353270,Hyperdimension Neptunia Re;Birth3 V Generation,3081,160,14.99,2921
383460,Sound of Drop - fall into poison -,383,57,12.99,326
38400,Fallout: A Post Nuclear Role Playing Game,13795,965,9.99,12830
362290,The Living Dungeon,45,12,9.99,33
408440,Dream Factory,17,69,9.99,-52
384690,Umihara Kawase,145,6,9.99,139
412770,Boogeyman,432,97,4.99,335
314520,Euro Fishing,1093,614,14.99,479
385100,Space - The Return Of The Pixxelfrazzer,32,1,2.99,31
407300,The Last NightMary - A Lenda do Cabeça de Cuia,552,128,3.99,424
415920,Voidspire Tactics,206,6,14.99,200
375910,Anno 2205™,3546,1540,39.99,2006
329440,Sonic Lost World,2098,1252,29.99,846
350990,Bloodwood Reload,148,237,0.0,-89
416030,Your Quest,89,61,0.0,28
409690,Pink Heaven,642,73,0.0,569
332620,PONCHO,123,59,5.99,64
299600,Dragon Fin Soup,165,119,19.99,46
403120,THE GAME OF LIFE,1508,509,4.99,999
397570,Shmadow,162,37,1.99,125
355980,Dungeon Warfare,1545,66,9.99,1479
389470,Call of Cthulhu: Shadow of the Comet,48,11,5.99,37
405650,Zero Reflex : Black Eye Edition,184,49,3.99,135
359620,Call of Cthulhu: Prisoner of Ice,60,18,5.99,42
369360,Car Washer: Summer of the Ninja,14,30,4.99,-16
388410,Darksiders II Deathinitive Edition,10956,3227,29.99,7729
374990,Orc Slayer,7,10,1.99,-3
408930,ePic Character Generator,801,156,0.0,645
388520,Call of Duty®: Black Ops III,38969,23378,59.99,15591
377670,G-senjou no Maou - The Devil on G-String,531,42,19.99,489
366842,Call of Duty®: Black Ops III,38921,23371,59.99,15550
375600,Air Brawl,1065,323,0.0,742
311210,Call of Duty®: Black Ops III,112104,27418,59.99,84686
316370,Wave of Darkness,48,42,29.99,6
416350,MiniBikers,29,31,0.0,-2
414260,Ironclads 2: American Civil War,33,12,9.99,21
399890,The Secret Order 2: Masked Intent,319,77,9.99,242
398970,none,8,23,0.0,-15
401170,Birth of Shadows®,4,1,4.99,3
288260,Conflicks - Revolutionary Space Battles,125,50,6.99,75
290530,Clandestine,362,95,19.99,267
400170,The Incredible Adventures of Van Helsing: Final Cut,2360,744,44.99,1616
403180,Draw a Stickman: EPIC 2,520,87,6.99,433
407980,Sakura Beach 2,444,133,9.99,311
270230,Prominence,115,19,19.99,96
409380,Among the Heavens,239,43,2.99,196
287980,Mini Metro,12256,440,9.99,11816
374830,Defend The Highlands,269,70,4.99,199
409450,The Fall of the Dungeon Guardians - Enhanced Edition,468,85,7.99,383
355020,Bomb The Monsters!,60,38,0.99,22
416080,The Odyssey: Winds of Athena,344,196,4.99,148
411760,Swordbreaker The Game,330,59,2.99,271
385360,Super Trench Attack 2,71,46,2.99,25
329790,Krosmaster Arena,185,112,0.0,73
418070,Turbo Pug,3066,309,1.99,2757
321330,ENYO Arcade,68,27,0.0,41
377160,Fallout 4,229418,53135,19.99,176283
254200,FortressCraft Evolved!,2069,781,12.99,1288
398980,Without Within 2,201,29,4.99,172
416290,Bleeding Border,53,79,3.99,-26
418160,Garden Rescue: Christmas Edition,53,12,3.99,41
409510,Genesis Online,605,1317,0.0,-712
412380,Legend (1994),45,24,2.44,21
412520,Evil Defenders,287,71,4.99,216
418960,Catorize,5,15,2.99,-10
292500,Kero Blaster,1046,68,9.99,978
324680,Impossible Creatures Steam Edition,1330,61,9.99,1269
365960,rFactor 2,4738,1135,7.99,3603
390670,Steel Ocean,3113,1386,0.0,1727
395900,Backgammon Blitz,111,75,3.99,36
409100,The Purring Quest,1174,223,9.99,951
416370,Showing Tonight: Mindhunters Incident,47,35,2.99,12
338120,Marble Duel: Sphere-Matching Tactical Fantasy,194,110,14.99,84
377860,Mushihimesama,1107,36,19.99,1071
391180,Ladra,37,13,1.99,24
414580,Uriel's Chasm 2: את,122,235,4.99,-113
370710,Last Heroes,60,26,2.99,34
410890,Higurashi When They Cry Hou - Ch.2 Watanagashi,873,29,3.99,844
412370,Parallels,11,8,0.99,3
294000,Knight Squad,314,50,14.99,264
389160,Shadow Ninja: Apocalypse,96,66,1.99,30
393610,ROOT,148,45,9.99,103
403950,Conquest of Elysium 4,489,57,24.99,432
331720,Survivor Squad: Gauntlets,118,36,4.99,82
333300,ADOM (Ancient Domains Of Mystery),1081,179,7.49,902
290080,Life is Feudal: Your Own,7553,3883,19.99,3670
390870,Circuit Breakers,63,44,6.99,19
386350,Rise: Battle Lines,57,28,0.0,29
386640,Affected Zone Tactics,167,134,0.0,33
338530,Trouble In The Manor,174,133,0.99,41
346730,GOCCO OF WAR,879,112,19.99,767
418000,Demented,7,11,4.99,-4
398100,Highschool Romance,459,118,12.99,341
418040,hocus,641,59,0.99,582
307670,Hard West,3137,913,19.99,2224
394220,Last Horizon,178,46,4.99,132
410120,AGON - The Mysterious Codex (Trilogy),47,23,9.99,24
396850,Chronicles of the Witches and Warlocks,108,72,4.99,36
397420,Hoyle Official Card Games,30,31,0.0,-1
418110,March of War: FaceOff - XL,116,45,0.0,71
368500,Assassin's Creed® Syndicate,17383,4383,29.99,13000
416320,Rescue Team 5,78,18,3.99,60
418440,Tick Tock Isle,253,34,0.99,219
276810,Mordheim: City of the Damned,4956,2125,19.99,2831
410130,AGON - The Lost Sword of Toledo,45,18,9.99,27
387930,The Tape,222,182,0.99,40
369390,Scourge of War: Waterloo,174,44,49.99,130
407190,Club Manager 2016,50,42,19.99,8
416630,True Lover's Knot,49,74,3.49,-25
361890,Chronostorm: Siberian Border,40,36,0.99,4
420000,Home Design 3D,1584,416,0.99,1168
403830,The Consuming Shadow,316,16,9.99,300
380210,Signal to Noise,12,12,4.99,0
410110,12 is Better Than 6,4689,854,9.99,3835
418310,Chronicles of a Dark Lord: Rhapsody Clash,17,12,0.0,5
421630,A Study in Steampunk: Choice by Gaslight,158,6,3.99,152
386280,Vendetta - Curse of Raven's Cry,269,275,29.99,-6
383240,Angels That Kill - The Final Cut,11,16,4.99,-5
378720,Thea: The Awakening,3105,453,19.99,2652
400380,Tactical Soccer The New Season,10,16,9.99,-6
359060,Switch Galaxy Ultra,36,55,9.99,-19
403700,Zero Punctuation: Hatfall - Hatters Gonna Hat Edition,238,40,4.99,198
402980,Osteya,57,43,3.99,14
417860,Emily is Away,27070,3494,0.0,23576
350210,Mighty Switch Force! Academy,38,9,9.99,29
321060,Gender Bender DNA Twister Extreme,164,50,24.99,114
420740,The Deed,2312,249,0.49,2063
415030,One More Dungeon,475,137,4.99,338
412730,Days Under Custody,51,96,4.99,-45
385310,The Land Of Lamia,35,31,0.99,4
324160,CLANNAD,6076,86,44.99,5990
416310,Goblin Defenders: Steel‘n’ Wood,68,40,2.99,28
378030,Cardinal Quest 2,81,8,4.99,73
418910,Idle Civilization,92,81,4.99,11
336520,Might & Magic Heroes Online,317,463,0.0,-146
387010,FIVE: Guardians of David,127,58,9.99,69
420920,Lost Labyrinth Extended Version,36,23,4.99,13
348710,Saint Seiya: Soldiers' Soul,2766,210,0.0,2556
384990,Gon' E-Choo!,73,18,0.99,55
414720,Astrox: Hostile Space Excavation,358,64,9.99,294
423880,Carpe Diem,7390,885,0.0,6505
411740,Yet Another World,53,15,5.99,38
348820,FIM Speedway Grand Prix 15,641,40,0.0,601
420880,I must kill...: Fresh Meat,69,180,0.0,-111
405980,Legend of Dungeon: Masters,116,78,0.0,38
417980,Planet Diver,46,11,3.99,35
225540,Just Cause™ 3,84686,18296,19.99,66390
421620,Dissonance: An Interactive Novelette,6,4,0.99,2
421880,Plastiland,60,28,7.99,32
423600,Adelantado Trilogy. Book one,37,3,4.99,34
420770,The Legend of Dark Witch,172,56,6.99,116
301120,Eastside Hockey Manager,1033,178,19.99,855
371320,Samsa and the Knights of Light,28,8,4.99,20
410470,Expander,15,3,2.99,12
359550,Tom Clancy's Rainbow Six® Siege,929372,138530,19.99,790842
376210,The Isle,44556,9061,19.99,35495
397040,Sphere 3: Rage of the Devastator,194,196,0.0,-2
351910,Valhalla Hills,646,544,0.69,102
423760,Hit Tank PRO,75,46,2.99,29
304580,CITYCONOMY: Service for your City,184,198,24.99,-14
417110,Mayjasmine Episode01 - What is God?,220,96,9.99,124
389850,Legacy of Dorn: Herald of Oblivion,146,24,0.0,122
346370,Into The War,106,376,0.0,-270
421260,Militia,128,5,5.99,123
394870,Office Battle,674,241,0.49,433
422250,ShipLord,356,300,1.09,56
377870,DARIUSBURST Chronicle Saviours,548,106,49.99,442
369310,Monstro: Battle Tactics,23,2,5.99,21
404040,Lords of Magic: Special Edition,339,31,4.99,308
414920,Corgi Warlock,263,63,0.49,200
405950,Lowglow,410,38,3.99,372
344190,Immortal Empire,205,78,0.0,127
410850,DRAGON QUEST HEROES™ Slime Edition,850,405,39.99,445
423740,Save Your Mother,33,16,2.99,17
387240,Steel Rain,86,14,9.99,72
254860,Lords of the Realm III,9,14,4.99,-5
395860,The Last Dream: Developer's Edition,255,70,9.99,185
254920,Lords of the Realm,59,15,1.99,44
397350,Lords of the Realm II,1021,42,2.99,979
414660,Vampire Legends: The True Story of Kisilova,471,78,9.99,393
423120,Community College Hero: Trial by Fire,213,33,3.99,180
319830,AX:EL - Air XenoDawn,925,281,0.0,644
409160,"Dr. Langeskov, The Tiger, and The Terribly Cursed Emerald: A Whirlwind Heist",8547,595,0.0,7952
415420,Nyan Cat: Lost In Space,1548,119,2.49,1429
424870,Threads of Destiny,18,9,4.99,9
411560,Reveal The Deep,1191,227,0.99,964
420270,Into the Void,80,50,1.99,30
387060,Earth Overclocked,155,31,4.99,124
242680,Nuclear Throne,15271,583,11.99,14688
422630,Metaverse Construction Kit,150,71,0.0,79
394510,HELLDIVERS™ Dive Harder Edition,20432,1898,19.99,18534
412670,Bullet Heaven 2,377,7,11.99,370
310560,DiRT Rally,33235,4652,4.49,28583
314000,Pool Nation FX Lite,1168,515,0.0,653
416770,SquareCells,863,77,0.89,786
392600,Volvox,24,2,9.99,22
337480,Zombie Vikings,236,68,1.19,168
412410,Castle Chaos,32,26,2.99,6
360940,The Mean Greens - Plastic Warfare,8077,1792,9.99,6285
417890,Apotheon Arena,868,178,0.0,690
354030,VolChaos,32,17,2.99,15
395200,Ben and Ed,2056,455,9.99,1601
348240,Gun Wings,215,44,3.99,171
424210,SodaCity,13,3,9.99,10
412170,City of Chains,236,88,8.99,148
397720,Romance of the Three Kingdoms Maker,190,101,0.0,89
396360,LocoSoccer,166,91,0.99,75
422140,Wrestling Spirit 3,34,37,19.99,-3
419090,Vector Strain,48,16,2.99,32
419500,Red Game Without A Great Name,69,8,0.0,61
376300,GUILTY GEAR Xrd -SIGN-,2088,204,29.99,1884
416190,Vehicle Simulator,197,28,35.0,169
409070,Fist Slash: Of Ultimate Fury,48,24,0.99,24
407600,Raiden Legacy - Steam Edition,125,99,9.99,26
375840,Rytmik Ultimate,314,42,17.99,272
345350,LIGHTNING RETURNS™: FINAL FANTASY® XIII,2962,743,19.99,2219
270110,Block Story™,878,232,2.99,646
399070,Dragon's Wake,359,46,3.99,313
390210,FreezeME,49,28,13.99,21
416590,Emily Wants To Play,1357,350,1.49,1007
413710,Blood and Gold: Caribbean!,719,470,19.99,249
412010,Crossbow Warrior - The Legend of William Tell,21,14,4.99,7
316750,Tetris® Ultimate,125,293,0.0,-168
377190,Pale Echoes,44,9,4.99,35
390520,PewDiePie: Legend of the Brofist,1317,149,7.99,1168
420970,RoBoRumble,112,81,5.99,31
342200,MechWarrior Online™ Solaris 7,7671,2050,0.0,5621
200150,Battle Chess: Game of Kings™,156,148,29.99,8
421810,OH! RPG!,263,93,2.99,170
409600,Contract With The Devil,179,73,4.99,106
380570,Axion,33,80,0.0,-47
406730,"1,000 Heads Among the Trees",65,53,4.99,12
407420,Gabe Newell Simulator,313,312,2.99,1
414950,Star Nomad 2,107,44,12.99,63
370590,Gem Wars: Attack of the Jiblets,43,29,0.0,14
339600,VEGA Conflict,2591,1843,0.0,748
406920,Monsterland,34,2,1.99,32
424000,Project Pulsation,68,100,4.99,-32
344760,Reign Of Kings,8555,6408,9.99,2147
377080,Hatoful Boyfriend: Holiday Star,456,31,9.99,425
386510,Pyramid Raid,96,68,2.99,28
416550,Rubber Ducky and the Rainbow Gun,147,12,0.99,135
408400,Swords and Sorcery - Underworld - Definitive Edition,67,19,14.99,48
382900,FINAL FANTASY VI (Old ver.),2035,434,0.0,1601
340320,Sinless + OST,176,72,4.99,104
217120,Waves 2: Notorious,76,13,9.99,63
375520,Taimumari: Definitive Edition,207,54,0.79,153
405820,Turok,2662,167,19.99,2495
397340,SimplePlanes,8083,626,12.99,7457
418300,Wick,500,92,5.99,408
326340,River City Super Sports Challenge ~All Stars Special~,542,260,2.99,282
356070,Commander Cool 2,892,120,2.99,772
426630,Bubsy Two-Fur,284,125,1.99,159
426040,Goodnight Butcher,28,25,1.99,3
428260,The Book of Desires,30,34,6.99,-4
250520,UnderRail,4095,599,14.99,3496
428800,liteCam Game 5:  120 FPS Game Capture + Streamer,37,54,19.99,-17
360730,Cards and Castles,549,199,0.0,350
298030,Total Annihilation,2515,101,4.99,2414
415830,Gnomes Garden,237,29,4.99,208
424170,The fall of gods,41,10,2.99,31
421180,Umbra: Shadow of Death,7,6,0.0,1
421700,Sakura Santa,545,89,9.99,456
426930,Moonshot,84,12,4.99,72
412880,Drift Streets Japan,2186,1199,1.99,987
339320,Snake Blocks,48,18,4.99,30
428460,Kings of Israel,69,9,4.99,60
418150,The Madness of Little Emma,115,27,8.99,88
429470,Space Pilgrim Episode I: Alpha Centauri,1020,143,0.0,877
271760,Dungeon Lords Steam Edition,411,124,14.99,287
416380,The Hurricane of the Varstray -Collateral hazard-,148,45,9.99,103
384630,Aviary Attorney,1804,92,14.99,1712
430020,Dance of Death,192,111,3.99,81
371460,Gnumz: Masters of Defense,115,45,4.99,70
428040,Sixth Grade Detective,30,2,3.99,28
416690,Oh...Sir! Prototype,772,75,0.0,697
386740,Puzzle Strike,41,7,14.99,34
412230,Infinitrap Classic: Ohio Jack and The Cup Of Eternity,53,16,0.0,37
428760,Hatch and Slay,25,22,1.99,3
298240,War Trigger 3,4961,3362,0.0,1599
381990,Dragon Saga,810,402,0.0,408
427780,PERFECT ANGLE: The puzzle game based on optical illusions,257,75,9.99,182
360040,Our Nation's Miner,12,18,5.99,-6
400250,Heaven Island - VR MMO,1233,863,0.99,370
429490,Resilience Wave Survival,112,70,4.99,42
368830,Adventure in the Tower of Flight,75,15,4.99,60
428510,Solitaire Christmas. Match 2 Cards,70,28,4.99,42
396890,Gridworld,178,32,0.99,146
396800,12 Labours of Hercules IV: Mother Nature (Platinum Edition),444,55,2.99,389
386480,Blood Code,1485,539,9.99,946
424320,Anomaly 1729,28,6,9.99,22
429950,ABO MANDO,24,51,0.99,-27
407900,Princess Remedy in a World of Hurt,2679,62,0.0,2617
429580,A Wild Catgirl Appears!,151,120,2.99,31
431740,Chowderchu,33,23,2.99,10
428900,"Linea, the Game",827,126,1.99,701
405640,Pony Island,12343,597,4.99,11746
407340,Strawberry Vinegar,117,11,9.99,106
390730,Sora,357,33,8.99,324
430080,Elysium: Blood Games,66,43,0.49,23
410670,Suits: A Business RPG,755,103,0.99,652
355510,Crazy Belts,19,48,3.99,-29
418120,Cally's Caves 3,411,100,6.99,311
429940,The Sad Story of Emmeline Burns,667,64,0.0,603
429700,Squirbs,277,143,0.99,134
429600,Fairy Tale Mysteries: The Puppet Thief,197,112,9.99,85
416610,The Growth Journey,37,23,3.99,14
334040,Down To One,800,1287,0.0,-487
263940,Red Baron Pack,68,19,9.99,49
429300,Sepia Tears,779,99,0.0,680
394310,Punch Club,8753,2135,9.99,6618
429520,Falcon Gold,20,5,1.39,15
374080,Falcon,11,4,1.39,7
429050,Feed and Grow: Fish,8315,2141,14.99,6174
431710,Space Pilgrim Episode II: Epsilon Indi,402,62,1.13,340
428060,Millia -The ending-,27,3,0.0,24
415670,Highrise Heroes: Word Challenge,95,9,4.99,86
428100,Beyond Reality,120,22,4.99,98
431540,Frosty Kiss,1279,137,0.0,1142
429530,Falcon 4.0,127,27,3.49,100
419460,"That Dragon, Cancer",1195,124,9.99,1071
433790,Wooden Floor 2 - Resurrection,29,30,1.99,-1
434800,The Great Escape,16,11,3.99,5
434610,Forbidden Planet,147,149,0.0,-2
323060,Tharsis,1655,691,14.99,964
434890,Eight Mini Racers,43,32,0.49,11
392970,New York Mysteries: High Voltage,230,23,6.99,207
431840,3DRPG,124,73,1.99,51
357120,Big Action Mega Fight!,193,60,1.99,133
435250,Deadhunt,120,11,4.99,109
371430,Space Grunts,59,14,14.99,45
359610,Assassin’s Creed® Chronicles: India,499,271,9.99,228
415960,Energy Cycle,188,77,2.99,111
354290,LoveBeat,944,327,0.0,617
434250,Masked Shooters 2,1133,466,0.99,667
429060,Zombie Wars: Invasion,46,50,2.99,-4
388880,Oxenfree,9498,758,9.99,8740
390460,Tyler,17,13,2.99,4
428740,Nordenfelt,7,14,5.99,-7
435140,Rush for gold: Alaska,37,12,3.99,25
387370,Sol 0: Mars Colonization,271,117,3.99,154
354740,Echoes of Aetheria,123,16,14.99,107
414370,Raining Blobs,75,10,9.99,65
372190,Astro Lords: Oort Cloud,27,28,0.0,-1
358080,No Turning Back: The Pixel Art Action-Adventure Roguelike,124,103,2.99,21
432190,Chef Solitaire: USA,127,16,2.99,111
406310,Stop Online - Battle of Words,104,66,4.99,38
424760,Bladestar,61,23,4.99,38
367500,Dragon's Dogma: Dark Arisen,26376,2970,29.99,23406
251110,INFRA,1912,238,29.99,1674
432170,Silver Knight,42,39,0.49,3
428950,"Kivi, Toilet and Shotgun",245,239,1.99,6
428350,Fear Equation,62,18,14.99,44
409290,Herding Dog,33,16,0.99,17
384100,Slybots: Frantic Zone,30,7,6.99,23
432770,Small Town Terrors: Livingston,49,20,5.99,29
324650,Gemini: Heroes Reborn,388,103,2.99,285
398170,Evochron Legacy SE,293,64,24.99,229
368860,Garbage Day,353,696,14.99,-343
262060,Darkest Dungeon®,103354,9996,24.99,93358
433360,Drawn™: Dark Flight,6,7,9.99,-1
400030,Cloney,139,118,0.0,21
352440,Catacombs of the Undercity,18,6,4.99,12
339340,Resident Evil 0,6731,1318,19.99,5413
415350,Shooting Stars!,716,123,0.54,593
401360,The Aquatic Adventure of the Last Human,315,87,9.99,228
387990,Scrap Mechanic,82947,6429,19.99,76518
353700,The Deadly Tower of Monsters,1123,142,14.99,981
412400,GASP,364,1257,0.0,-893
350740,The Bug Butcher,1042,108,7.99,934
281200,A Boy and His Blob,325,153,9.99,172
435780,VIOLET: Space Mission,9,10,4.99,-1
281610,Homeworld: Deserts of Kharak,5384,1104,49.99,4280
417480,Marcus Level,21,12,4.99,9
410820,Starward Rogue,431,35,11.99,396
384480,Six Sides of the World,81,9,4.99,72
383800,Close Order,34,33,4.99,1
340490,Subterrain,921,264,16.99,657
352240,The Westport Independent,142,65,0.0,77
397820,Let's Sing 2016,28,28,3.99,0
423900,Dinocide,114,102,9.99,12
412540,The Minotaur,38,17,0.0,21
391730,Crashlands,3215,442,14.99,2773
236010,Bloxitivity,17,13,11.99,4
323850,Move or Die,18844,2094,14.99,16750
433950,Bit Blaster XL,5870,195,0.99,5675
434620,Pythagoria,175,57,0.0,118
363270,O3DX,35,25,7.99,10
433280,Warlords Battlecry III,560,118,9.99,442
425340,Space Moth DX,99,19,4.99,80
225840,Sven Co-op,23200,1661,0.0,21539
434370,Buried: An Interactive Story,140,7,2.99,133
431770,Rivalry,241,17,2.99,224
434920,Last Heroes 2,32,15,2.99,17
432010,World's Dawn,647,164,9.99,483
427770,Pills4Skills,48,4,2.99,44
389430,Knight Online,4890,5027,0.0,-137
381640,Allods Online RU,966,505,0.0,461
405310,LEGO® MARVEL's Avengers,4891,681,19.99,4210
432330,Rytmik Lite Chiptune Synthesizer,50,20,5.99,30
406130,DarkMaus,335,78,9.99,257
425600,The Order of the Thorne - The King's Challenge,105,15,9.99,90
299340,Habitat,101,148,14.99,-47
426560,Full Tilt Poker,41,50,0.0,-9
418610,Swiftly,67,63,0.99,4
423700,Apocalypse Hotel - The Post-Apocalyptic Hotel Simulator!,29,47,6.99,-18
210970,The Witness,12092,2073,39.99,10019
428630,White Mirror,180,149,4.99,31
427980,Aozora Meikyuu,413,109,4.99,304
424280,Iron Snout,16435,358,0.0,16077
436140,Empire of the Gods,42,18,1.99,24
438020,AI: Rampage,160,289,1.99,-129
438180,Super Mustache,439,164,1.99,275
435040,Incredible Dracula: Chasing Love Collector's Edition,60,16,9.99,44
438010,PulseCharge,80,79,0.99,1
438080,Surfingers,462,119,0.51,343
345700,Echo Tokyo: An Intro,94,57,4.99,37
426690,Narcissu 10th Anniversary Anthology Project,485,12,2.99,473
363150,Romance of the Three Kingdoms XIII,3464,2967,59.99,497
415840,Mystic Saga,130,87,4.99,43
406870,Eventide: Slavic Fable,659,43,9.99,616
433290,Nemesis of the Roman Empire,72,4,9.99,68
372540,The Lost Mythologies,1110,556,0.0,554
429220,FullBlast,55,19,4.99,36
400910,Rabi-Ribi,9766,291,17.99,9475
421040,Plantera,4461,581,2.99,3880
359350,Defunct,492,107,9.99,385
355060,Sébastien Loeb Rally EVO,438,376,19.99,62
435120,Rusty Lake Hotel,5622,260,1.99,5362
434220,Bear Haven Nights,42,7,4.99,35
439770,The Lost Heir: The Fall of Daria,42,14,2.99,28
409340,Perraw - FPS Clone War Alpha,85,34,0.99,51
353190,Bombshell,222,163,34.99,59
437060,MOAI 3: Trade Mission Collector's Edition,40,3,9.99,37
404700,Curvatron,135,29,0.0,106
435420,Operation: Matriarchy,54,30,5.99,24
438030,Dead6hot,212,259,1.99,-47
433920,Aveyond 4: Shadow of the Mist,139,9,14.99,130
429680,Spellweaver,995,339,0.0,656
389050,Pocket Rumble,148,42,9.99,106
415240,Feesh,101,30,0.99,71
372360,Tales of Symphonia,3445,577,19.99,2868
353130,Time of Dragons,1059,638,0.0,421
428210,Horror in the Asylum,19,29,4.99,-10
434570,Blood and Bacon,27509,1419,0.99,26090
394130,Water Bears VR,162,12,4.99,150
427810,CALENDULA,265,79,6.99,186
411000,Sorcery! Parts 1 and 2,452,63,12.99,389
357340,Cobalt,596,51,14.99,545
270880,American Truck Simulator,104521,3859,19.99,100662
434210,It's Spring Again,711,63,0.99,648
414510,5089: The Action RPG,263,53,7.99,210
431610,Hubert's Island Adventure: Mouse o' War,6,1,4.99,5
422420,Godus Wars,86,479,14.99,-393
429720,IMSCARED,1322,114,3.99,1208
334210,Fortified,1250,401,14.99,849
434880,Hieroglyphika,96,51,9.99,45
349040,NARUTO SHIPPUDEN: Ultimate Ninja STORM 4,62347,6322,29.99,56025
404620,The Political Machine 2016,553,171,0.0,382
406120,Astral Breakers,10,7,4.99,3
434420,The Chosen RPG,826,343,1.99,483
374900,Agatha Christie - The ABC Murders,1829,414,14.99,1415
439250,Space Pilgrim Episode III: Delta Pavonis,291,48,1.13,243
268500,XCOM® 2,67933,13088,8.99,54845
434410,Moonlight,223,15,1.99,208
440740,Epic battles within 5 seconds!,185,147,0.0,38
435840,The Preposterous Awesomeness of Everything,70,7,3.14,63
417410,Northern Tale,46,2,2.99,44
438600,Soccer Manager,141,81,0.0,60
391220,Rise of the Tomb Raider™,105887,6868,29.99,99019
383870,Firewatch,51303,6571,19.99,44732
359600,Assassin’s Creed® Chronicles: Russia,528,346,9.99,182
411330,Men of Valor,328,140,9.99,188
378930,Pesadelo - Regressão,91,43,0.0,48
283060,Lucent Heart,162,160,0.0,2
392080,Wayward Terran Frontier: Zero Falls,269,109,29.99,160
431290,Level 22: Gary’s Misadventures - 2016 Edition,33,16,6.99,17
431510,Mystic Destinies: Serendipity of Aeons,313,68,0.0,245
426170,Defragmented,29,14,9.99,15
393390,Cat Simulator,139,187,0.0,-48
314240,RPG Tycoon,263,230,9.99,33
402620,Kindred Spirits on the Roof,1051,30,17.49,1021
415860,Tactical Craft Online,557,599,0.0,-42
264120,Victory: The Age of Racing,636,654,0.0,-18
411080,SHOWTIME 2073,214,77,1.99,137
395350,Doors,192,116,4.99,76
425160,Recursion Deluxe,67,11,4.99,56
431680,Nuts!: The Battle of the Bulge,18,27,9.99,-9
440760,Cube Destroyer,968,162,0.99,806
391720,Layers of Fear (2016),21834,2672,19.99,19162
310950,Street Fighter V,24733,13341,19.99,11392
364390,Downfall,983,66,10.99,917
439930,Control Craft 2,173,59,4.99,114
427930,Army of Tentacles: (Not) A Cthulhu Dating Sim,46,40,4.99,6
436110,Medusa's Labyrinth,849,240,0.0,609
434260,My Name is Mayo,2187,446,0.99,1741
429200,Super Helmets on Fire DX Ultra Edition Plus Alpha,29,18,0.0,11
423270,ZHEROS,31,11,9.99,20
394260,Dance Magic,32,19,9.99,13
437880,Project Graviton,15,7,1.99,8
434680,Lamia's Game Room,127,74,0.99,53
444410,Find Out,58,50,0.99,8
392000,TRON RUN/r,280,72,19.99,208
408650,ChromaGun,423,75,12.99,348
438270,Learn Japanese To Survive! Hiragana Battle,1715,151,6.99,1564
404850,DARTHY,34,6,0.99,28
406940,Dub Dash,189,74,0.99,115
418360,Gurgamoth,75,16,9.99,59
399530,Hyspherical 2,10,3,3.99,7
434820,Brushwood Buddies,104,19,2.99,85
444940,UBERMOSH:BLACK,264,49,0.49,215
253490,CABAL Online,751,356,0.0,395
402060,Californium,222,86,6.99,136
262120,Toy Soldiers: Complete,712,214,8.99,498
411310,"Codename: Panzers, Phase One",282,30,14.99,252
444160,Bonsai,90,75,0.99,15
246620,Plague Inc: Evolved,41913,2464,14.99,39449
422970,Devil Daggers,7202,333,9.99,6869
415610,Red Comrades Save the Galaxy: Reloaded,582,42,3.99,540
429610,The Emerald Maiden: Symphony of Dreams,348,65,9.99,283
399120,Prospekt,906,557,5.99,349
444260,Mindless Running,250,137,0.99,113
350090,No Pineapple Left Behind,22,18,6.99,4
411320,"Codename: Panzers, Phase Two",164,19,14.99,145
413410,Danganronpa: Trigger Happy Havoc,22620,844,19.99,21776
444430,Zeus vs Monsters - Math Game for kids,39,15,5.99,24
271970,Hero and Daughter+,190,22,9.99,168
403940,Dungelot: Shattered Lands,411,118,9.99,293
355920,Pixel Puzzles 2: Space,284,45,4.99,239
436150,Governor of Poker 3,7013,2967,0.0,4046
439910,Risky Rescue,277,76,0.99,201
428880,The Quest,358,54,9.99,304
439720,Unending Galaxy,71,40,8.99,31
378810,Steamroll,46,17,9.99,29
420110,NEKOPARA Vol. 2,11795,341,9.99,11454
444480,Broken Dreams,325,137,1.99,188
430190,Wondershot,19,4,12.99,15
434070,Plight of the Zombie,29,8,2.99,21
358460,Talisman: The Horus Heresy,208,80,0.0,128
441870,OutDrive,3376,1063,2.99,2313
429690,Astro Duel,62,3,9.99,59
438340,Drizzlepath: Genie,108,78,3.99,30
444000,Super Night Riders,164,24,4.99,140
434530,Flobe,24,3,0.99,21
432470,Magdalena,105,150,0.99,-45
442290,Pointless,152,94,0.0,58
427480,FritzChess 15,47,31,29.99,16
427820,Hitman GO: Definitive Edition,1597,280,7.99,1317
368740,Obliteracers,164,59,14.99,105
405540,Ninja Senki DX,62,24,4.99,38
404790,Godot Engine,2001,63,0.0,1938
224500,Gnomoria,2660,775,14.99,1885
429570,The Walking Dead: Michonne - A Telltale Miniseries,4789,1302,14.99,3487
425040,ComixPlay #1: The Endless Incident,18,0,6.99,18
364720,Reagan Gorbachev,19,3,9.99,16
405900,Disgaea PC,3456,460,19.99,2996
444220,Asteroid Bounty Hunter,461,247,1.09,214
438040,Shakes and Fidget,24644,1752,0.0,22892
268360,Krautscape,158,78,6.99,80
396480,Battlevoid: Harbinger,724,188,9.99,536
318600,The Flame in the Flood,5044,1606,2.24,3438
439700,Z1 Battle Royale: Test Server,1312,1182,0.0,130
410970,Master of Orion 1,244,25,5.99,219
395570,We Are The Dwarves,703,353,9.99,350
219990,Grim Dawn,71838,4995,24.99,66843
401690,Life in Bunker,194,127,15.99,67
322500,SUPERHOT,27409,3011,24.99,24398
427030,Xuan-Yuan Sword: The Gate of Firmament,991,366,14.99,625
443850,Tross,22,34,4.99,-12
442500,Age of Gladiators,542,143,9.99,399
373770,LiEat,3839,153,2.99,3686
410980,Master of Orion 2,1071,41,5.99,1030
348460,Bierzerkers,253,278,4.99,-25
404510,Heaven's Hope - Special Edition,94,17,9.99,77
420440,Atlantic Fleet,1089,186,9.99,903
410370,Huenison,9,1,0.99,8
351700,UnReal World,1004,62,10.99,942
413150,Stardew Valley,475785,8983,14.99,466802
433100,The Town of Light,1782,462,18.99,1320
395850,Bear Simulator,495,81,14.99,414
445170,The Haunting of Billy Classic,28,11,2.99,17
428530,Machine Gun Train Run,21,12,0.99,9
405720,Perfect Universe - Play with Gravity,92,31,9.99,61
351730,On My Own,89,54,7.99,35
430960,Lucy -The Eternity She Wished For-,6885,353,9.99,6532
434230,Fairies vs. Darklings: Arcane Edition,17,3,2.99,14
440340,Banzai Escape,92,42,5.99,50
447890,Cat on a Diet,660,147,4.99,513
279900,Soul Axiom,149,64,19.99,85
424250,Balrum,402,114,14.99,288
442000,Alone K.W.,20,39,0.99,-19
371660,Far Cry® Primal,20640,3905,29.99,16735
441550,STAR WARS™ Rebellion,874,121,5.99,753
437900,Party Jousting,647,61,0.0,586
356500,STAR WARS™ Galactic Battlegrounds Saga,3006,301,5.99,2705
342480,Gunscape,855,389,19.99,466
421050,Deponia Doomsday,2836,451,1.99,2385
354860,The Adventures of Tree,367,102,4.99,265
416240,Space Impossible,110,5,12.99,105
423610,Where's My Mommy?,131,37,5.99,94
432240,UnderDread,75,52,4.99,23
447860,Maria the Witch,39,23,4.99,16
371880,Collider,46,18,2.99,28
396320,Tank Battle: 1944,33,18,9.99,15
388750,BlazBlue: Chronophantasma Extend,2445,235,29.99,2210
410290,Acorn Assault: Rodent Revolution,55,20,9.99,35
449050,Rock Paper Scissors Champion,264,213,0.0,51
443460,Star Sky 2,66,13,3.99,53
299460,Woodle Tree Adventures,3699,1787,2.99,1912
424640,Karaski: What Goes Up...,48,7,11.99,41
324310,Bus Simulator 16,2264,1015,9.99,1249
355310,Blood Alloy: Reborn,32,16,12.99,16
434980,Onion Force,58,12,4.99,46
442220,Iron Madness,46,48,0.0,-2
381320,Bezier,80,23,9.99,57
440380,Super Kitty Boing Boing,10,15,5.99,-5
449940,! That Bastard Is Trying To Steal Our Gold !,26,62,2.99,-36
382420,E.T. Armies,143,151,14.99,-8
330420,The Interactive Adventures of Dog Mendonça & Pizzaboy®,180,49,14.99,131
407830,Space Overlords,6,21,7.99,-15
432290,Elemental Heroes,97,67,0.0,30
449020,The Bottom of the Well,444,76,0.0,368
440880,The Count Lucanor,1821,102,9.99,1719
402340,Blue Rider,89,11,9.99,78
352950,Better Late Than DEAD,257,642,4.99,-385
355560,Trigger Runners,49,15,1.99,34
448830,ASMR Universe,78,34,2.99,44
444280,Alice's Patchwork,177,31,4.99,146
421670,CUPID - A free to play Visual Novel,1075,160,0.0,915
446460,Highland Warriors,29,17,2.39,12
448070,Red Risk,486,348,0.51,138
440790,Spellbind : Luppe's tale,12,11,2.99,1
312980,Graviteam Tactics: Mius-Front,668,85,34.99,583
433210,Rhino's Rage,42,59,4.99,-17
448630,Rabiez: Epidemic,76,111,1.99,-35
449550,Chicken Invaders 2,329,11,3.99,318
386940,Ultimate Chicken Horse,27757,1021,14.99,26736
358750,Sunrider: Liberation Day - Captain's Edition,645,124,24.99,521
440750,Story of a Cube,17,15,5.99,2
346610,Racecraft,60,147,0.0,-87
428550,Momodora: Reverie Under The Moonlight,8956,583,9.99,8373
360510,Into the Stars,213,302,19.99,-89
447310,Paper Train Traffic,76,23,1.49,53
446640,Space Pilgrim Episode IV: Sol,287,36,1.13,251
324090,Football Club Simulator - FCS #21,170,86,9.95,84
448560,Mind Games,121,43,2.99,78
448150,Mystica: The Ninth Society,29,18,1.99,11
412310,Labyrinth,186,88,0.0,98
436360,Robo's World: The Zarnok Fortress,16,4,9.99,12
366690,Cue Club 2: Pool & Snooker,395,53,18.99,342
450220,Overload Playable Teaser 3.0,626,40,0.0,586
421140,Blades of the Righteous,12,8,2.99,4
365590,Tom Clancy’s The Division™,59837,26719,29.99,33118
389510,Wild Animal Racing,2287,174,3.99,2113
438140,Star Realms,1341,215,0.0,1126
336130,Shardlight,516,51,14.99,465
431220,Porradaria 2: Pagode of the Night,108,85,0.0,23
322630,Mind Zero,40,50,19.99,-10
451140,Drawn®: Dark Flight™ Collector's Edition,26,10,9.99,16
379980,Panzermadels: Tank Dating Simulator,1356,117,9.99,1239
448010,RePete,31,6,1.99,25
451350,Tropical Fish Shop 2,16,7,3.99,9
449520,Rush for gold: California,32,14,3.99,18
369990,"Gremlins, Inc.",6035,1112,14.99,4923
437420,The Secret Order 3: Ancient Times,271,39,9.99,232
320040,Moon Hunters,3397,886,14.99,2511
448480,Caravanserail,30,26,2.99,4
314180,Deathsmiles,448,17,19.99,431
402040,The Guest,537,164,9.99,373
443370,The Treasures of Montezuma 5,104,46,6.99,58
336030,Race.a.bit,54,21,0.99,33
385730,WWE 2K16,1825,1001,0.0,824
368570,Beat Da Beat,417,32,1.99,385
366010,Generic Space Shooter,29,11,2.99,18
406720,Alekhine's Gun,243,146,14.99,97
236870,HITMAN™,29631,6161,0.0,23470
382940,HITMAN™,23039,5795,0.0,17244
450290,Assault on Arnhem,28,33,9.99,-5
405440,Ares Omega,10,9,0.99,1
448790,Infinity Wings - Scout & Grunt,26,16,2.99,10
444970,SPATIAL SOUND CARD,161,68,9.99,93
448000,Sparkle ZERO,166,154,4.99,12
394970,DEADBOLT,4247,178,9.99,4069
454080,Burst,23,19,0.0,4
263980,Out There Somewhere,6386,477,0.99,5909
435030,Lost Lands: Mahjong,4432,385,0.0,4047
370280,Season of 12 Colors,1820,119,2.99,1701
449540,There's Poop In My Soup,3743,494,0.99,3249
449120,Nanobots,10,5,3.99,5
444460,Love is Blind: Mutants,41,82,0.0,-41
449340,Serafina's Crown,36,12,7.99,24
420900,Mech Anarchy,12,4,0.99,8
453890,Black Rose,725,175,0.0,550
356040,Sheltered,4536,1057,14.99,3479
438820,Hyper Box,39,12,2.99,27
453340,Hustle Cat,1072,79,19.99,993
439920,Royal Heroes,234,63,9.99,171
436390,Prison Run and Gun,411,37,0.49,374
446380,Sophie's Curse,367,69,4.99,298
448400,Hidden Object 6-in-1 bundle,174,45,11.99,129
352050,Chesster,15,5,3.99,10
413480,101 Ways to Die,29,9,9.99,20
420850,Cosmic Leap,90,37,0.99,53
441680,Obscuritas,114,64,14.99,50
443020,Victory and Glory: Napoleon,91,27,29.99,64
448980,The Divergent Series: Allegiant VR,68,36,0.0,32
449040,Jesus Christ RPG Trilogy,1276,211,0.0,1065
449200,Calcu-Late,195,139,1.99,56
424830,Bell Ringer,97,315,6.99,-218
397090,Wind Child,74,17,5.99,57
451670,War Birds: WW2 Air strike 1942,34,27,3.99,7
413170,Metal Assault,173,127,0.0,46
451130,Khan: Absolute Power,108,84,0.0,24
368150,Rising Angels: Hope,19,4,14.99,15
96100,Defy Gravity Extended,7418,1204,1.99,6214
418190,Helen's Mysterious Castle,679,47,1.99,632
454670,Piggy Princess,26,22,3.99,4
388210,Day of the Tentacle Remastered,3523,107,14.99,3416
369280,Hidden Mysteries: Titanic,26,10,4.99,16
387340,Hyperdimension Neptunia U: Action Unleashed,2685,226,14.99,2459
418250,Polaris Sector,295,118,39.99,177
402430,Out of the Park Baseball 17,589,55,0.0,534
450140,Seven Kingdoms: Ancient Adversaries,153,5,5.99,148
366180,Disposable Heroes,49,27,1.99,22
440020,bit Dungeon+,83,112,0.0,-29
444770,Mimpi Dreams,659,47,0.0,612
447850,The Next Door,412,369,0.49,43
317320,Nelly Cootalot: The Fowl Fleet,230,13,19.99,217
446780,AMOK,84,112,0.99,-28
448470,Bacteria,214,152,0.54,62
427510,Way of the Samurai 3,383,99,19.99,284
375450,NOBUNAGA'S AMBITION: Sphere of Influence - Ascension,595,288,59.99,307
455440,Spell Fighter VR,251,113,0.0,138
431230,Tiny Guardians,124,26,9.99,98
433670,Professional Farmer 2017,72,150,2.99,-78
449060,Cellar,146,33,0.99,113
317280,Solstice,134,43,19.99,91
453980,Airstrike HD,196,172,1.99,24
369070,Slain: Back from Hell,1416,561,12.99,855
447780,LostWinds,489,107,1.99,382
400020,Atari Vault,691,128,19.99,563
351940,The Descendant,4867,680,0.0,4187
421120,Samorost 3,3590,196,19.99,3394
441670,Jelly Killer,237,65,3.99,172
389170,Songs for a Hero - Definitive Edition,2707,114,15.99,2593
456660,Slime & Friends,23,35,0.99,-12
434000,Paws,547,51,19.99,496
448080,Fibbage XL,233,13,9.99,220
384330,PolyRace,39,19,0.0,20
433000,Lost Lands: The Golden Curse,433,25,6.99,408
418950,DreadOut: Keepers of The Dark,718,192,6.99,526
337720,The Sea Will Claim Everything,199,5,9.99,194
375900,Trackmania® Turbo,918,479,39.99,439
445230,Lost girl`s [diary],832,186,0.0,646
447800,LostWinds 2: Winter of the Melodias,215,43,1.99,172
403850,Sky To Fly: Faster Than Wind,70,34,3.99,36
431180,WolfQuest: Classic,1404,132,19.99,1272
447990,Spectrubes,13,8,1.99,5
297450,Zombies on a Plane,137,107,4.99,30
273800,Forestry 2017 - The Simulation,47,66,5.99,-19
397100,MachineCraft,691,211,0.0,480
453680,MiniGolf Mania,72,37,0.0,35
451920,Thorne - Death Merchants,202,42,3.99,160
397390,Space Food Truck,188,72,9.99,116
455110,Pertinence,25,10,3.99,15
455970,Nokori,23,27,0.99,-4
373480,1993 Space Machine,188,86,11.99,102
372000,Tree of Savior (English Ver.),12675,6954,0.0,5721
400240,The Deer,1396,859,0.35,537
427660,NightCry,157,105,24.99,52
377570,Space Drifters 2D,25,12,0.99,13
457530,My Lady,120,30,0.99,90
300060,ADR1FT,927,747,19.99,180
402260,Dead Secret,427,100,14.99,327
450110,Amigdala,78,34,5.99,44
445110,Tasty Planet: Back for Seconds,384,33,7.99,351
446310,Sabres of Infinity,119,7,2.99,112
446330,Guns of Infinity,87,4,4.99,83
457710,Road Madness,139,314,0.0,-175
409660,Angry Video Game Nerd II: ASSimilation,662,79,9.99,583
265000,FORCED SHOWDOWN,539,103,19.99,436
402530,The Last Door: Season 2 - Collector's Edition,700,43,9.99,657
456540,STAR WARS™: Rebel Assault I + II,126,70,9.99,56
444270,Hypersensitive Bob,48,8,4.99,40
432260,Tiltagon,77,29,2.99,48
455910,STAR WARS™: Rogue Squadron 3D,769,285,9.99,484
453950,To Ash,19,5,1.99,14
429390,XenoShyft,69,30,9.99,39
455640,Edgar,20,12,4.99,8
457580,The Visitor,153,49,0.0,104
366780,Magical Eyes - Red is for Anguish,52,10,7.49,42
366760,Adorables,595,207,2.99,388
363420,Leap of Fate,381,49,15.99,332
451880,Catch a Falling Star,423,151,1.99,272
398850,Epistory - Typing Chronicles,5548,298,14.99,5250
449000,Steno Arcade,142,40,0.0,102
345140,Crystal Rift,78,52,1.99,26
434480,Mathoria: It All Adds Up,50,38,0.0,12
454320,[the Sequence],144,15,4.99,129
427760,A Chair in a Room : Greenwater,501,95,24.99,406
257850,Hyper Light Drifter,14200,944,19.99,13256
382110,Virtual Desktop,1250,524,14.99,726
409280,Blue Sheep,18,21,1.99,-3
409560,Run Rabbit Run,69,17,3.99,52
348030,Trackday Manager,184,144,0.0,40
443380,Tokyo Babel,68,8,34.99,60
444440,Scapeland,38,26,3.99,12
437000,GUILTY GEAR 2 -OVERTURE-,167,78,19.99,89
457520,Moustache Mountain,97,36,1.99,61
448610,Draw Rider,116,43,1.99,73
407060,AltspaceVR,416,164,0.0,252
412600,Lup,152,194,1.99,-42
458420,Last Heroes 3,39,17,2.99,22
456430,Christmas Adventure: Candy Storm,304,32,1.99,272
448570,Origin Of Destiny: Crimson Awakening,90,34,0.0,56
457490,"Forgotten, Not Lost - A Kinetic Novel",196,26,1.99,170
392190,#SelfieTennis,79,25,9.99,54
400360,Adam's Venture: Origins,238,124,17.99,114
457860,Apollo 11 VR,497,99,9.69,398
442770,The Minims,14,5,9.99,9
429330,Stikbold! A Dodgeball Adventure,362,50,4.99,312
420930,CHKN,924,246,14.99,678
448640,Elements II: Hearts of Light,80,56,0.0,24
451650,Whirligig VR Media Player,344,88,3.99,256
449820,Daughter of Shadows: An SCP Breach Event,45,38,0.99,7
435800,Binaries,60,7,9.99,53
439310,Until I Have You,120,52,13.99,68
457960,Holopoint,628,72,14.99,556
434430,Abbot's Book Demo,173,21,0.0,152
426000,HunieCam Studio,4980,767,6.99,4213
409390,Marble Mountain,44,16,4.99,28
448880,Spells 'n' Stuff,7,4,9.99,3
454720,RAM BOE,14,6,1.99,8
447270,IKEA VR Experience,235,103,0.0,132
380670,Final Approach,328,21,14.99,307
418520,SculptrVR,88,5,19.99,83
432990,Green Game: TimeSwapper,50,7,2.99,43
388320,1979 Revolution: Black Friday,790,239,9.99,551
373470,A Wizard's Lizard: Soul Thief,40,13,0.0,27
448280,Job Simulator,3293,357,19.99,2936
314970,Age of Conquest IV,1921,459,0.0,1462
439550,'n Verlore Verstand,43,66,14.99,-23
433600,A Legend of Luca,163,41,9.99,122
445040,Sorcery! Part 3,77,8,9.99,69
414120,Modbox,191,26,14.99,165
411820,The FOO Show featuring Will Smith,132,21,0.0,111
457480,Domino Sky,259,60,3.99,199
270130,The Gallery - Episode 1: Call of the Starseed,1259,242,14.99,1017
443800,Ruckus Ridge VR Party,36,20,9.99,16
311690,Enter the Gungeon,64585,2620,14.99,61965
457230,Atlas Reactor VR Character Viewer,31,3,0.0,28
327140,Tilt Brush,1084,65,19.99,1019
358830,Good Robot,207,38,8.99,169
447100,XLR,8,14,4.99,-6
451520,theBlu,1069,190,5.99,879
428370,Windlands,653,191,19.99,462
452490,The Cubicle.,534,76,0.0,458
425720,Cloudlands : VR Minigolf,256,48,19.99,208
454890,Project Starship,379,71,2.99,308
457420,Surgeon Simulator VR: Meet The Medic,291,106,0.0,185
386690,Fantastic Contraption,211,60,19.99,151
412740,Audioshield,2208,523,19.99,1685
450390,The Lab,5105,258,0.0,4847
343730,Irrational Exuberance: Prologue,300,53,0.0,247
450020,DAMAGE CONTROL,11,13,0.99,-2
380220,Hover Junkers,512,299,19.99,213
449220,A grande bagunça espacial - The big space mess,687,383,0.99,304
447170,"Destiny's Princess: A War Story, A Love Story",192,60,15.99,132
458030,StarFringe: Adversus,29,30,0.99,-1
450540,"Hot Dogs, Horseshoes & Hand Grenades",15257,472,19.99,14785
446770,Skeet: VR Target Shooting,122,38,0.0,84
458700,Cursor Challenge,21,13,0.99,8
452710,Realities,183,65,0.0,118
431390,Diorama No.1 : Blocked In,22,10,0.0,12
455940,Odd||Even,54,43,19.99,11
457820,Outrage,87,52,3.99,35
241760,Kill to Collect,181,81,9.99,100
448500,Little Walker,34,2,3.99,32
454900,Amaranthine,94,8,0.89,86
431250,Mushroom Wars,398,112,9.99,286
405550,Jet Set Knights,59,12,9.99,47
444800,NO THING,245,33,3.99,212
443580,Antenna,1793,601,0.0,1192
427550,Tibetan Quest: Beyond the World's End,123,72,9.99,51
460150,One Last Chance,55,25,1.99,30
448910,Axes and Acres,107,22,9.99,85
400800,MXGP2 - The Official Motocross Videogame,421,148,14.99,273
450500,Ace of Seafood,457,57,11.99,400
457010,StarsOne,385,123,9.99,262
449760,Tenrow,132,27,2.99,105
394690,Tower Unite,14794,1641,19.99,13153
459310,The Hero Project: Redemption Season,70,40,3.99,30
443970,S2ENGINE HD,202,73,19.99,129
404640,Game Tycoon 2,123,122,3.99,1
423800,Automata Empire,35,15,8.99,20
446250,Silver Bullet: Prometheus,43,18,4.99,25
338310,Warden: Melody of the Undergrowth,62,13,19.99,49
456130,Space Scaven,27,2,6.99,25
377140,Hide & Hold Out - H2o,346,295,17.99,51
374320,DARK SOULS™ III,310407,21119,59.99,289288
453670,The Lost Souls,75,89,0.99,-14
345010,Ascent - The Space Game,229,106,19.99,123
402800,Chunks,21,26,0.0,-5
427470,Democracy 3 Africa,281,98,14.99,183
461840,Zenge,2722,139,0.99,2583
453850,Dear RED - Extended,229,111,2.99,118
439190,Stories: The Path of Destinies,5469,733,14.99,4736
447190,Pub Encounter,197,29,17.99,168
434020,Last Hope - Tower Defense,344,66,4.99,278
453820,Hero Quest: Tower Conflict,82,216,1.99,-134
347720,Soda Drinker Pro,517,33,4.99,484
422110,Wand Wars,190,12,11.99,178
431500,Clash of the Monsters,185,179,0.0,6
406290,Twilight Struggle,1977,283,9.99,1694
368080,Aurion: Legacy of the Kori-Odan,207,98,14.99,109
439940,Lucid9: Inciting Incident,909,97,0.0,812
437090,Wobbly Jungle,39,5,1.99,34
366260,METAL SLUG 2,575,87,6.99,488
417880,Everybody's Gone to the Rapture,953,407,19.99,546
408640,Code of Princess,160,127,14.99,33
377840,FINAL FANTASY IX,7977,494,20.99,7483
342550,Phantasmal: Survival Horror Roguelike,140,168,0.0,-28
377690,Starlight Vega,219,15,9.99,204
461010,Roll'd,216,60,0.99,156
453750,Tyto Ecology,307,95,6.99,212
421740,Goetia,503,142,14.99,361
449090,Zombie Parking,68,25,0.99,43
424780,Imperia Online,136,108,0.0,28
270410,I Want To Be Human,35,42,0.0,-7
458380,Gahkthun of the Golden Lightning Steam Edition,74,6,39.99,68
446620,Zombie Training Simulator,507,50,19.99,457
394540,Spaceport Hope,357,109,1.99,248
461180,SurrealVR,43,29,0.0,14
454970,Gravity Den,45,10,3.99,35
446910,Night Blights,86,9,6.99,77
405970,Flat Kingdom Paper's Cut Edition,142,49,7.99,93
337950,The SKIES - BETA,1685,2301,0.0,-616
353540,Stephen's Sausage Roll,1157,57,29.99,1100
462910,Poly Runner VR,55,13,0.0,42
413420,Danganronpa 2: Goodbye Despair,19580,708,19.99,18872
461710,Tales Across Time,54,12,2.99,42
301650,Battlezone 98 Redux,779,70,19.99,709
434290,Typefighters (Steam Edition),90,40,1.99,50
444720,Inexistence,231,116,2.99,115
415150,Pang Adventures,267,68,9.99,199
445130,The Average Everyday Adventures of Samantha Browne,818,194,0.0,624
458560,Plastic Playground,46,97,0.0,-51
447200,The Men of Yoshiwara: Ohgiya,172,27,15.99,145
403410,ARCADE GAME SERIES: Ms. PAC-MAN,163,27,3.99,136
448370,IS Defense,1305,101,5.99,1204
393430,Ice Lakes,1192,209,14.99,983
281640,The Banner Saga 2,2803,321,24.99,2482
357010,The Collider 2,33,11,0.0,22
394160,ARCADE GAME SERIES: PAC-MAN,580,77,3.99,503
365200,LOUD on Planet X,5,10,0.0,-5
411370,Melty Blood Actress Again Current Code,3171,253,24.99,2918
463850,Muddy Heights® 2,197,60,2.99,137
410380,HEX: Shards of Fate,1097,646,0.0,451
207140,SpeedRunners,31106,2031,14.99,29075
403400,ARCADE GAME SERIES: DIG DUG,341,57,3.99,284
403430,ARCADE GAME SERIES: GALAGA,544,66,3.99,478
412450,The Black Death,1193,993,0.0,200
371010,Nomad Fleet,127,62,4.99,65
460910,A-Gents,101,24,2.99,77
458000,March of the Living,384,145,14.99,239
444520,Leave Me Alone: A Trip To Hell,81,20,1.99,61
462480,Sweet Escape VR,45,7,4.99,38
456690,Weather Lord: Following the Princess Collector's Edition,32,7,9.99,25
299380,Masquerade: The Baubles of Doom,15,42,14.99,-27
444640,Bloons TD Battles,23228,2491,0.0,20737
462110,3 Coins At School,37,62,4.99,-25
422650,Megamagic: Wizards of the Neon Age,69,20,9.99,49
353630,Oil Enterprise,85,88,24.99,-3
422100,Heaven Island Life,366,317,0.99,49
322330,Don't Starve Together,328702,13277,14.99,315425
363680,Battlefleet Gothic: Armada,3665,1692,2.99,1973
464540,Colosse,118,25,0.0,93
434130,Witch and Hero(魔女と勇者),65,11,4.99,54
437100,My Night Job,75,9,3.99,66
299480,Rogue Stormers,656,297,19.99,359
377360,Western Press,149,81,4.99,68
458480,Mythic Wonders: The Philosopher's Stone,265,34,9.99,231
414730,Epic Clicker Journey,453,220,0.0,233
463030,Bottle,260,144,0.74,116
453100,Frederic: Resurrection of Music Director's Cut,258,55,5.99,203
446990,The Huntsman: Winter's Curse,206,77,0.0,129
427250,8-Bit Armies,1769,396,14.99,1373
453710,TableTop Soccer,87,22,0.99,65
428830,Save the Dodos,141,17,2.99,124
454420,Mini Metal,19,7,9.99,12
457680,OPUS: The Day We Found Earth,1017,154,8.99,863
379210,Wayward,886,158,7.99,728
332410,Moonchild,107,27,4.99,80
462220,Mahjong Deluxe 3,77,33,3.99,44
429280,Gems of the Aztecs,113,46,4.99,67
338130,Strategy & Tactics: Wargame Collection,170,74,9.99,96
444250,Crown and Council,482,268,0.0,214
449710,REDCON,410,106,5.99,304
461520,Grizzly Valley,94,137,4.99,-43
463390,One Thousand Lies,906,101,0.0,805
434490,Otem's Defiance,28,0,6.99,28
251270,Corpse Party,997,107,14.99,890
464230,Colours of Magic: Aqua Teeter,69,17,0.99,52
457320,HoloBall,413,45,5.99,368
370940,Demons with Shotguns,54,4,9.99,50
461230,Dashy Square,143,19,2.99,124
461750,Ghoul Kid,103,38,0.0,65
462960,Caveman World: Mountains of Unga Boonga,407,196,1.13,211
428430,Endorlight,822,520,1.99,302
462950,The East New World,25,24,0.0,1
464700,Maui,187,187,0.0,0
284410,Cornerstone: The Song of Tyrim,53,37,19.99,16
415480,Hyperdevotion Noire: Goddess Black Heart (Neptunia),716,168,14.99,548
387290,Ori and the Blind Forest: Definitive Edition,51300,2237,4.99,49063
462730,Townopolis,66,32,3.99,34
461890,NORTH,260,155,1.99,105
458830,Snooker Nation Championship,173,104,3.99,69
463210,State of Anarchy,892,154,1.99,738
436160,The Panic Room. House of secrets,230,179,0.0,51
443650,Wailing Heights,85,20,9.99,65
438130,Root Double -Before Crime * After Days- Xtend Edition,364,34,34.99,330
461040,PICO PARK:Classic Edition,522,241,0.0,281
465450,iOMoon,30,6,5.99,24
362350,Boss Monster,224,134,0.0,90
386080,Pharaonic,200,43,14.99,157
463000,Hero Battle,98,54,6.99,44
462570,New Yankee in King Arthur's Court,24,5,4.99,19
462000,Cyberpong,95,13,8.99,82
377530,侠客风云传(Tale of Wuxia),4622,1449,16.99,3173
401820,FATED: The Silent Oath,92,38,9.99,54
457550,Bigscreen Beta,2248,373,0.0,1875
428750,Neon Chrome,988,84,14.99,904
433380,Back in 1995,71,34,9.99,37
437180,Chill the Piro,23,8,1.99,15
271920,Worlds Adrift Island Creator,412,86,0.0,326
466000,Maze: Subject 360 Collector's Edition,31,0,9.99,31
446450,Blaster Simulator,14,26,0.99,-12
408740,Pro Gamer Manager,350,349,9.99,1
271240,Offworld Trading Company,3995,1207,11.99,2788
417750,Left Alone,439,143,6.99,296
385080,Guardians of Victoria,61,179,1.99,-118
463710,Puzzle Galaxies,88,58,0.99,30
456810,Zombillie,168,71,4.99,97
461970,Skyreach,69,97,0.0,-28
454530,Decisive Campaigns: Barbarossa,159,18,49.99,141
461850,Abrix 2 - Diamond version,54,32,1.99,22
463920,Initia: Elemental Arena,27,63,11.99,-36
303290,OZMAFIA!!,487,93,34.99,394
377480,N.E.R.O.: Nothing Ever Remains Obscure,117,55,14.99,62
412050,HordeZ,333,63,16.99,270
392120,City Z,12,14,3.99,-2
449470,Atulos Online,183,79,0.0,104
391420,Gun Rocket,500,189,1.99,311
466720,Vintage VR,77,8,0.0,69
423720,Color Chaos,11,2,0.99,9
463290,Kismet,125,12,0.0,113
451700,Secrets of Deep Earth Shrine,7,7,0.99,0
394230,Battleborn,5992,3694,0.0,2298
428540,Fragments of Him,107,20,9.99,87
448020,Share,192,72,0.99,120
383580,Flesh Eaters,948,379,1.99,569
385560,Shadow Complex Remastered,690,130,14.99,560
288140,Perfect Golf,557,299,34.99,258
456210,A Land Fit For Heroes,15,12,0.0,3
463100,Liveza: Death of the Earth,84,69,2.99,15
466910,Worm.is: The Game,3624,881,0.0,2743
454690,Cyber City 2157: The Visual Novel,117,96,4.99,21
467370,Escape This,257,307,0.99,-50
399600,I and Me,335,15,9.99,320
370910,Kathy Rain,3232,262,14.99,2970
463180,Super Blue Fighter,86,26,0.0,60
431590,Earn to Die 2,635,58,4.99,577
342970,Pixel Survivors,186,91,3.99,95
408110,Planet R-12,165,32,0.99,133
290060,Glitchspace,251,90,0.0,161
461880,Hyposphere,97,90,2.99,7
463760,The Beggar's Ride,134,33,5.99,101
452120,Midvinter,58,11,2.99,47
459470,Wars of Napoleon,51,43,39.99,8
465760,Scrap Garden,802,257,9.99,545
454870,Magic Quest,32,17,1.99,15
373720,Ryzom,287,130,0.0,157
449140,Istrolid,2266,325,0.0,1941
461910,Forge of Gods (RPG),2003,666,0.0,1337
394760,Dead Effect 2,1495,557,11.99,938
447940,Brine,101,282,3.99,-181
466890,Z.I.O.N.,107,174,0.54,-67
467380,Khimera: Destroy All Monster Girls,1225,56,0.0,1169
281990,Stellaris,117388,16105,39.99,101283
467310,Rogue Port - Red Nightmare,71,20,1.99,51
350110,TransOcean 2: Rivals,305,281,29.99,24
420790,StarBreak,934,258,0.0,676
468320,Mini Golf Mundo,71,76,2.99,-5
365190,TASTEE: Lethal Tactics,187,43,0.0,144
460960,The Deed: Dynasty,385,51,1.7,334
447180,My Secret Pets!,84,40,15.99,44
448440,Bizarre Earthquake,254,192,1.99,62
463220,Dungeon of Zolthan,389,115,1.99,274
469730,Super Mega Neo Pug,605,119,1.99,486
466580,GOD's DEATH,8,12,3.99,-4
465930,OddPlanet,78,68,5.99,10
435970,RefRain - prism memories -,98,2,14.99,96
433910,Neon Drive,1668,323,9.99,1345
363520,Goliath,186,85,11.99,101
467000,Insincere,125,122,3.99,3
351990,Riff Racer - Race Your Music!,1722,317,9.99,1405
466490,Princess Isabella: The Rise of an Heir,80,67,9.99,13
453270,Madness Cubed,661,208,1.99,453
359870,FINAL FANTASY X/X-2 HD Remaster,13124,1329,29.99,11795
468490,Neon Space,371,132,10.99,239
379720,DOOM,159063,7906,19.99,151157
461780,Moonstone Tavern - A Fantasy Tavern Sim!,66,68,7.99,-2
461640,Sins Of The Demon RPG,783,148,1.99,635
398680,Ace Of Words,538,280,4.99,258
467220,Dyna Bomb,31,8,1.99,23
427730,Who's Your Daddy?!,18779,5096,4.99,13683
454060,Blueprint Tycoon,854,185,2.99,669
303310,The House in Fata Morgana,2537,111,24.99,2426
453830,Innoquous 5,25,3,0.99,22
473510,Gal-X-E,66,9,0.0,57
473520,Autumn,117,93,0.49,24
467930,SMASHING THE BATTLE,431,145,11.99,286
469650,Disney Movies VR,108,92,0.0,16
467210,Evo Explores,309,18,3.99,291
361350,Skyhook,97,16,4.99,81
283640,Salt and Sanctuary,14973,1604,17.99,13369
402310,Overfall,394,468,4.99,-74
223100,Homefront®: The Revolution,8694,6043,19.99,2651
425210,Shadwen,888,280,16.99,608
432620,Mimic Arena,9,5,7.99,4
460160,The Leisure of Grisaia,255,22,2.99,233
469890,Space Codex,295,63,0.51,232
473560,Cosmic Dust & Rust,247,179,1.99,68
471170,Romopolis,80,28,3.99,52
254320,Duskers,1954,219,19.99,1735
368640,htoL#NiQ: The Firefly Diary,378,141,9.99,237
449170,Gnomes Garden 2,145,8,4.99,137
462070,IWO: Bloodbath in the Bonins,11,16,9.99,-5
452420,Koihime Enbu 恋姫†演武,247,41,4.99,206
397190,Sengoku Jidai: Shadow of the Shogun,112,33,29.99,79
474030,The Abbey of Crime Extensum,193,31,0.0,162
356180,Time Machine VR,72,41,29.99,31
448310,Bitardia Cards: Memes of 2ch,142,50,0.0,92
438680,One Troll Army,1156,194,0.0,962
463440,Retool,1,5,7.99,-4
463930,The Dweller,528,39,0.54,489
468800,Arkshot,101,31,0.74,70
465360,Uprising: Join or Die,66,13,6.99,53
449240,Stormworm+,54,2,0.0,52
461380,A Princess' Tale,29,17,4.99,12
467950,Survive in Space,214,92,10.99,122
475240,ORCS,308,66,1.99,242
381120,Shoppe Keep,1721,1048,4.99,673
470450,Where's My Helmet?,55,22,0.99,33
311010,The Way,957,174,14.99,783
419590,Tales from the Void,34,14,9.99,20
270210,Melody's Escape,4483,339,9.99,4144
476490,Choice of the Pirate,90,7,3.99,83
451100,Cubikolor,32,2,7.99,30
401680,POSTAL Redux,2916,245,8.99,2671
458750,FireAlpaca SE,87,9,39.99,78
461700,Seduce Me 2: The Demon War,344,27,9.99,317
413830,Overdosed - A Trip To Hell,10,6,6.99,4
364880,Genesis of Drones,19,14,0.0,5
454600,Age of Cavemen,310,236,0.0,74
345480,Lumo,76,30,14.99,46
477130,Surge,241,15,0.0,226
364360,Total War: WARHAMMER,38579,11004,59.99,27575
434520,Simutrans,341,108,0.0,233
473480,Miko Mole,9,8,4.99,1
461210,Riding Out,66,104,19.99,-38
450670,Table Top Racing: World Tour,474,144,3.99,330
473670,The Dolls: Reborn,127,154,4.99,-27
246820,Jeklynn Heights,16,5,0.0,11
445770,Airport Madness 3D,258,54,19.99,204
474910,The Mahjong Huntress,112,90,4.99,22
385950,Infection: Humanity's Last Gasp,18,27,9.99,-9
366280,TWINKLE STAR SPRITES,132,43,7.99,89
467520,Power & Revolution,675,504,49.99,171
466420,Warriors' Wrath,47,24,0.99,23
357030,Excubitor,19,8,14.99,11
465090,Don Bradman Cricket 17 Demo,3,2,0.0,1
479150,BoX -containment-,5,0,0.99,5
466780,Prehistoric Tales,63,20,2.99,43
415740,OmniBus,373,86,4.99,287
374670,Ember Strike,818,207,0.0,611
444590,Skautfold: Shrouded in Sanity,377,70,4.99,307
473840,Diib's Dilemma,25,3,1.99,22
466170,Idling to Rule the Gods,1124,161,0.0,963
461030,A Long Way Home,23,13,1.99,10
463150,BARRIER X,1922,290,2.99,1632
453770,Forgotten Tales: Day of the Dead,36,15,9.99,21
468560,Blind Trust,745,702,0.0,43
372490,GROOVY,73,47,5.99,26
454100,Dungeon Escape,537,144,3.99,393
407940,Hyper Bounce Blast,75,4,4.99,71
466500,35MM,2759,1107,8.99,1652
478010,ABC Coloring Town,197,91,1.99,106
449300,Planar Conquest,268,183,19.99,85
476240,KNIGHTS,639,35,0.51,604
454200,Neon Hardcorps,122,151,1.99,-29
466800,The Dope Game,163,37,4.99,126
368800,Apocalypse: Party's Over,135,22,0.0,113
383150,Dead Island Definitive Edition,11974,2761,19.99,9213
310370,The Way of Life Free Edition,4805,1669,0.0,3136
463980,Solitairica,304,78,9.99,226
477270,Lightblade VR,511,128,3.99,383
483970,Directionless,50,12,0.99,38
485950,Rise of the Ancients,104,167,0.56,-63
372350,Tumbleweed Express,100,12,3.99,88
485800,Runeous: Part One,80,25,0.0,55
465920,Echoes of the Past: The Revenge of the Witch Collector's Edition,4,1,6.99,3
433350,BlackShot: Mercenary Warfare FPS,1566,1324,0.0,242
337360,Dead Island Retro Revenge,194,143,4.99,51
423620,HERO DEFENSE,437,240,2.99,197
451570,Demetrios - The BIG Cynical Adventure,278,52,9.99,226
469990,NEKOPALIVE,1320,107,0.0,1213
379420,Polynomial 2 - Universe of the Music,118,21,11.99,97
383180,Dead Island: Riptide Definitive Edition,2964,978,19.99,1986
420670,Elite vs. Freedom,31,49,4.99,-18
436820,Waltz of the Wizard (Legacy demo),1368,54,0.0,1314
459440,Tower!3D,37,56,0.0,-19
454230,SLG Remix,12,28,2.99,-16
482300,Investigator,654,277,4.99,377
485890,Summer Sale,549,375,0.99,174
369550,Blacksea Odyssey,162,38,9.99,124
342130,Hashtag Dungeon,20,14,0.0,6
393860,Smoots World Cup Tennis,19,18,14.99,1
444130,Auralux: Constellations,102,28,9.99,74
443420,Artificial Defense,170,33,2.99,137
485330,Star Drifter,91,104,1.99,-13
269170,Sports Bar VR,693,120,19.99,573
479100,Music Wars Empire,62,66,14.99,-4
428220,TurnOn,288,58,14.99,230
431850,Projector Face,65,12,0.99,53
423220,T-Kara Puzzles,20,2,4.99,18
411830,SENRAN KAGURA SHINOVI VERSUS,3464,191,19.99,3273
477200,Descent: Road to Legend,300,35,0.0,265
474010,The NADI Project,277,142,0.0,135
477290,Magma Tsunami,198,105,0.99,93
458470,Grim Legends 3: The Dark City,602,48,9.99,554
440540,Ara Fell: Enhanced Edition,1465,73,14.99,1392
380750,Anima: Gate of Memories,444,213,19.99,231
339110,Plith,17,15,2.99,2
274500,Brigador: Up-Armored Edition,4258,228,19.99,4030
446390,Onechanbara Z2: Chaos,614,182,39.99,432
467090,A Game of Changes,32,28,0.99,4
405500,Dangerous Golf,299,327,19.99,-28
467960,Home Behind,4654,798,5.99,3856
486360,Timore Inferno,202,128,4.99,74
453300,A Healer Only Lives Twice,138,34,4.99,104
420100,CLANNAD Side Stories,232,30,19.99,202
467430,Farming 6-in-1 bundle,36,13,0.89,23
361280,Turmoil,9381,765,9.99,8616
485760,Legend of Numbers,69,25,0.0,44
485310,Head Shot,870,874,1.99,-4
485860,Impossible Quest,211,81,1.99,130
407810,Hard Reset Redux,1506,352,19.99,1154
451000,Ember Kaboom,98,19,2.99,79
407330,Sakura Dungeon,1624,150,19.99,1474
482390,The Night Cafe: A VR Tribute to Vincent Van Gogh,241,10,0.0,231
298560,Captain Forever Remix,292,67,9.99,225
436280,Sudoku Quest,54,27,4.99,27
485500,Smithy,59,19,0.51,40
386490,Wanda - A Beautiful Apocalypse,109,70,1.99,39
485560,POPixel,47,14,1.49,33
485490,Dungeon Journey,182,51,0.51,131
470590,moto RKD dash SP,47,19,2.99,28
402880,Age of Barbarian Extended Cut,554,152,12.99,402
480480,Slash or Die,211,31,1.99,180
485690,Hope Lake,329,119,7.99,210
467390,Approaching Blocks,186,103,1.99,83
459160,Allods Online,415,180,0.0,235
385380,Planet Centauri,1463,331,14.99,1132
466840,Super Space Pug,150,124,1.99,26
409890,Stranger of Sword City,380,187,19.99,193
487370,Akin,278,38,0.99,240
391820,Evolution,37,43,0.0,-6
487590,Pepe Porcupine,67,53,0.99,14
463270,Ghost 1.0,1727,151,12.99,1576
396680,Sol Trader,45,20,19.99,25
394360,Hearts of Iron IV,175219,15155,39.99,160064
445550,Watson's Watch,8,2,7.99,6
485870,Super Duper Party Pooper,341,90,0.99,251
347170,Combat Air Patrol 2: Military Flight Simulator,144,148,29.99,-4
327510,WASTED,842,264,12.99,578
488210,JDM Tuner Racing,160,183,0.49,-23
376450,Last Days of Old Earth,34,22,24.99,12
322190,SteamWorld Heist,4263,254,2.24,4009
340770,Death Goat,254,80,0.0,174
313630,The Solus Project,1992,499,19.99,1493
393460,Crazy Pixel Streaker,51,35,4.99,16
393530,Insanity Clicker,1835,865,0.0,970
439880,Heroes of Loot 2,26,9,3.99,17
442810,UFO Online: Invasion,342,242,0.0,100
459130,Love in the Glen,37,23,5.99,14
487580,Ludo Supremo,73,55,1.99,18
471630,Rexodus: A VR Story Experience,79,31,0.0,48
366620,Broken Bots,33,8,6.99,25
416450,Emporea: Realms of War and Magic,305,158,0.0,147
466730,King's Guard TD,210,137,2.99,73
456780,DUCATI - 90th Anniversary,154,66,9.99,88
485620,Pick a Hero,32,14,0.0,18
477750,Thirty Years' War,31,15,29.99,16
489020,iGrow Game,117,92,0.99,25
430290,Shmups Skill Test シューティング技能検定,46,3,4.99,43
411610,Tick's Tales,57,9,7.99,48
376570,WildStar,3682,1294,0.0,2388
327070,Gloria Victis: Medieval MMORPG,5144,2045,7.99,3099
280520,Crea,1025,302,14.99,723
431640,Doodle Kingdom,76,100,8.99,-24
473140,BomberZone,89,36,0.99,53
464690,Vroomist,8,32,6.99,-24
384500,Zombie Party,553,93,9.99,460
350640,Sherlock Holmes: The Devil's Daughter,9528,2480,5.99,7048
487600,Puzzles Under The Hill,69,34,0.99,35
485570,Milford Heaven - Luken's Chronicles,34,18,1.49,16
470060,1917 - The Alien Invasion DX,102,27,4.99,75
452860,Mad Bullets,277,23,14.99,254
438920,Legends of Callasia,207,62,0.0,145
446050,Operation KREEP,13,3,2.99,10
466430,Choice of Alexandria,68,3,2.99,65
461480,Archibald's Adventures,66,7,4.99,59
476410,One Small Fire At A Time,53,4,9.99,49
467120,Rising Runner,12,1,0.0,11
480500,Dogfight Elite,18,11,0.0,7
489700,Battle Forever,12,15,0.0,-3
482890,Fantasy Kingdom Simulator,44,56,0.49,-12
489900,Bayla Bunny,59,70,1.99,-11
435480,Trials of the Blood Dragon,129,66,14.99,63
488280,Gun Done,528,57,0.99,471
277700,On Rusty Trails,208,23,12.99,185
432310,Virtual Pool 4 Multiplayer,71,39,0.0,32
364420,Roguelands,2919,715,9.99,2204
490860,DashBored,189,59,4.99,130
449210,Verdict Guilty - 유죄 평결,610,110,4.99,500
472680,Elisa: The Innkeeper - Prequel,568,162,0.0,406
454180,CrazyCars3D,141,70,2.99,71
464080,Kyoto Colorful Days,139,25,9.99,114
476510,Cally's Trials,115,47,6.99,68
473450,The Narrator Is a DICK,102,25,4.99,77
491160,GemBreak,83,27,4.0,56
473460,Memory Oblivion Box,830,62,9.99,768
488580,Hover 2030,57,19,0.99,38
381210,Dead by Daylight,494648,112924,7.99,381724
485380,Welcome to the Game,1788,328,4.99,1460
490230,SWARMRIDERS,380,46,0.0,334
463060,Clover Tale,575,195,0.0,380
489220,Unforgiving Trials: The Darkest Crusade,406,228,0.51,178
485080,Megapolis,94,31,3.99,63
486720,Bastard Bonds,503,61,10.99,442
462400,Slide Ride Arcade,5,3,4.99,2
441050,Polandball: Can into Space!,470,27,2.99,443
376250,Ground Breakers,37,15,0.99,22
487030,Beasts Battle,63,22,3.99,41
423650,Summer Fling,65,38,12.99,27
385370,Radiator 2: Anniversary Edition,2407,390,0.0,2017
453290,Awareness Rooms,303,70,4.99,233
487220,Freebie,1003,357,1.99,646
438430,Valentino Rossi The Game,322,74,14.99,248
444930,Zaccaria Pinball,951,186,0.0,765
400510,The Final Take,186,159,1.99,27
489580,AWA,70,20,2.99,50
408760,Pro Cycling Manager 2016,247,132,9.99,115
365300,Transmissions: Element 120,8734,520,0.0,8214
464800,Twisted Worlds,68,59,0.0,9
492160,3D Pool,22,23,0.99,-1
450190,MAZE LORD,176,49,4.99,127
431260,Cursed,495,122,4.99,373
489470,Hide and Secret Treasure of the Ages,23,34,4.99,-11
472870,Higurashi When They Cry Hou - Ch.3 Tatarigoroshi,553,12,3.99,541
463350,Storm Of Spears RPG,394,145,1.99,249
491330,12 Labours of Hercules V: Kids of Hellas (Platinum Edition),334,35,2.99,299
491580,Mahjong Destiny,61,47,1.99,14
465890,Dark Parables: The Final Cinderella Collector's Edition,22,0,9.99,22
491090,Ant Queen,146,91,5.99,55
355800,Space Run Galaxy,599,328,9.99,271
464440,Annie Amber,49,33,2.99,16
451760,Highway Blossoms,2287,118,12.99,2169
484950,Evil Maze,883,284,1.99,599
442070,Drawful 2,2336,556,9.99,1780
487770,Hoops VR,48,15,5.99,33
463110,Farnham Fables,260,106,0.54,154
376240,Hadean Lands,35,1,11.99,34
447530,VA-11 Hall-A: Cyberpunk Bartender Action,28716,676,14.99,28040
314710,Mighty No. 9,1520,1545,2.99,-25
455400,PAC-MAN 256,1521,127,1.99,1394
423950,Deadlight: Director's Cut,827,329,11.99,498
390340,Umbrella Corps,796,1940,19.99,-1144
391310,Alien Attack,160,51,1.99,109
460940,Father´s Island,31,21,4.99,10
452970,Asemblance,80,40,7.99,40
472060,Ortus Regni,147,29,0.0,118
436270,Civil War: 1863,28,18,9.99,10
486850,Card of spirits,72,22,0.99,50
464780,ChuSingura46+1 S,838,127,0.0,711
465190,Space Survival,15,36,0.99,-21
489460,The Last Leviathan,356,185,9.99,171
490990,Aiball,73,65,1.99,8
382050,Eon Altar,629,98,1.24,531
473470,Purgatory,141,92,1.99,49
460640,Breached,73,57,6.99,16
454160,Dark Fear,174,10,3.99,164
345620,The Labyrinth of Grisaia,102,14,29.99,88
423710,Invasion: Brain Craving,129,174,1.99,-45
340030,Dungeon of gain,7,45,4.99,-38
454380,Champions of Breakfast,125,1,2.99,124
486500,Spooky Heroes,22,15,4.99,7
388840,CATS!,24,60,0.0,-36
488460,Zeus Quest Remastered,22,11,0.0,11
398150,Ace of Protectors,53,33,1.99,20
487430,KARAKARA,1618,160,9.99,1458
489610,Chicken Assassin: Reloaded,716,53,4.99,663
438640,LEGO® STAR WARS™: The Force Awakens,4849,849,19.99,4000
360880,Nightfall: Escape,23,32,9.99,-9
370840,Rugby Challenge 3,72,41,49.99,31
338390,The Technomancer,1694,749,9.99,945
311240,Zero Escape: Zero Time Dilemma,2678,453,19.99,2225
460230,Starters Orders 6 Horse Racing,82,21,34.99,61
448710,VirZOOM Arcade,23,6,0.0,17
474050,Candy Blast,61,56,3.99,5
444140,Sonicomi,466,50,34.99,416
462990,Tomoyo After ~It's a Wonderful Life~ English Edition,466,37,19.99,429
437870,Earth Space Colonies,84,80,9.99,4
485000,Cthulhu Realms,147,58,0.0,89
490390,神明的一天世界(God's One Day World),610,102,9.99,508
369030,Vinyl,167,116,0.0,51
492170,Planet Driller,47,25,1.99,22
462700,Cricket Captain 2016,39,19,9.99,20
454220,The Temporal Invasion,72,26,6.99,46
334280,Lost Sea,39,24,14.99,15
380660,Killing Time at Lightspeed: Enhanced Edition,113,21,9.99,92
463800,FreeHolder,73,18,9.99,55
423230,Furi,8882,889,19.99,7993
425580,The Room Two,14447,316,4.99,14131
418340,RWBY: Grimm Eclipse,9334,2123,19.99,7211
460120,Megadimension Neptunia VII,2895,153,19.99,2742
490950,Frost,124,13,6.99,111
482920,Hero Zero,2551,562,0.0,1989
491260,Take Thy Throne,137,91,1.99,46
440630,The Brookhaven Experiment,735,116,19.99,619
442080,Riders of Icarus,6836,3492,0.0,3344
425820,Dragonpath,78,18,3.19,60
493650,Deep Space Dash,96,231,1.99,-135
493310,Requiem: Avenging Angel,64,14,9.99,50
497860,Zezenia Online,188,89,0.0,99
498980,DUO,25,9,8.99,16
417920,Mistfal,26,29,0.0,-3
493810,Jonah's Path,47,21,0.0,26
497590,Sapper's bad dream,14,15,0.99,-1
485040,Nurse Love Addiction,653,50,39.99,603
304430,INSIDE,36171,1351,19.99,34820
487700,Conan the mighty pig,897,93,0.51,804
497050,Shape Shifter,73,73,1.99,0
423550,Day D: Tower Rush,164,52,4.99,112
492600,Ridge,14,10,7.99,4
437160,The Lion's Song: Episode 1 - Silence,1919,143,0.0,1776
498510,DreamLand,37,27,0.0,10
461490,Kaboom Monsters,65,53,0.53,12
274270,NOT A HERO,1692,255,19.99,1437
491130,Red Trigger,1815,198,0.0,1617
491220,Mr. Pumpkin Adventure,186,21,3.99,165
466350,Fossil Echo,82,48,9.99,34
314010,Boid,579,145,0.0,434
406550,Umineko When They Cry - Question Arcs,1276,57,24.99,1219
399130,Massive Cleavage vs Zombies: Awesome Edition,82,93,2.99,-11
493720,Haven Moon,385,105,9.99,280
496530,Pigmentone,31,14,1.99,17
479130,ESEA,3090,1130,0.0,1960
378090,Rebel Wings,14,5,0.0,9
490820,Fly O'Clock,440,80,0.99,360
486150,Radical Spectrum: Volume 1,57,48,1.99,9
488220,Valcarta: Rise of the Demon,16,8,1.99,8
498660,Mind Spheres,518,152,0.49,366
492530,The Dark Legions,98,21,1.99,77
473810,Killbot,38,69,0.99,-31
496890,Replica,2761,425,2.99,2336
370130,Lion Quest,26,23,5.99,3
460700,Song of the Deep,654,122,14.99,532
491040,Bot Vice,1107,68,9.99,1039
500190,Firefight,58,16,9.99,42
497670,Line/Dash,25,7,1.99,18
499460,Tomato Jones,154,29,1.99,125
494290,MiDZone,29,41,2.99,-12
368680,Super Mutant Alien Assault,125,17,9.99,108
468070,90 Minute Fever - Online Football (Soccer) Manager,155,95,0.0,60
390720,Anarcute,491,33,14.99,458
465750,Tank Battle: North Africa,22,8,9.99,14
464960,Hiiro,253,33,2.99,220
269710,Tumblestone,1372,418,2.49,954
452510,UNDER NIGHT IN-BIRTH Exe:Late,840,84,29.99,756
416120,InterSection,6,2,8.99,4
367450,Poly Bridge,13188,1211,9.99,11977
261900,The Real Texas,28,2,14.99,26
454520,MilitAnt,24,12,9.99,12
277390,VIDEOBALL,147,24,9.99,123
485370,Mad Combat Marines,270,125,0.99,145
404820,Ragdoll Runners,238,22,4.99,216
499440,klocki,4350,130,1.99,4220
490300,Rabbit Island,19,9,1.99,10
406850,Crush Your Enemies,314,66,9.99,248
492280,The Agency: Chapter 1,30,13,1.49,17
492430,Alteric,79,37,3.99,42
491000,Gravity Cat,381,94,2.99,287
444620,SpellKnights,33,45,0.0,-12
499620,Ultimate Booster Experience,253,72,4.99,181
362380,Push Me Pull You,24,7,14.99,17
393930,RoShamBo,283,159,0.0,124
465170,Crime Secrets: Crimson Lily,301,110,9.99,191
468700,NVIDIA® VR Funhouse,618,160,0.0,458
502550,Strike.is: The Game,944,346,0.0,598
496980,Cosmic Cavern 3671　　宇宙最大の地底最大の作戦,12,5,4.99,7
486480,Tales of Destruction,33,117,0.51,-84
461830,Adventure Apes and the Mayan Mystery,14,5,2.99,9
494810,VR: Vacate the Room (Virtual Reality Escape),198,36,3.99,162
315430,Polarity,3787,955,12.99,2832
470480,Angel Express [Tokkyu Tenshi],30,8,9.99,22
502140,Drayt Empire,119,118,1.99,1
498620,The Shadowland,25,19,3.99,6
501050,Emerland Solitaire: Endless Journey,72,22,0.0,50
410320,EARTH DEFENSE FORCE 4.1 The Shadow of New Despair,7129,401,19.99,6728
495010,Ranger of the jungle,18,29,3.99,-11
500580,Kitty Cat: Jigsaw Puzzles,197,45,0.99,152
381940,Trials on Tatooine,1050,267,0.0,783
502880,The Janitor,28,93,0.99,-65
503480,Mahluk:Dark Demon,94,51,3.99,43
435790,10 Second Ninja X,2083,481,0.99,1602
502230,Monsters' Den: Book of Dread,152,12,4.99,140
326520,Chime Sharp,100,39,9.99,61
479110,Hunter's Legacy,31,11,6.99,20
290000,DubWars,224,62,9.99,162
464490,The Afterglow of Grisaia,91,3,8.99,88
454250,The Eyes of Ara,496,89,14.99,407
373650,The Assembly,103,43,29.99,60
468530,A Date in the Park,1266,199,0.0,1067
490880,Robot Legions Reborn,40,9,2.99,31
441830,I am Setsuna,1094,403,39.99,691
496630,Empty Horizons,71,11,2.99,60
501120,1$ Fun: Clock Simulator,357,47,1.0,310
393200,Bad Rats Show,656,162,1.99,494
416680,Zombie Night Terror,2644,200,1.29,2444
486810,House of Snark 6-in-1 Bundle,75,12,11.99,63
425300,Super Button Soccer,65,29,6.99,36
427910,Zavix Tower,253,87,9.99,166
467900,SWORDY,64,33,14.99,31
404770,SUPERFIGHT,227,142,0.0,85
252610,Death Road to Canada,6196,456,14.99,5740
497260,Fabulous Food Truck,64,63,2.99,1
287900,Pro Pinball Ultra,193,38,14.99,155
501030,Extravaganza Rising,30,13,0.0,17
474730,Airship Asunder,9,9,9.99,0
318090,DICETINY: The Lord of the Dice,164,74,0.99,90
299800,The Land of Eyas,56,9,0.99,47
443570,DreamBreak,49,53,1.04,-4
376520,Kelvin and the Infamous Machine,736,82,9.99,654
381880,Red Rope: Don't Fall Behind,87,13,7.99,74
501430,Blue Solar: Chaos War,111,33,0.0,78
465720,Demon Hunter 2: New Chapter,154,65,9.99,89
457450,Defend Your Crypt,40,7,2.99,33
436000,Lovely Planet Arcade,102,30,5.99,72
498580,ASRECorp,27,10,0.99,17
211820,Starbound,145902,11330,14.99,134572
474240,Journey to the Center of the Earth,16,19,9.99,-3
477160,Human: Fall Flat,157904,8930,5.99,148974
492800,Shonen Idle Z,290,232,0.0,58
497400,1 Moment Of Time: Silentville,483,138,0.99,345
500870,Riddles Of The Past,188,48,6.99,140
500750,GI Racing 2.0,35,7,0.0,28
496680,SweatShop,189,224,0.99,-35
340000,Headlander,843,84,19.99,759
500360,VRMultigames,62,19,0.0,43
409870,Phantom Brave PC,412,60,19.99,352
482330,Legends of the Universe - StarCore,76,21,1.99,55
458710,Kingdom Rush Frontiers - Tower Defense,5866,204,9.99,5662
240440,Quadrilateral Cowboy,743,66,9.99,677
498330,Cats are Liquid - A Light in the Shadows,559,45,0.64,514
232450,SolForge,776,413,0.0,363
495890,Montaro,11416,545,0.99,10871
487530,Simple Ball: Extended Edition,76,24,1.99,52
447570,Regeria Hope Episode 1,291,56,0.0,235
488660,Just Deserts,241,81,9.99,160
505210,Neon Space 2,261,109,10.99,152
443860,Riptide GP: Renegade,235,21,9.99,214
433300,Marvel: Ultimate Alliance,339,204,0.0,135
501090,"Design it, Drive it : Speedboats",48,10,24.99,38
498040,The Hidden Dragon,42,54,2.99,-12
496640,Strange Night,198,118,0.49,80
433320,Marvel: Ultimate Alliance 2,181,167,0.0,14
501760,Francisca,208,121,0.99,87
498050,Mystery Of Rivenhallows,46,70,2.99,-24
506670,ORBITAL,200,71,0.99,129
338170,Ratz Instagib,3119,411,8.99,2708
496260,Corona Blossom Vol.1 Gift From the Galaxy,273,10,9.99,263
496650,Antihorror,132,44,0.99,88
504100,Russian VR Coasters,21,13,4.99,8
508290,$1 Ride,384,439,1.99,-55
503820,A Detective's Novel,582,274,0.99,308
498830,Mustache in Hell,58,7,0.99,51
457210,SEUM: Speedrunners from Hell,2576,139,14.99,2437
508730,Painted Legend,25,9,4.99,16
357670,Home Improvisation: Furniture Sandbox,154,67,9.99,87
448520,Deranged Rabbits,34,1,4.99,33
486510,TOKYO WARFARE,264,54,4.99,210
477180,Shard Games,32,56,7.99,-24
508180,Fly and Destroy,153,98,10.99,55
503100,Black Hat Cooperative,57,19,9.99,38
421870,Quatros Origins,20,7,4.99,13
502910,The Return Home Remastered,52,77,0.99,-25
498030,Barnyard Mahjong 3,69,43,1.99,26
504770,Slavistan,638,67,1.99,571
485920,Neon Warp,50,16,0.51,34
494120,RX squad,18,9,1.99,9
503410,Zombie Camp,18,8,0.0,10
478980,Mansions of Madness,788,65,0.0,723
434730,Half Dead,2526,711,1.99,1815
502400,Redactem,167,68,0.99,99
504980,Elves Adventure,42,121,1.99,-79
508840,Broken Armor,395,87,0.99,308
465780,New Retro Arcade: Neon,471,121,16.99,350
407780,Lethe - Episode One,291,42,14.99,249
485230,HALP!,73,29,0.0,44
384750,EVEREST VR™,160,153,9.99,7
510050,You Have 10 Seconds,1139,128,0.0,1011
452450,Rising Islands,65,44,9.99,21
416200,Door To Door,23,21,4.99,2
465540,Adventure World,28,32,4.99,-4
498240,Batman - The Telltale Series,10046,1994,14.99,8052
491720,Nary,36,8,1.99,28
509960,Pinga Ponga,26,31,0.99,-5
443810,This Is the Police,7761,1594,14.99,6167
327560,Near Death,820,79,7.99,741
437920,Tricky Towers,11031,1141,14.99,9890
384190,ABZU,20845,1589,19.99,19256
375680,Apartment 666,141,273,1.99,-132
448510,Overcooked,11537,1164,16.99,10373
461560,MANDAGON,5170,283,0.0,4887
454700,Shiny Gauntlet,8,13,0.99,-5
448670,Pinball HD Collection,52,32,19.99,20
493370,Ragnarok Clicker,812,310,0.0,502
508950,Beerman,32,21,1.99,11
507360,The Wizard's Lair,7,8,0.0,-1
509860,Baezult,49,16,0.0,33
489360,CASE: Animatronics,2558,434,9.99,2124
491240,Lil Big Invasion,24,1,0.59,23
492270,The Cat! Porfirio's Adventure,242,58,2.99,184
445310,Might and Magic: Heroes VII – Trial by Fire,770,420,29.99,350
509220,Save Jesus,1865,201,1.99,1664
502770,Voodoo Garden,549,170,2.99,379
508540,Haeven,20,8,0.99,12
506590,Sky Valley,51,27,1.99,24
390310,Little King's Story,215,130,14.99,85
270270,Frozen State,345,190,11.99,155
508170,BlackSmith HIT,363,105,0.99,258
425410,Road to Ballhalla,337,45,14.99,292
449530,Grand Pigeon's Duty,445,132,3.99,313
438790,Random Access Murder,38,124,0.99,-86
497180,Street Legal Racing: Redline v2.3.1,2720,420,5.99,2300
499420,Star Fields,55,67,1.99,-12
479140,Framed Wings,18,3,3.99,15
461760,Reptilian Rebellion,44,13,2.99,31
508990,Handsome Mr. Frog,180,18,0.99,162
511070,MANIC MINERS,7,7,1.99,0
510750,Driftwood The Visual Novel,36,35,0.0,1
461940,Plancon: Space Conflict,50,71,6.99,-21
364230,Lucius Demake,396,29,4.99,367
492630,Bear With Me - Episode One,799,112,0.0,687
269310,Infectonator: Survivors,624,298,9.99,326
495390,The Wire Loop Game VR,7,3,4.99,4
483680,PolyDome,44,6,0.0,38
498600,MSI Electric City,94,33,0.0,61
509110,Spikit,318,78,1.99,240
326840,Heart&Slash,424,101,3.89,323
499120,Dark Parables: The Red Riding Hood Sisters Collector's Edition,26,5,9.99,21
513340,Through Abandoned: The Forest,128,23,0.49,105
512080,Fancy Skiing VR,168,66,9.99,102
496300,Kingdom: New Lands,7886,1208,14.99,6678
495910,Dungeon Fighter Online,2987,1758,0.0,1229
373920,Eisenhorn: XENOS,151,137,0.0,14
499110,Dark Parables: Rise of the Snow Queen Collector's Edition,28,1,9.99,27
383930,Doorways: Holy Mountains of Flesh,350,78,6.79,272
421600,Ray Gigant,56,44,14.99,12
303720,#KILLALLZOMBIES,224,57,9.99,167
465180,One Day in London,78,8,9.99,70
485350,Winter Novel,428,88,4.99,340
438940,XBlaze Lost: Memories,25,8,19.99,17
438480,Rock 'N' Roll Defense,1634,268,0.49,1366
495780,Hexoscope,190,23,2.99,167
502090,Invisible Mind,61,95,0.54,-34
435440,Galaxy Control: 3D Strategy,255,195,0.0,60
474750,Reigns,6433,867,2.99,5566
501180,Acan's Call: Act 1,292,61,0.0,231
511160,Cubway,89,34,3.99,55
495110,Enigmatis 3: The Shadow of Karkhala,727,55,9.99,672
503300,Super Star,3208,900,0.0,2308
451400,Meridian: Squad 22,82,39,1.49,43
275850,No Man's Sky,181803,57094,29.99,124709
504880,Pixel Puzzles 2: RADical ROACH,65,22,4.99,43
485660,Karma Miwa,36,16,0.0,20
508600,ROD: Revolt Of Defense,435,112,0.99,323
486880,Abrix 2 Diamond version,55,145,0.0,-90
464620,Siralim 2,412,35,14.99,377
497850,8-Bit Hordes,393,93,14.99,300
485640,Genius Greedy Mouse,63,16,0.0,47
497820,Quanero VR,307,33,0.0,274
504490,The God's Chain,119,225,7.99,-106
513980,Oh No! Bugs!,86,20,1.99,66
494470,My Butler,43,39,9.99,4
503340,Dig 4 Destruction,103,11,11.99,92
458730,Conception II: Children of the Seven Stars,494,108,19.99,386
451010,Kittypocalypse,173,22,14.99,151
506140,Shop Heroes,2451,1192,0.0,1259
514470,Fantastic 4 In A Row 2,53,43,0.99,10
515570,UBERMOSH Vol.3,236,28,0.49,208
336240,Typoman,593,87,9.99,506
502150,Interstellar Logistics Inc,31,4,3.99,27
509390,GalaxIverse,20,9,0.99,11
372750,Girl Amazon Survival,103,129,2.99,-26
432980,INVERSUS Deluxe,283,32,14.99,251
426790,Grow Up,1379,132,9.99,1247
511320,Echoes of the Fey: The Fox's Trail,17,4,7.99,13
444880,Death Stair,200,93,3.99,107
468930,Phantaruk,129,78,4.99,51
485730,Shift,208,69,0.49,139
502210,Super Markup Man,79,15,3.99,64
452440,Flowers -Le volume sur printemps-,1330,53,19.99,1277
514220,Super GunWorld 2,8,5,7.99,3
455000,The Lost,38,27,0.0,11
513930,J.U.R : Japan Underground Racing,34,71,0.49,-37
270070,The Girl and the Robot,42,19,9.99,23
512640,Final Quest,68,98,1.99,-30
514650,Orbital X,37,5,2.99,32
366440,Savage Resurrection,816,622,0.0,194
351410,Clean'Em Up,53,4,0.0,49
513580,Miaou Moon,21,14,5.99,7
514490,Ultimate Word Search 2: Letter Boxed,32,51,0.99,-19
507390,Gone In November,232,136,0.99,96
455340,"Warhammer 40,000: Armageddon - Da Orks",53,27,19.99,26
400180,Okhlos: Omega,639,181,12.99,458
514480,Fantastic Checkers 2,37,61,0.99,-24
515910,Hooligan Vasja,107,61,0.59,46
436490,Firebird - La Peri,167,39,3.99,128
502240,You Deserve,186,72,0.99,114
443260,Hero Generations: ReGen,51,33,14.99,18
460340,Guards,392,66,4.99,326
514050,Uprising 2: Lead and Destroy,12,3,6.99,9
515020,The VR Museum of Fine Art,262,26,0.0,236
493400,Funfair,25,8,0.0,17
385240,Ultimate Arena,758,167,4.99,591
288220,Backstage Pass,228,29,29.99,199
418180,Tempest: Pirate Action RPG,1615,688,14.99,927
519170,The Journey Home,15,16,0.0,-1
469980,Legend of Miro,23,27,9.99,-4
396650,ACE Academy,1380,67,19.99,1313
516920,Veilia,7,6,2.99,1
373990,Metrico+,151,56,13.99,95
408960,Zombasite,143,43,19.99,100
337000,Deus Ex: Mankind Divided,27583,9318,29.99,18265
510660,Big Bang Empire,720,351,0.0,369
510780,SkyBoats,18,6,7.99,12
511330,Farm Life: Natures Adventure,19,19,0.99,0
493780,Nightork Adventures - Beyond the Moons of Shadalee,24,28,0.0,-4
291410,Duelyst,3945,838,0.0,3107
462930,AdVenture Communist,2908,1492,0.0,1416
327030,Worms W.M.D,7327,1400,5.99,5927
514970,Drive Megapolis,115,175,0.0,-60
511140,New York Mysteries: The Lantern of Souls,195,19,6.99,176
378610,Valley,5680,519,14.99,5161
306760,Obduction,2697,671,29.99,2026
512740,Flat Path,66,7,0.99,59
431600,Automobilista,1870,214,24.99,1656
512470,The Pirate: Caribbean Hunt,3193,728,0.0,2465
476460,Picross Touch,1179,74,0.0,1105
496250,Paddle Up,206,30,9.99,176
513420,VR Escape the space station,38,23,6.99,15
325730,The Hive,239,91,14.99,148
466920,Mugen Souls Z,67,16,19.99,51
503830,The Life Of Greather,61,46,1.99,15
222500,Rail Adventures - VR Tech Demo,19,20,0.0,-1
501500,Black Moon Chronicles,23,2,0.59,21
516940,MineSweeper VR,31,8,1.99,23
513880,Panzer Warfare,42,24,1.99,18
471920,Pan-Pan,185,23,19.99,162
427100,Fernbus Simulator,5593,2189,29.99,3404
496750,The Housewife,98,156,1.99,-58
448780,Sixtieth Kilometer,1157,345,0.56,812
230270,N++ (NPLUSPLUS),2479,151,14.99,2328
492610,One Day : The Sun Disappeared,10,21,0.99,-11
521210,Timore 5,78,20,8.99,58
521570,You Have 10 Seconds 2,594,64,0.0,530
521430,Super Switch,77,14,0.51,63
410990,Master of Orion 3,61,65,9.99,-4
512770,IACTURA,21,10,0.99,11
298050,Master of Orion,5168,1670,24.99,3498
515690,Warriors of Vilvatikta,66,75,1.99,-9
353990,Parvaneh: Legacy of the Light's Guardians,42,20,9.99,22
462100,Starr Mazer: DSP,191,51,9.99,140
470270,Tribal Pass,280,90,6.99,190
449800,Attack on Titan / A.O.T. Wings of Freedom,3104,542,59.99,2562
502410,Airport Fire Department - The Simulation,22,47,1.49,-25
504400,Optika,286,45,4.99,241
514160,18 Wheels of Steel: Across America,116,14,9.99,102
461360,Thorne - Son of Slaves (Ep.2),86,13,3.99,73
491620,Beeftacular,77,20,2.99,57
521470,Magical Otoge Ciel,207,18,0.0,189
517000,Sakura Shrine Girls,175,57,9.99,118
499910,SHINRAI - Broken Beyond Despair,98,8,14.99,90
520290,Fright Light,35,9,0.99,26
488330,Highway to the Moon,13,8,0.99,5
498700,The Ember Saga: A New Fire,9,8,6.99,1
467990,Versus: Battle of the Gladiator,310,183,0.0,127
510710,Bloxiq VR,3,1,1.49,2
445070,Tatsu,26,8,9.99,18
495700,Gabriel Knight: Sins of the Father®,100,16,5.99,84
453720,Last Will,217,63,8.99,154
502440,Plant Fire Department - The Simulation,18,22,2.99,-4
522570,The Last Hope,344,552,4.99,-208
517790,Caesar™ 3,1224,115,5.99,1109
494740,Police Quest™ Collection,78,25,9.99,53
511820,Le Havre: The Inland Port,27,21,6.99,6
500810,Arcanum: Of Steamworks and Magick Obscura,1123,160,5.99,963
497360,"Gabriel Knight® 3: Blood of the Sacred, Blood of the Damned",42,37,5.99,5
496760,The Beast Within: A Gabriel Knight® Mystery,166,17,5.99,149
438490,GOD EATER 2 Rage Burst,3145,886,49.99,2259
502750,Quest for Glory 1-5,307,15,9.99,292
517810,Caesar™ IV,385,172,9.99,213
496240,Onward,5800,2110,24.99,3690
501990,Phantasmagoria,292,46,6.49,246
448240,Hybrid Animals,229,170,6.99,59
383270,Hue,1674,105,2.99,1569
460560,Blamdown: Udder Fury,20,5,4.99,15
251230,Livelock,530,140,9.99,390
485260,Talent Not Included,34,6,12.99,28
324740,The Warlock of Firetop Mountain,474,144,19.99,330
337490,Four Sided Fantasy,299,66,9.99,233
499520,The Turing Test,6341,910,19.99,5431
491650,Reset 1-1,149,79,1.99,70
435530,The Final Station,5969,930,14.99,5039
374520,Champions of Anteria™,74,79,29.99,-5
440550,Atomik: RunGunJumpGun,252,34,7.99,218
506280,My Lil' Donut,34,5,0.0,29
434650,Lost Castle / 失落城堡,18722,2513,9.99,16209
386750,Cashtronauts,45,17,2.99,28
519140,Minds Eyes,1078,440,0.0,638
400450,NeuroVoider,500,144,13.99,356
396660,Tahira: Echoes of the Astral Empire,86,25,14.99,61
502420,Firefighters - The Simulation,34,51,4.49,-17
496390,Shiny,29,29,9.99,0
465840,THE LAST BLADE,109,45,9.99,64
475150,Titan Quest Anniversary Edition,25642,2561,19.99,23081
517320,GunGirl 2,113,12,0.0,101
424590,Farm Expert 2017,312,364,19.99,-52
513740,Joana's Life,48,134,1.99,-86
521200,Epic Battle Fantasy 3,1617,57,0.0,1560
493580,Hidden Object - 12 in 1 bundle,73,59,5.99,14
497580,Agent Walker: Secret Journey,145,69,9.99,76
425220,One Piece Burning Blood,2717,709,7.49,2008
511380,Pozzo Jello Crusade,23,1,2.99,22
513230,The Underground Man,1098,254,1.99,844
452340,Ian's Eyes,64,34,0.0,30
520820,Dawn's Light,38,5,0.0,33
366320,Seasons after Fall,2149,505,9.99,1644
502380,Tangled Up!,28,16,4.99,12
358130,Curious Expedition,3350,329,14.99,3021
482990,Heirs And Graces,65,6,19.99,59
515470,Hyper color ball,135,168,1.99,-33
525300,Starship Annihilator,74,45,0.51,29
508820,Won't You Be My Laser?,37,18,0.99,19
517710,Redout: Enhanced Edition,3615,625,19.99,2990
487180,The Lords of the Earth Flame,177,80,9.99,97
517930,The Castles of Dr. Creep,38,4,1.99,34
354400,Tadpole Treble,265,11,4.99,254
522990,Spell Casting: Meowgically Enhanced Edition,18,4,0.0,14
370670,The Tale of a Common Man,113,6,9.99,107
468570,De-Void,60,50,7.99,10
521000,Globe Rush,6,2,2.99,4
503680,The Seeker,10,6,2.99,4
504700,Blockships,25,1,6.99,24
516560,The Odyssey,14,6,4.99,8
517910,Sisyphus Reborn,840,63,0.0,777
513570,Wooden House,170,103,0.99,67
512300,Unbox: Newbie's Adventure,475,97,19.99,378
361300,Mother Russia Bleeds,3874,573,14.99,3301
518030,Aim Hero,5136,847,4.99,4289
503450,Space Rangers: Quest,45,41,9.99,4
518670,Intensive Exposure,149,24,4.99,125
429620,Dungeon Rushers,726,419,14.99,307
473540,Raise Your Own Clone,7,13,0.99,-6
516010,Board Defenders,17,1,4.99,16
521280,Atlantis: Pearls of the Deep,57,10,6.99,47
503950,Star Tactics Redux,40,8,0.0,32
499370,Tower of Archeos,39,4,12.99,35
378800,Police Tactics: Imperio,245,153,24.99,92
514730,Hidden Expedition: Dawn of Prosperity Collector's Edition,5,0,9.99,5
391040,F1 2016,3821,642,0.0,3179
483950,SMILE GAME BUILDER,220,31,69.99,189
415270,Star Crusade CCG,1517,359,0.0,1158
497420,Pixelscape: Oceans,36,9,0.99,27
525080,The Race for the White House 2016,14,14,14.99,0
497700,Safety First!,247,59,0.59,188
412830,STEINS;GATE,12401,326,29.99,12075
502940,"Calm Down, Stalin",846,99,3.99,747
508790,Flat Heroes,410,49,9.99,361
509930,NightmareZ,17,25,3.99,-8
504810,MXGP2 - The Official Motocross Videogame Compact,55,28,4.99,27
360170,How to Survive 2,7240,3156,14.99,4084
527810,Dynamite Alex,14,11,0.99,3
423580,Project Highrise,3177,592,19.99,2585
522040,Princess Remedy 2: In A Heap of Trouble,530,51,4.99,479
507380,Black Sand Drift,154,67,0.99,87
371200,Halcyon 6: Starbase Commander,1094,208,14.99,886
517470,King of Booze: Drinking Game,37,9,2.99,28
351030,Pixel Puzzles Ultimate Jigsaw,1652,554,0.0,1098
514180,18 Wheels of Steel: Haulin’,68,11,9.99,57
525450,King Oddball,73,5,4.99,68
431750,Iron Sea Defenders,208,48,4.99,160
444690,TRAPPED,135,245,4.99,-110
339580,Ember,666,205,9.99,461
300630,Pure Chess Grandmaster Edition,149,57,15.99,92
512550,Cursed West,47,23,0.99,24
324810,TOXIKK™,4155,1256,0.0,2899
503770,Elven Assassin,480,79,13.99,401
524030,Machine Learning: Episode I,35,17,0.99,18
517350,Squareface,58,16,4.99,42
526880,Chess Knight 2,63,71,2.99,-8
522490,Carrie's Order Up!,119,4,2.99,115
526790,Monsti,378,240,1.99,138
427190,DEAD RISING®,3608,468,19.99,3140
527340,What The Box?,591,154,4.99,437
509850,Bumper,76,26,0.49,50
453960,Envy the Dead,144,67,0.99,77
376310,Otherland MMO,277,407,0.0,-130
527800,War Cube,27,19,0.53,8
525190,The Construct,34,33,0.99,1
409000,Mystery Chronicle: One Way Heroics,226,136,9.99,90
508450,NASCAR Heat Evolution,163,141,9.99,22
513440,Path of War,99,81,0.0,18
341000,Mad Games Tycoon,3942,401,14.99,3541
502320,Boulder Dash - 30th Anniversary,79,19,14.99,60
496320,Running Gods,18,6,4.99,12
519030,Don't Let Go!,44,22,2.99,22
492710,VR Ping Pong,108,28,9.99,80
487250,Spaera,56,64,9.99,-8
441380,PAC-MAN™ CHAMPIONSHIP EDITION 2,1351,603,12.99,748
523760,Loot or Die,29,7,0.99,22
521130,Dots eXtreme,83,10,1.99,73
278100,"RIVE: Wreck, Hack, Die, Retry!",752,130,14.99,622
480450,Floppy Heroes,321,16,2.99,305
529670,The Bellows,197,34,0.0,163
527510,The Legions of Rome,16,33,2.99,-17
451840,Out of Ammo,590,122,9.99,468
486120,Escape The Past,38,20,4.99,18
470260,Event[0],1647,403,19.99,1244
489720,Conga Master,54,6,9.99,48
506550,RollerForce,20,8,4.99,12
528580,Found,118,17,0.0,101
527900,Grim Tales: The Bride Collector's Edition,18,9,9.99,9
460780,Avadon 3: The Warborn,98,10,19.99,88
423810,Marooners,428,228,9.99,200
522660,Snooker-online multiplayer snooker game!,46,73,0.0,-27
514890,Super Jagua,76,14,0.99,62
40980,Stronghold Legends: Steam Edition,1427,243,4.49,1184
530720,Solitaire Royale,24,17,0.0,7
510330,Shotgun Raiders,15,12,0.0,3
523060,Planet Smasher,9,3,3.99,6
364300,Space Rogue,287,156,9.99,131
465520,PRICE,4622,271,0.0,4351
409720,BioShock™ 2 Remastered,12850,5719,19.99,7131
522010,Lost Crew,39,6,1.99,33
409710,BioShock™ Remastered,34221,8389,19.99,25832
514090,Beautiful Japanese Scenery - Animated Jigsaws,182,25,0.99,157
521340,True or False,887,430,0.0,457
436500,Diaries of a Spaceport Janitor,586,223,9.99,363
527450,Cockroach Simulator,2067,508,0.99,1559
495350,Woodle Tree 2: Worlds,179,73,3.99,106
510630,Soccer Manager 2017,418,218,0.0,200
528660,Spin Rush,378,107,10.99,271
523090,Bomb U!,47,7,5.99,40
489170,Galaxy Reavers,130,59,4.99,71
393230,The Youthdrainers,9,40,0.0,-31
524660,RutonyChat,537,140,14.99,397
467010,Fall of Civilization,52,78,0.0,-26
464070,Diorama Battle of NINJA　虚拟3D世界 忍者之战,24,13,6.99,11
385760,NBA 2K17,4720,4114,0.0,606
530240,Pixel-Warfare: Pro,54,43,0.99,11
392410,Toy Odyssey: The Lost and Found,215,105,14.99,110
528510,Turbo Pug 3D,230,106,1.99,124
508740,Wheels of Aurelia,85,74,14.99,11
481110,The Bunker,901,372,4.41,529
333420,Cossacks 3,8502,2024,19.99,6478
425670,Seraph,431,102,12.99,329
438420,Zenith,393,169,7.99,224
530540,mr.President Prologue Episode,62,42,0.99,20
494230,Heart's Medicine - Time to Heal,767,50,12.99,717
462680,BalanCity,582,154,7.99,428
435490,Pierhead Arcade,239,28,4.99,211
496930,Sumeru,123,37,3.99,86
418670,Pankapu,258,75,11.99,183
513610,Madrobot X,101,15,2.99,86
421660,Harmonia,489,16,9.99,473
492500,Heroes of the Monkey Tavern,251,87,9.99,164
517360,The Secret Order 4: Beyond Time,128,67,9.99,61
488310,Eleven Table Tennis,2712,136,19.99,2576
420360,Spectrum,51,11,4.99,40
521630,Toadled,320,57,0.99,263
355400,Diesel Guns,209,83,7.99,126
533040,Dark Parables: The Thief and the Tinderbox Collector's Edition,12,2,9.99,10
406970,The Uncertain: Last Quiet Day,4094,1154,9.99,2940
469920,hackmud,511,150,19.99,361
533690,Think To Die,275,92,0.0,183
441250,Talewind,50,40,0.89,10
465490,Stellar Tactics,886,169,19.99,717
286240,Dog Sled Saga,570,51,7.99,519
496730,Sorcerer King: Rivals,222,133,19.99,89
504800,Sorcery! Part 4,63,12,9.99,51
374030,Virginia,1974,1056,9.99,918
483980,Mad Father,3459,99,9.99,3360
522690,In Fear I Trust,23,26,3.99,-3
476530,Children of a Dead Earth,550,56,19.99,494
527790,Cranium Conundrum,24,42,5.99,-18
526540,8infinity,235,104,0.51,131
523710,Sword Master VR,148,58,9.99,90
314330,DROD: Gunthro and the Epic Blunder,112,11,9.99,101
417150,Pavilion,85,37,9.99,48
518280,Dead End Junction,33,10,8.99,23
375230,"Warhammer 40,000: Eternal Crusade",6272,6328,0.0,-56
367010,Vernon's Legacy,64,47,11.99,17
497640,Trick & Treat,2037,76,0.0,1961
525600,Dyno Adventure,7,11,0.99,-4
515040,Make America Great Again: The Trump Presidency,1541,233,2.99,1308
530890,Haydee,4963,878,14.99,4085
513780,Turbo Pug DX,1348,381,1.99,967
531860,Where's My What?,52,61,0.99,-9
511740,Gal*Gun: Double Peace,1673,254,29.99,1419
524610,Ceggtcher VR,0,7,0.49,-7
392260,Rogue Wizards,185,54,14.99,131
434740,Lichtspeer,118,27,0.0,91
397950,Clustertruck,11119,826,14.99,10293
489560,Astroflux,194,79,0.0,115
509420,Riding Club Championships,453,149,0.0,304
498850,"Ortus Arena, strategy board game online, FOR FREE",25,15,0.0,10
506760,Twisty's Asylum Escapades,22,21,0.54,1
402710,Osiris: New Dawn,8027,5162,34.99,2865
523000,Princess Maker 2 Refine,1160,88,19.99,1072
531960,Bloody Walls,913,263,0.0,650
503160,Angels & Demigods - SciFi VR Visual Novel,57,41,0.0,16
527760,Just Hero,160,149,0.54,11
531890,Guardian's Oath,109,38,0.99,71
525610,Hardware Engineering,96,81,4.99,15
465870,SHOCK TROOPERS 2nd Squad,48,41,7.99,7
503460,Security Hole,131,10,9.99,121
409040,Herolike,32,22,7.99,10
527750,Merger 3D,80,110,0.65,-30
501860,Slayer Shock,55,37,19.99,18
467490,GRAVEN The Purple Moon Prophecy,39,4,7.99,35
520520,It Comes Around - A Kinetic Novel,14,19,2.99,-5
466270,Half-Life: A Place in the West,612,74,0.0,538
402750,Giant Machines 2017,341,133,2.99,208
488160,Galaxy Combat Wargames,11,10,0.0,1
422900,Particle Fleet: Emergence,925,74,14.99,851
532600,Sweet Candy Mahjong,35,31,2.99,4
400630,Wuppo: Definitive Edition,4440,247,14.99,4193
321270,UNLOVED,841,240,4.99,601
517130,Soundboxing,499,68,15.99,431
527160,Cmoar VR Cinema,124,80,9.99,44
534010,Defense of Egypt: Cleopatra Mission,94,39,6.99,55
476930,FourChords Guitar Karaoke,69,23,0.0,46
422610,1775: Rebellion,54,49,24.99,5
432230,"Axe, Bow & Staff",25,5,4.99,20
474960,Quantum Break,19226,3256,39.99,15970
509600,Battle Time,136,41,0.99,95
485450,Ninja Stealth,707,319,0.99,388
416790,The Metronomicon: Slay The Dance Floor,307,51,19.99,256
411540,Hybrid Wars,148,70,0.0,78
403290,Burly Men at Sea,273,150,9.99,123
533780,Zombie Defense,1601,323,0.0,1278
531190,HEBEREKE!: March! Red Army Girls' Brigade,174,26,0.0,148
533330,Shut Eye,61,50,4.99,11
534480,Tropical Girls VR,13,23,4.99,-10
393790,Rogue Operatives Hide and Seek,95,40,0.0,55
533850,EggK47,151,28,0.99,123
252850,Streamline,1449,591,0.0,858
382260,8Bit Fiesta - Party Game,497,43,0.0,454
535260,Save Home,19,16,9.99,3
352890,Caravan,652,179,0.65,473
497780,Recursed,382,8,7.99,374
460220,Xenoraid: The First Space War,106,13,9.99,93
459090,Masquerada: Songs and Shadows,438,47,19.99,391
490980,Daily Chthonicle: Editor's Edition,99,33,0.79,66
532030,DMT: Dream Dealer,108,99,3.99,9
526430,Project Fire,71,27,0.0,44
531920,Carton,43,19,0.49,24
518730,Zombo Buster Rising,397,31,1.99,366
536320,The Space Garden,19,27,1.99,-8
529780,Disturbed,1524,126,0.0,1398
496810,MegaTagmension Blanc + Neptune VS Zombies (Neptunia),1184,162,14.99,1022
314950,Spectre,12,30,4.99,-18
451980,The Body VR: Journey Inside a Cell,228,19,0.0,209
397750,Guided Meditation VR,89,22,14.99,67
514390,PooShooter: Toilet Invaders,63,24,0.0,39
524970,Helmet Heroes,474,428,0.0,46
528720,Shu,127,33,9.99,94
325930,Viking Squad,205,37,14.99,168
477140,SparkDimension,26,44,9.99,-18
221680,Rocksmith® 2014 Edition - Remastered,17926,1582,29.99,16344
533300,Zup!,7687,454,0.99,7233
402570,Atlas Reactor,4359,900,0.0,3459
280160,Aragami,9577,1015,19.99,8562
515740,Radical Heroes: Crimson City Crisis,16,8,2.99,8
512260,Avalon Legends Solitaire 2,44,6,9.99,38
525780,Doorways: Old Prototype,547,91,0.0,456
387090,Revolution : Virtual Playspace,17,17,19.99,0
495990,True Love ～Confide to the Maple～,1143,182,5.99,961
496550,Noob Squad,212,276,0.99,-64
525660,Moonlit Mayhem™,3,4,2.99,-1
453130,Powargrid,27,5,9.99,22
485650,Campaign Clicker,186,204,0.0,-18
474210,BUTCHER,876,136,9.99,740
472420,"Duke Grabowski, Mighty Swashbuckler",159,27,1.99,132
530920,Archimedes,158,39,1.99,119
452920,Laser Disco Defenders,40,6,9.99,34
513590,So Many Cubes,44,101,1.99,-57
409320,Syndrome,178,102,19.99,76
476650,The Silver Case,483,73,19.99,410
488960,Star Vikings Forever,70,10,9.99,60
508260,Treasure of a Blizzard,140,27,14.99,113
384080,Industry Manager: Future Technologies,174,124,24.99,50
485120,Frog Climbers,131,28,6.99,103
530520,Aegis,20,28,2.99,-8
535760,Unforgiving Trials: The Space Crusade,174,113,0.99,61
458770,WRC 6 FIA World Rally Championship,551,316,14.99,235
273890,Arctic Trucker Simulator,8,34,1.99,-26
496440,The Challenge,23,35,10.99,-12
510620,THOTH,352,65,4.99,287
513000,KUBOOM,1535,1288,0.0,247
483420,Adam Wolfe,864,67,5.99,797
477770,Ride 2,2259,350,29.99,1909
504380,Detective Hayseed - Hollywood,103,3,14.99,100
523160,Alice's Patchworks 2,193,50,4.99,143
508390,Scrap Garden - The Day Before,704,229,0.0,475
523150,Mahjong World Contest (麻将),143,18,0.49,125
506610,Five Nights at Freddy's: Sister Location,8389,810,7.99,7579
529500,ALONE? - VR,25,15,8.99,10
538590,Sleeping Valley,93,188,0.49,-95
521500,Sakura Space,228,64,9.99,164
461620,Predynastic Egypt,1474,133,9.99,1341
528070,Solitaire Beach Season,50,24,4.99,26
515650,Straimium Immortaly,134,12,6.99,122
509210,Clockwork,44,26,2.99,18
356400,Thumper,3235,281,5.99,2954
475630,Crush Online,308,202,0.0,106
507010,Mr.President!,2777,718,9.99,2059
514240,ALONE?,69,102,2.99,-33
439490,BLUE REVOLVER,377,5,14.99,372
539460,Puzzle Cube,54,14,0.99,40
496190,Senza Peso,278,19,0.0,259
535150,BUSTED!,59,19,4.99,40
397150,Stellar Overload,428,181,0.0,247
536040,Cards of Cthulhu,129,59,0.49,70
434050,Duke Nukem 3D: 20th Anniversary World Tour,3056,608,19.99,2448
475490,Major\Minor,428,125,0.0,303
504390,Along the Edge,309,28,12.99,281
503630,INVASION!,156,21,0.0,135
446540,Smash Up,133,90,6.99,43
539720,Razortron 2000,1181,199,0.49,982
446100,Mantis Burn Racing®,89,31,9.99,58
531540,Hidden Dimensions 3,56,14,0.0,42
392580,WARSHIFT,480,183,9.99,297
523810,Wonder Boy Returns,62,21,0.0,41
514660,BitMaster,130,61,2.99,69
437570,GoNNER,1039,199,9.99,840
542310,Escape the Game,1619,323,0.0,1296
471730,Rocket Ski Racing,16,7,2.99,9
541920,Help,49,54,3.99,-5
526490,Higurashi When They Cry Hou - Ch.4 Himatsubushi,373,12,2.99,361
510650,Eventide 2: The Sorcerers Mirror,201,62,9.99,139
540640,Tales of the Elements,13,6,6.99,7
529150,Lazerbait,462,15,0.0,447
464450,DoDonPachi Resurrection,737,33,29.99,704
530330,Blameless,3750,712,0.0,3038
460850,Allumette,546,33,0.0,513
418270,Draw Slasher,388,373,1.99,15
324800,Shadow Warrior 2,19137,2687,29.99,16450
542120,Win Big Or Die,26,6,0.0,20
536750,BoomTown! Deluxe,87,22,0.99,65
517140,POLYCRUSHER,13,9,4.99,4
531740,Rubek,73,25,2.99,48
497100,FootRock,66,27,0.99,39
536420,Shining Plume,36,23,3.99,13
528110,Tennis Elbow Manager,25,5,9.99,20
364200,Farabel,78,28,9.99,50
518620,Ballistick,66,153,1.99,-87
504130,Manual Samuel - Anniversary Edition,2131,454,1.99,1677
539380,Think To Die 2,85,23,0.0,62
540610,Delicious! Pretty Girls Mahjong Solitaire,1439,224,0.99,1215
457330,High Octane Drift,3237,2619,0.0,618
539750,Kombine,82,22,0.51,60
531910,Bad Sector HDD,51,4,0.99,47
541370,Clickdraw Clicker,130,285,0.99,-155
455120,Stay Close,952,572,8.99,380
443360,Red Comrades 2: For the Great Justice. Reloaded,228,43,4.99,185
536470,Magnetized,46,5,0.99,41
279070,9th Dawn II,130,24,5.99,106
540880,Rose of Winter,161,13,8.99,148
501480,Lost Socks: Naughty Brothers,45,5,9.99,40
542690,Mahsung Deluxe,30,38,0.99,-8
542820,DemonicGuestVR,14,5,0.99,9
511490,Malavision: The Beginning,29,17,4.99,12
384940,Magical Brickout,23,7,7.99,16
498470,Switch 'N' Shoot,115,4,3.99,111
434170,The Jackbox Party Pack 3,4643,135,24.99,4508
535460,"A Fear Of Heights, And Other Things",50,9,0.99,41
527210,Janken Cards,24,11,2.99,13
533820,Atonement 2: Ruptured by Despair,109,41,5.99,68
540020,Final Quest II,62,91,1.99,-29
351920,Crazy Machines 3,8187,445,9.99,7742
470740,Demolish & Build 2017,462,127,19.99,335
537700,Octave,106,37,2.99,69
525330,Galaxy of Trian Board Game,4,4,4.99,0
227940,Heroes & Generals,93513,46263,0.0,47250
459820,Crush Crush,19250,1997,0.0,17253
525740,Slashy Hero,31,2,6.99,29
518580,Accounting (Legacy),2282,157,0.0,2125
528300,Soulless: Ray Of Hope,229,76,4.99,153
539640,Racecar.io,183,137,0.0,46
435000,The Whisperer in Darkness,31,7,2.99,24
542650,On the front line,20,15,12.99,5
527770,Russian SuperHero Dead Ivan,111,126,0.54,-15
429480,Vision Runner,4,6,9.99,-2
429790,AdventureQuest 3D,5970,1489,0.0,4481
533340,Captivity,41,45,0.99,-4
460190,Rocket Riot,46,12,9.99,34
533890,ReBoot,13,7,1.99,6
489000,The Infinite Black,135,70,0.0,65
540060,Fabulous - Angela's Fashion Fever,97,22,12.99,75
447950,Bad Caterpillar,100,7,1.99,93
394700,Karma. Incarnation 1,294,56,4.99,238
440420,True Fear: Forsaken Souls Part 1,652,65,8.99,587
432100,Negligee,564,141,14.99,423
407560,Killing Room,897,387,9.99,510
488910,Astral Heroes,205,92,0.0,113
543650,Last Days,24,19,0.0,5
453780,Secrets of Magic: The Book of Spells,41,4,9.99,37
289070,Sid Meier’s Civilization® VI,186295,36439,59.99,149856
319760,Oh My Gore!,338,53,0.49,285
539670,Sakura Nova,327,49,14.99,278
452320,Party Saboteurs: After Party,32,16,9.99,16
532110,Rusty Lake: Roots,4875,191,2.99,4684
405760,Robot Squad Simulator 2017,96,57,14.99,39
534290,Cursed Castilla (Maldita Castilla EX),468,78,11.99,390
544520,The Puppet Master,33,8,0.0,25
504310,The Cooking Game,113,62,0.0,51
451660,Trucker,29,29,1.99,0
545470,Hover Hazard,32,23,0.49,9
493980,Green Ranch,27,10,5.99,17
467360,Off-Peak,1205,174,0.0,1031
544870,Blood Ties,37,24,3.99,13
529110,Awkward Dimensions Redux,2346,561,0.0,1785
542780,Drift GEAR Racing Free,72,138,0.0,-66
542340,Slingshot people,643,724,0.99,-81
527710,Crown Champion: Legends of the Arena,148,36,0.95,112
542710,Dessert Storm,39,54,0.99,-15
439800,Clouds & Sheep 2,110,19,9.99,91
529950,12 orbits,217,30,1.99,187
542720,Bubble Blowout,54,75,0.99,-21
516750,My Summer Car,40710,2705,14.99,38005
330100,BossConstructor,155,46,14.99,109
447020,Farming Simulator 17,19655,1381,14.99,18274
545800,Ghostdream,29,17,5.99,12
488300,Infinite Air with Mark McMorris,219,67,0.0,152
544140,Murder Mystery Adventure,21,54,4.99,-33
455700,Big Buck Hunter Arcade,41,32,9.99,9
418030,Subsistence,7588,2719,13.99,4869
547960,Space Beret,326,317,0.99,9
512250,Oh...Sir!! The Insult Simulator,3140,304,0.61,2836
491060,League of Evil,45,11,7.99,34
530390,Slayaway Camp,704,34,8.99,670
532290,Dark Train,121,43,9.99,78
458960,Winning Putt: Golf Online,375,203,0.0,172
477870,Yomawari: Night Alone,1323,338,19.99,985
519870,Flying Pengy,61,11,0.99,50
542880,Byte Family,39,8,3.99,31
531730,Corona Blossom Vol.2 The Truth From Beyond,159,4,9.99,155
529420,Crazy Sapper 3D,21,11,0.99,10
533960,Scary Humans,6,0,9.99,6
538550,Party Golf,47,8,14.99,39
523730,Sweet Volley High,56,23,9.99,33
490890,Ne no Kami: The Two Princess Knights of Kyoto,129,17,9.99,112
542730,Block Blowout,39,75,0.99,-36
534200,Ultimate Solid,25,8,1.79,17
486310,Meadow,5029,596,4.99,4433
375500,The Deep Paths: Labyrinth Of Andokost,70,51,5.99,19
543170,Project: R.E.B.O.O.T,36,28,0.51,8
532660,Exteria,13,16,1.99,-3
545910,Redemption Cemetery: Bitter Frost Collector's Edition,3,0,9.99,3
224740,Clockwork Empires,348,444,0.0,-96
550180,Fiber Twig: Midnight Puzzle,18,8,9.99,10
471330,VERSUS SQUAD,437,115,7.99,322
422590,Wacky Wheels HD,12,65,0.0,-53
513820,LUXIS,36,10,4.99,26
502100,Death's Life,34,22,2.99,12
453480,Shadowverse CCG,9900,3220,0.0,6680
397730,Rescue Love Revenge,33,33,4.99,0
547310,That's Mahjong!,94,46,0.99,48
467290,Starship Titanic,63,16,5.99,47
513320,ALICE VR,94,149,9.99,-55
547910,The Survey,525,195,4.99,330
505170,Carmageddon: Max Damage,2132,636,16.99,1496
456760,A dragon girl looks up at the endless sky,35,5,9.99,30
458920,Carnival Games® VR,138,190,19.99,-52
368430,Through the Woods,929,356,19.99,573
379870,Alteil: Horizons,48,54,0.0,-6
489830,The Elder Scrolls V: Skyrim Special Edition,198312,19722,39.99,178590
491950,Orwell: Keeping an Eye On You,12457,1200,9.99,11257
446560,Just Dance 2017,1525,415,49.99,1110
545570,PHAT PHROG,36,23,0.0,13
454650,DRAGON BALL XENOVERSE 2,30090,3933,49.99,26157
524110,Emergency 2017,263,135,0.0,128
542550,Plankton,59,30,1.99,29
457570,Camp Sunshine,244,22,6.99,222
540100,Imprisoned Light,133,71,0.99,62
545580,"GO AWAY, THERE'S KUMIS OVER THERE!",137,50,0.99,87
546660,Operation Breakout,35,51,8.99,-16
518800,Lone Leader,124,225,0.99,-101
508760,Ball of Wonder,36,20,4.99,16
529830,Game Character Hub: Portfolio Edition,77,39,24.99,38
531050,Far Beyond: A space odyssey VR,117,53,12.99,64
543980,Zombie Exodus: Safe Haven,138,23,4.99,115
542740,Balloon Blowout,57,72,0.99,-15
545030,NSFW ~ Not a Simulator For Working,87,8,2.99,79
429180,Project CARS - Pagani Edition,917,522,0.0,395
451960,The Secret of Pineview Forest,64,48,0.0,16
383790,The Ship: Remasted,382,284,9.99,98
450440,Creepy Castle,163,19,9.99,144
215550,Zombie Playground™,152,183,9.99,-31
550820,Kitten Cannon,29,7,0.0,22
547390,Mosaic: Game of Gods,70,6,2.99,64
465660,Franchise Hockey Manager 3,55,41,19.99,14
449450,SPLIT BULLET,55,5,0.79,50
420300,The Admin,10,24,1.99,-14
546490,Heart and Seoul,38,47,1.49,-9
528820,Eisenwald: Blood of November,81,76,2.69,5
115800,Owlboy,4444,791,24.99,3653
486890,Gear Gauntlet,3,2,6.99,1
547040,Above - VR,13,22,3.99,-9
546170,Gem Forge,43,5,0.99,38
283160,House of the Dying Sun,1424,156,19.99,1268
543030,Slap The Fly,178,66,5.39,112
417430,Moto Racer  4,640,395,2.99,245
551930,Skater 2D,42,29,0.51,13
458630,Political Animals,126,51,14.99,75
530120,VR The Diner Duo,389,17,14.99,372
527740,YANKAI'S TRIANGLE,51,10,5.99,41
541960,TRI.DEFENDER,8,2,0.99,6
547710,Darkness Ahead,31,17,0.49,14
523170,ShotForge,57,19,0.0,38
551320,Lord Darydikilkil,11,4,1.99,7
292730,Call of Duty®: Infinite Warfare,12328,10908,59.99,1420
537180,Digimon Masters Online,5442,2599,0.0,2843
539440,Citalis,109,105,1.99,4
493490,City Car Driving,13954,3162,24.99,10792
545940,Hunting Unlimited 2009,37,4,9.99,33
542930,Painted Memories,15,22,0.49,-7
537060,MagixHome™ VR,8,8,0.0,0
312560,Xanadu Next,386,31,14.99,355
549900,Leviathan Starblade,24,19,2.99,5
544420,VRCapture,47,81,0.0,-34
545920,Hunting Unlimited 4,12,5,9.99,7
461430,EmergeNYC,2269,1212,24.99,1057
487350,Pirate Pop Plus,89,52,4.99,37
544600,Delicious - Emily's Christmas Carol,140,17,12.99,123
459410,Sector 724,6,3,6.99,3
431810,Rencounter,221,89,5.99,132
513510,Intralism,4293,618,2.99,3675
531930,Dungeon Rats,412,122,4.99,290
551330,Sea of Lies: Mutiny of the Heart Collector's Edition,2,0,9.99,2
403980,World Ship Simulator,52,194,19.99,-142
386970,Memory's Dogma CODE:01,271,67,14.99,204
505750,Trimmer Tycoon,457,234,0.0,223
551080,Rescue your chickens,82,34,0.99,48
551110,Wayout,861,107,0.56,754
299250,European Ship Simulator,281,379,19.99,-98
548080,Space Merchants: Arena,16,7,6.99,9
534270,Solitaire 220 Plus,6,2,9.99,4
363930,Dead Age,4127,898,1.49,3229
543160,SuperMoose,19,15,1.99,4
521980,Autumn Dream,84,99,4.99,-15
544440,Next Stop 2,30,6,6.99,24
545690,VOI,662,46,0.99,616
538920,Fiery Disaster,19,24,1.99,-5
451780,Trillion: God of Destruction,297,143,9.99,154
549860,One Night Stand,546,67,2.99,479
552100,Brick Rigs,24873,1958,14.99,22915
545960,Wild Animals - Animated Jigsaws,125,18,9.99,107
547470,Apokalypsis,15,21,1.99,-6
532090,Dawn's Light 2,13,2,0.0,11
390040,Small Radios Big Televisions,243,97,11.99,146
237870,Planet Explorers,4173,2445,0.0,1728
543360,Relaxation balls,52,51,0.99,1
544590,Death Dojo,57,27,0.0,30
532270,Lethal VR,148,38,14.99,110
446800,Transport Fever,8468,1700,29.99,6768
444200,World of Tanks Blitz,92679,22566,0.0,70113
432370,Sethian,64,19,4.99,45
542240,TZOMPANTLI,16,12,9.99,4
537200,Defense Of Greece TD,42,25,2.09,17
415200,Motorsport Manager,10633,968,19.99,9665
390540,High Fidelity,66,48,0.0,18
523880,peakvox Escape Virus HD,3,2,4.99,1
475550,Beholder,19823,1825,9.99,17998
553790,Once in Yaissor,901,151,0.99,750
511960,Gravity Shot,2,1,6.99,1
491530,Notruf 112 | Emergency Call 112,2536,878,14.99,1658
362960,Tyranny,9541,1462,29.99,8079
514310,SENRAN KAGURA Bon Appétit! - Full Course,793,58,19.99,735
536490,Perfect Fit - Totemland,28,11,3.99,17
549670,The Thing: Tower Defense,25,20,4.99,5
465280,Yesterday Origins,473,96,14.99,377
507490,Ashes of the Singularity: Escalation,3183,1004,29.99,2179
536780,Lost Grimoires: Stolen Kingdom,176,31,9.99,145
551100,Oblivion's Edge,9,3,1.99,6
520910,Kokurase Episode 1,116,10,0.0,106
518120,Chimpact 1 - Chuck's Adventure,148,53,5.99,95
551680,Bad birthday,14,17,0.0,-3
420060,Candle,732,197,0.99,535
500940,Get The Gems,28,5,2.99,23
403640,Dishonored 2,43312,6020,29.99,37292
551500,Star Fight,16,15,3.99,1
533950,Don't open the doors!,237,43,10.99,194
532700,Finque,13,6,13.99,7
546340,"Dynamic Very, Very, Hard game!!",50,69,0.49,-19
545050,Badiya: Desert Survival,165,153,19.99,12
522090,Medieval Defenders,78,132,4.99,-54
517010,Aztecalypse,26,29,0.99,-3
528670,Elems,11,7,0.99,4
548710,Sandstorm,10,12,5.99,-2
452230,Spellstone,254,144,0.0,110
541380,PhysDrive,55,61,0.98,-6
377980,Mortos,41,43,0.99,-2
551690,Counter Fight,168,37,7.99,131
390330,Mekazoo,49,14,9.99,35
533860,Multimirror,55,75,4.99,-20
550810,Abduction Bit,136,13,0.99,123
541190,Nodiatis,46,29,0.0,17
546790,Comit the Astrodian,24,7,0.99,17
454540,LuckCatchers,438,365,0.0,73
555610,Gunmetal Arcadia Zero,86,31,5.99,55
466940,The Sandbox Evolution - Craft a 2D Pixel Universe!,593,719,0.0,-126
542260,The Herbalist,559,35,5.99,524
494100,ENIGMA:,105,3,7.49,102
416040,CLASH,93,141,0.0,-48
350380,The Martian VR Experience,12,37,4.99,-25
369830,Toonstruck,182,7,9.99,175
395620,Ittle Dew 2+,284,44,14.99,240
314790,Silence,1720,319,1.99,1401
361040,Doom & Destiny Advanced,333,28,0.99,305
254300,Dofus,411,143,0.0,268
512460,Nature And Life - Drunk On Nectar,171,18,11.24,153
422920,Creeper World 2: Anniversary Edition,285,26,4.99,259
429350,Satellite Rush,45,10,4.99,35
399820,Kopanito All-Stars Soccer,2169,405,5.99,1764
464350,Screeps: World,1429,159,14.99,1270
348250,Google Earth VR,3126,138,0.0,2988
555660,Red Forest,83,133,4.99,-50
511500,Nanuleu,49,11,2.99,38
422910,Creeper World: Anniversary Edition,576,18,4.99,558
265470,Even the Ocean,187,29,14.99,158
496400,Renoir,55,60,9.99,-5
282560,RollerCoaster Tycoon World™,1359,4157,14.99,-2798
551520,Last Days of Spring 2,43,13,6.99,30
534360,Colt Express,53,47,0.0,6
555060,Final Soccer VR,88,23,4.99,65
550390,Kingdom of Aurelia: Mystery of the Poisoned Dagger,56,26,6.99,30
553640,ICEY,20095,1997,10.99,18098
540510,ISLANDS: Non-Places,281,61,4.99,220
546990,Town of Night,63,67,1.99,-4
504210,SHENZHEN I/O,3217,162,14.99,3055
554310,Rage Wars,1403,168,0.99,1235
544480,Draft Day Sports: Pro Basketball 2017,11,16,4.99,-5
359140,Kick Ass Commandos,390,24,4.99,366
502200,Orczz,14,9,2.99,5
493340,Planet Coaster,50047,4792,11.24,45255
553820,DeathMetal,32,12,2.99,20
552410,Project Abyss,38,26,4.99,12
528770,Twixel,18,1,1.99,17
522340,Ghostlords,56,2,4.99,54
485360,Disgraced,68,13,9.99,55
554640,拯救大魔王2 Rescue the Great Demon 2,340,113,0.0,227
511470,Glass Masquerade,5375,157,4.99,5218
556280,Neon Prism,213,111,10.99,102
490870,Weird Hero,115,47,3.99,68
546390,Brief Karate Foolish,2458,145,0.0,2313
232090,Killing Floor 2,96342,13718,29.99,82624
538060,Doodle God: 8-bit Mania - Collector's Item,94,76,19.99,18
558870,Club Naughty,44,91,24.99,-47
364910,Redemption: Saints And Sinners,126,125,0.99,1
438300,Shepherds of the Abyss,12,10,5.99,2
520530,INTERSHELTER,694,346,0.0,348
518660,Zone4,356,248,0.0,108
556240,Disoriented,285,55,2.99,230
524850,Alicemare,757,98,2.99,659
542520,Lost in the Rift - Reborn,35,7,4.99,28
557190,BuildMoreCubes,23,12,1.99,11
557680,Germ Wars,113,97,1.99,16
557630,Hello Charlotte EP2: Requiem Aeternam Deo,819,20,0.0,799
431200,Disastr_Blastr,41,5,1.99,36
517330,Stellar Interface,154,27,12.99,127
460630,Trouble Witches Origin - Episode1 Daughters of Amalgam -,160,12,9.99,148
555570,Infestation: The New Z,17523,15496,0.0,2027
364820,Star Trek: Starfleet Command Gold Edition,93,61,9.99,32
546980,Midnight Carnival,101,183,1.99,-82
555930,Madness,41,36,2.99,5
553590,Hot Squat,128,12,0.0,116
555630,A Magical High School Girl / 魔法の女子高生,133,44,9.99,89
436530,Bullshot,223,68,0.99,155
555640,Japanese School Life,221,50,9.99,171
558660,it's always monday,227,54,1.99,173
527470,Donuts'n'Justice,113,26,1.24,87
546650,Beat Boxer,15,7,8.99,8
517190,Rebound,6,1,1.99,5
555750,Masked Forces,293,149,0.99,144
546180,Starry Nights : Helix,16,11,3.99,5
466740,ARAYA,582,187,14.99,395
547900,Front Office Football Eight,208,42,29.99,166
519990,Zenza,2,17,3.99,-15
556770,Star Phoenix,9,16,9.99,-7
544710,Delicious - Emily's New Beginning,70,4,12.99,66
548050,Runes,27,3,0.99,24
527990,Gladiator Trainer,163,66,1.99,97
535840,Marblize,11,2,11.99,9
528640,Rugby Union Team Manager 2017,56,46,39.99,10
544290,Tyto Online,11,1,0.0,10
559010,Cosmic Sugar VR,339,19,0.0,320
447040,Watch_Dogs® 2,47889,9752,49.99,38137
512790,Quern - Undying Thoughts,2589,222,24.99,2367
555180,InfinitasDM,26,22,9.99,4
469710,Shattered Throne,33,8,9.99,25
528550,Drunkn Bar Fight,644,233,13.99,411
548290,Dark Eden,124,132,0.0,-8
562690,Immersion,15,33,9.99,-18
556160,PHAT STACKS,84,99,1.99,-15
556870,Charlie's Adventure,203,118,10.99,85
556190,Seven Seas Solitaire,25,7,9.99,18
553780,ARK BOX Unlimited,18,5,4.99,13
462780,Darksiders Warmastered Edition,10524,1591,19.99,8933
562600,Our Wonderful World,17,9,1.99,8
557780,Atom Fishing II,1103,368,0.0,735
307940,Radiation Island,405,111,9.99,294
384030,Florensia,403,217,0.0,186
547590,Pinball FX2 VR,287,47,14.99,240
532800,ComPet - Epic Beast Battles,43,31,0.0,12
414190,Junk Jack,341,96,14.99,245
402560,Tabletopia,928,558,0.0,370
513370,Blade & Bones,58,122,10.99,-64
563200,Slay,118,17,9.99,101
468100,Aqua Moto Racing Utopia,71,30,12.99,41
546230,Xenus 2. White gold.,165,65,14.99,100
486540,Townsmen,165,56,0.0,109
514150,Line of Sight: Vietnam,47,17,9.99,30
403970,The Dwarves,1318,472,39.99,846
548340,Abode,332,26,9.99,306
556130,"Drones, The Human Condition",107,128,5.99,-21
391600,King Lucas,97,43,4.99,54
353580,Rad Rodgers: World One,143,25,0.0,118
423870,Astervoid 2000,37,10,4.99,27
500690,Secret Santa,63,7,0.0,56
544800,Driftwatch VR,7,13,2.99,-6
284240,Maize,1464,363,19.99,1101
449730,Ahnayro: The Dream World,216,28,4.99,188
536990,Redie,159,36,0.0,123
562270,Shot Shot Tactic,206,249,3.99,-43
527420,Demon Hunter 3: Revelation,193,25,9.99,168
549090,Counter Agents,133,15,0.0,118
550420,Stargazer Christmas,22,4,0.0,18
254590,Theme Park Studio,200,271,29.99,-71
460920,Steep™,18566,3860,29.99,14706
557750,Giants: Citizen Kabuto,117,6,9.99,111
383230,Dungeon Souls,1633,563,12.99,1070
552160,Hade,238,27,3.99,211
407880,Mad Nords: Probably an Epic Quest,106,7,1.19,99
513620,SkyTime,121,74,0.99,47
561340,Merlin adventurer store,106,20,2.99,86
550450,Sparkle Unleashed,54,18,7.99,36
529700,Total Extreme Wrestling 2013,67,6,19.99,61
497080,Construct: Escape the System,87,31,7.99,56
523900,Fated Souls 2,14,4,11.99,10
555710,Zolg,133,41,0.99,92
376480,Ohr: אור,17,14,5.99,3
563400,Ludu,52,15,0.0,37
540840,Lara Croft GO,2759,225,9.99,2534
446000,Stellar Monarch,171,44,19.99,127
545150,Beastiarium,60,58,14.99,2
545860,Luke Sidewalker,72,53,0.0,19
370060,Coffee Shop Tycoon,401,64,7.99,337
511350,Mr. Massagy,190,8,5.99,182
562220,Zup! 2,5941,272,0.99,5669
518920,Surgeon Simulator: Experience Reality,356,397,19.99,-41
547090,Halloween Mysteries,13,9,4.99,4
418240,Shadow Tactics: Blades of the Shogun,30558,1192,39.99,29366
488950,Werewolves Within™,91,50,19.99,41
471660,Kingspray Graffiti VR,628,109,14.99,519
342180,Arizona Sunshine®,6342,1584,29.99,4758
535700,3D Chess,71,47,4.99,24
528250,Patchwork,156,53,6.99,103
366240,GAROU: MARK OF THE WOLVES,697,39,9.99,658
513560,Hunger Dungeon,1657,641,0.0,1016
513450,Drop Alive,1279,154,0.0,1125
552130,Whiplash - Crash Valley,105,122,4.99,-17
530350,Smashbox Arena,409,35,19.99,374
565860,Tomato Way,393,105,1.99,288
533180,Campfire: One of Us Is the Killer,23,35,0.49,-12
544650,Sacred Almanac Traces of Greed,46,18,4.99,28
529020,Virtual-O,86,11,39.99,75
553000,Escape Artist: The Trial,8,16,0.99,-8
529590,"Please, Don't Touch Anything 3D",664,111,9.99,553
552780,Dexodonex,59,16,0.99,43
494600,EARTH'S DAWN,164,57,14.99,107
488770,Her Majesty's SPIFFING,218,53,11.99,165
388900,Fracture the Flag,85,27,4.99,58
554140,Desert Ride Coaster,31,20,0.0,11
480650,Yu-Gi-Oh! Legacy of the Duelist,3594,651,19.99,2943
497020,Mystic Diary - Hidden Object,20,22,4.99,-2
495570,ConflictCraft,420,82,4.99,338
566150,Bowling at the Lake,11,9,0.0,2
470300,Winged Sakura: Demon Civil War,65,19,9.99,46
562520,Attempt[42],77,71,0.99,6
557410,Dream Quest,236,25,9.99,211
550310,Root Of Evil: The Tailor,413,73,6.99,340
546080,Coffin of Ashes,625,45,6.99,580
496120,LaserCat,74,4,0.99,70
482450,Nitroplus Blasterz: Heroines Infinite Duel,660,70,19.99,590
529130,Expect The Unexpected,53,27,1.49,26
528120,Darkness and Flame: Born of Fire,106,10,6.99,96
493700,Monster Puzzle,92,68,4.99,24
462620,Pocket Kingdom,134,9,6.99,125
552280,Tayutama 2-you're the only one-,2151,98,34.99,2053
555850,Galactic Landing,19,13,1.99,6
531660,Exoplanet: First Contact,215,58,19.99,157
541640,Disney Infinity 1.0: Gold Edition,229,33,29.99,196
557770,Pawn,14,6,6.99,8
348670,Immune - True Survival,850,604,0.0,246
541660,Disney Infinity 2.0: Gold Edition,233,26,29.99,207
552580,Jade's Journey,24,19,3.99,5
563750,World Boxing Manager,74,50,4.99,24
541670,Disney Infinity 3.0: Gold Edition,690,106,29.99,584
491670,Stratego - Single Player,33,9,6.99,24
540780,Delicious - Emily's Message in a Bottle,109,5,12.99,104
384180,Prominence Poker,5032,868,0.0,4164
391280,Epic Manager - Create Your Own Adventuring Agency!,156,70,17.99,86
545400,Natural - Beyond Nature -,19,5,5.99,14
562450,Salvage Op,6,15,0.99,-9
510550,Congo Merc,11,17,4.99,-6
411960,TY the Tasmanian Tiger,2221,40,14.99,2181
423890,Gods and Idols,511,211,0.0,300
546700,The Butterfly Sign,123,69,4.99,54
568570,Force of Nature,2932,914,7.99,2018
534320,4Team,10,10,0.99,0
423590,The Little Acre,674,88,12.99,586
567280,Cube Runner,807,138,10.99,669
412290,The Dreamlord,62,103,1.99,-41
492090,A-Train PC Classic,84,20,59.99,64
350600,BIOS,115,68,2.99,47
562360,"Planes, Bullets and Vodka",1167,211,0.49,956
548090,Alone in the Dark 1,254,21,14.99,233
544990,NOBUNAGA'S AMBITION,8,1,12.99,7
567860,Passage 4,19,1,8.99,18
555080,Isyium,4,5,0.99,-1
567980,Santa Rockstar,80,23,9.99,57
548900,Alone in the Dark 3,58,19,14.99,39
356460,Drive!Drive!Drive!,36,16,9.99,20
541570,Sally Face - Episode One,11739,367,2.99,11372
520440,GUILTY GEAR Xrd -REVELATOR-,6948,495,29.99,6453
465440,Aplowcalypse,38,10,0.0,28
324520,Defense Zone 3 Ultra HD,311,75,9.99,236
562470,Empire of Angels IV,247,133,14.99,114
298900,Space Hulk: Deathwing,3028,2607,0.0,421
476480,Heaven Forest - VR MMO,321,150,0.99,171
559450,Demented Pixie,7,4,4.99,3
528740,Operation: New Earth,333,244,0.0,89
463160,Super Dungeon Tactics,111,31,9.99,80
535890,Stereo Aereo,28,5,3.99,23
566550,Rule Your School,35,45,2.99,-10
493320,Killing Time,49,13,9.99,36
547340,LoveKami -Divinity Stage-,451,98,12.99,353
565110,Mobile Astro,114,41,0.0,73
564530,Pharaoh + Cleopatra,1660,172,9.99,1488
523190,Weapons of Mythology - New Age -,32,50,0.0,-18
561000,Delicious - Emily's Home Sweet Home,75,5,12.99,70
563490,Earth Liberation,22,16,6.99,6
251450,Heroes of Havoc: Idle Adventures,90,135,0.0,-45
560350,Police Quest: SWAT,24,20,5.99,4
463860,Shadows of Kurgansk,135,77,5.99,58
464500,The Melody of Grisaia,69,3,8.99,66
496450,J.A.C.K.,131,15,14.99,116
486780,Fruit Ninja VR,632,162,14.99,470
570490,SHENZHEN SOLITAIRE,155,5,2.99,150
557790,Goblet of Maya,15,1,1.99,14
558850,Children of Colossus,19,9,4.99,10
559640,Betrayal Collection,68,12,5.99,56
522890,Ant-gravity: Tiny's Adventure,13,4,1.99,9
532770,Time Leap Paradise SUPER LIVE!,186,50,0.0,136
566050,Zeus + Poseidon,1145,50,9.99,1095
504000,Endless Fables: The Minotaur's Curse,218,22,9.99,196
552200,peakvox Mew Mew Chamber for Steam,38,1,2.99,37
562660,Pandarama: The Lost Toys,39,8,0.99,31
551720,Unearthed Inc: The Lost Temple,25,9,0.0,16
557810,Clicker Guild,334,283,0.0,51
546550,Snowball!,130,19,2.99,111
528950,Nekuia,15,3,9.99,12
569380,Alicia Griffith – Lakeside Murder,63,23,9.99,40
560260,Super Blue Boy Planet,2363,243,0.0,2120
518040,Volleyball Unbound - Pro Beach Volleyball,141,12,14.99,129
417910,Street Warriors Online,966,709,1.99,257
540740,Perfect,29,32,9.99,-3
554800,Masky,110,28,0.99,82
529160,Moekuri: Adorable + Tactical SRPG,331,53,11.99,278
543140,Legend of Merchant,512,107,1.79,405
561230,Special Delivery,14,9,9.99,5
552300,Soldier Sortie :VR Agent 006,7,6,19.99,1
535000,EXIT,32,1,4.99,31
531680,8-Bit Invaders!,318,69,14.99,249
562570,Access Denied,245,58,2.99,187
357500,Rumble Fighter: Unleashed,179,165,0.0,14
565200,Gem Monster,20,7,2.99,13
567290,Slash It,989,136,10.99,853
485430,NAL Is Alive,10,8,9.99,2
568690,Smash Party VR,42,4,0.0,38
530620,Resident Evil 7 Teaser: Beginning Hour,3753,492,0.0,3261
568500,Atomic Reconstruction,29,6,1.99,23
570890,Fallen,37,22,1.99,15
567210,Bunnyrama,48,10,2.99,38
565720,Pretty Girls Panic!,323,68,1.99,255
571020,Santa's Big Adventures,56,25,0.51,31
550010,Happy Room,2117,250,4.99,1867
534870,Arcane,15,4,0.0,11
537110,Angels of Death,3594,235,9.99,3359
525680,Deisim,500,42,14.99,458
500340,QUACK ATTACK 1985: TURBO DX EDITION,22,7,0.99,15
253840,Shantae: Half-Genie Hero,2050,215,19.99,1835
570500,Child Phobia: Nightcoming Fears,39,13,1.99,26
569610,Distant Space,249,67,0.49,182
408250,Eagle Flight,216,140,19.99,76
536220,The Walking Dead: A New Frontier,10135,2464,14.99,7671
572000,President Erect VR,87,25,0.0,62
545820,Wanderland,186,126,0.0,60
534910,3D Arcade Fishing,27,16,4.99,11
570350,Sorry. (Entschuldigung) ~ A Psychological Horror Visual Novel,22,17,2.99,5
512700,Duckles: the Jigsaw Witch,7,16,4.99,-9
500320,A Tale of Caos: Overture,38,16,9.99,22
567800,12 Labours of Hercules VI: Race for Olympus (Platinum Edition),187,22,2.99,165
568860,Psycho on the loose,18,11,0.99,7
547210,Sullen,8,0,2.99,8
451990,Cranks and Goggles,131,39,1.99,92
542280,Happy Maze,64,21,4.99,43
565030,Blueshift,155,38,0.0,117
537140,Nemesis Perspective,99,13,0.0,86
542350,Castle of no Escape 2,270,82,4.99,188
407840,Guardians of Orion (Phase 2),1984,1664,0.99,320
527190,WORLD END ECONOMiCA episode.03,199,12,12.99,187
557570,Able Black,28,0,0.99,28
557040,99Vidas,414,103,12.99,311
545590,Button Tales,72,5,0.99,67
512110,Cosmos Crash VR,28,4,3.99,24
537990,Heroine Anthem Zero -Sacrifice-,409,220,9.99,189
558100,Art of War: Red Tides,5241,1405,0.0,3836
561080,The Price of Freedom,360,27,1.99,333
556720,Off-Road Super Racing,36,44,0.0,-8
546200,Gnomes Garden 3: The thief of castles,90,10,4.99,80
543430,Brain Booster,22,9,0.99,13
539090,Clazer,23,8,29.99,15
528730,Crypt of the Serpent King,127,35,1.99,92
507340,Strike Squadron: Caracará,8,3,2.99,5
566560,Fighters Unleashed,34,39,3.99,-5
529900,Polygon Attack,202,30,0.99,172
544180,Orbox C,174,5,2.99,169
395550,Operation Hardcore,22,3,4.99,19
568090,Tattletail,2620,207,4.99,2413
546610,Acro Storm,11,20,4.99,-9
574030,Score a goal (Physical football),131,82,9.99,49
567580,Duke of Alpha Centauri,329,89,10.99,240
574580,To The Capital,42,22,1.99,20
571870,Little Jack's Adventures,37,24,0.51,13
533660,Ziggy's Chase,6,7,1.99,-1
512560,HoCWar,70,52,0.0,18
571520,Kalaban,37,31,4.99,6
555320,Never give up!,105,31,2.99,74
560710,Leap Up no jutsu,82,29,0.99,53
573210,Mistwood Heroes,28,22,3.99,6
490910,Control Craft 3,102,40,4.99,62
575490,Let's Draw,327,298,1.99,29
444490,POLYWAR,357,146,1.99,211
555210,Trick and Treat - Visual Novel,3154,371,0.0,2783
550400,Delicious - Emily's Hopes and Fears,61,4,12.99,57
562240,The Spirit Underneath,35,70,0.99,-35
461730,Blaite,353,138,0.49,215
540900,Nuclear Contingency,133,127,0.99,6
550440,Azkend 2: The World Beneath,15,14,7.99,1
568130,Gum Guy,16,7,3.99,9
557880,Say Goodbye,104,82,0.0,22
470220,UNO,29975,10806,9.99,19169
575400,Try Hard Parking,68,12,1.99,56
555670,Infinitum,66,50,4.99,16
565550,Redneck Rampage,100,32,9.99,68
544970,Milkmaid of the Milky Way,407,21,5.99,386
568670,Heroes of Dark Dungeon,9,3,2.99,6
547820,Kitten Squad,89,66,0.0,23
557030,Avenger Bird,61,24,3.99,37
568320,Pictopix,873,28,6.99,845
574640,Unalive,127,55,1.99,72
576800,Final Bravely,25,4,3.99,21
526740,hack_me,1285,835,3.99,450
576030,MHRD,316,37,9.99,279
569360,Pivot Pilot,34,3,4.99,31
555410,Hearts of Chaos,13,10,4.99,3
576730,Spirit of Maya,32,15,1.99,17
573520,Crowtel Renovations,55,3,4.99,52
568830,Witch of Ice Kingdom Ⅱ,50,7,3.99,43
494580,STANDBY,159,55,2.99,104
533170,Don't Chat With Strangers,67,76,4.99,-9
497560,Crimson Sword Saga: The Peloran Wars,12,7,0.0,5
437390,HoPiKo,142,46,6.99,96
524940,Javva Juice,10,4,0.99,6
548720,Through the Mirror,41,9,3.99,32
531520,TankCraft,9,9,0.99,0
560000,Ladykiller in a Bind,170,8,19.99,162
572740,Nancy Drew®: The Secret of Shadow Ranch,79,12,9.99,67
521230,Stone Age Wars,134,64,1.99,70
545700,The Land of Dasthir,38,58,1.99,-20
559960,Power Hover,254,23,3.99,231
576770,Low Magic Age,2370,235,14.99,2135
576540,Brother Wings,44,23,0.99,21
559870,PAKO - Car Chase Simulator,110,43,2.99,67
455710,Project RPG Remastered,76,104,0.99,-28
550670,"What The Heck, Dude?",127,177,0.99,-50
386770,Caladrius Blaze,253,54,3.99,199
493710,Laraan,122,129,4.99,-7
409850,Criminal Girls: Invite Only,418,111,19.99,307
559310,Illyriad - Grand Strategy MMO,90,49,0.0,41
444170,Unhack 2,70,4,5.99,66
575550,Hell Girls,3460,474,0.0,2986
556180,Mysterium: A Psychic Clue Game,536,126,6.99,410
575640,Zup! 3,4645,514,0.99,4131
555220,Detention,10776,2623,11.99,8153
552570,The New Queen,9,8,4.99,1
577740,Winexy,93,55,0.49,38
314590,room13,58,16,7.99,42
460210,Bearslayer,15,0,9.99,15
541230,Alien Shooter TD,586,96,9.99,490
567890,Zero-G,17,5,0.99,12
512490,Zombie Estate 2,498,13,4.99,485
568440,Not Dying Today,182,45,9.99,137
576280,Arena Hero,44,11,9.99,33
347290,Rise & Shine,583,262,14.99,321
573770,RED,277,13,0.0,264
566880,Henry The Hamster Handler VR,30,3,0.99,27
557260,iREC,126,132,0.49,-6
552390,Druid,162,50,1.99,112
464850,Don Bradman Cricket 17,159,102,49.99,57
405340,Siegecraft Commander,30,17,19.99,13
498500,I Am The Hero,444,95,9.99,349
514990,Outbreak,72,44,9.99,28
578670,Conquest: Frontier Wars,7,0,5.99,7
470780,She Remembered Caterpillars,417,19,11.99,398
567680,The Pasture,82,103,0.99,-21
411120,Galaxy Admirals,181,40,1.99,141
388960,Torn Tales,31,20,10.99,11
505290,Super Rock Blasters!,3,0,2.99,3
295670,Hive Jump,256,106,19.99,150
581650,Once Upon an All Hallow's Eve,113,29,0.0,84
581820,Judas,80,29,2.99,51
550580,Sticker Craft,75,19,0.99,56
490370,Imperium Galactica II,373,56,9.99,317
536410,Greenwood the Last Ritual,35,22,2.99,13
579150,Riot of the numbers,33,18,0.99,15
404070,Lords of New York,26,21,0.0,5
461390,Bulby - Diamond Course,22,21,2.99,1
439530,Rock-N-Rogue: A Boo Bunny Plague Adventure,8,12,1.99,-4
573790,Imperium Galactica,94,7,4.99,87
502370,"Warhammer 40,000: Sanctus Reach",1051,177,29.99,874
575750,Magic Box,37,29,0.51,8
539450,Crab Dub,189,73,2.99,116
464880,Stars in Shadow,549,141,24.99,408
581030,The Last Hope: Trump vs Mafia - North Korea,199,186,4.99,13
521920,Death's Hangover,400,49,4.99,351
576050,Other Worlds India,55,38,0.99,17
566670,Save the Ninja Clan,95,8,0.99,87
554150,Frequent Flyer,62,9,0.99,53
580420,Tourists Kidnapped a Little Bear,62,21,0.51,41
552350,Unhappy Ever After,16,10,0.99,6
542290,Da Capo 3 R,71,4,39.99,67
352550,Urban Empire,809,1587,29.99,-778
377150,Tactical Genius Online,162,72,0.0,90
461370,Midnight's Blessing 2,6,7,4.99,-1
402220,Lift It,60,53,4.99,7
572170,DeadTruth: The Dark Path Ahead,7,9,0.0,-2
579230,Alpacapaca Dash,163,16,0.99,147
575700,Fruit Arranger,162,98,0.99,64
557830,My Pet Rock,24,8,2.99,16
448290,Nefarious,330,59,14.99,271
540690,Hellenica,33,15,9.99,18
576840,RAYGUN COMMANDO VR,81,15,0.0,66
418370,Resident Evil 7 Biohazard,58270,3235,9.99,55035
458170,SpiritSphere DX,39,7,9.99,32
555450,Deus Ex: Breach™,131,161,0.0,-30
583760,Slash It 2,1037,123,10.99,914
575920,Felix Jumpman,23,38,0.99,-15
562410,Panty Party,860,77,4.99,783
532840,CAYNE,1205,292,0.0,913
430410,Memoranda,107,37,14.99,70
346460,Vector 36,196,44,19.99,152
514620,Ellipsis,215,12,4.99,203
583150,KART CHASER : THE BOOST VR,25,9,9.99,16
584760,Rayless,4,4,1.99,0
562480,Corona Blossom Vol.3 Journey to the Stars,119,5,9.99,114
576590,Puzzle Wishes,11,13,3.99,-2
454950,Mainlining,242,67,12.99,175
584780,Operation swat,18,21,0.49,-3
505120,Valentino Rossi The Game Compact,31,9,4.99,22
514080,Deadly Dozen,30,12,9.99,18
547680,Guild Quest,1152,556,0.0,596
572580,Incredible Dracula II: The Last Call Collector's Edition,31,8,8.99,23
470210,Rocketbirds 2 Evolution,266,87,9.99,179
565660,Akihabara - Feel the Rhythm,46,25,4.99,21
523210,A Normal Lost Phone,1845,231,2.99,1614
429660,Tales of Berseria™,14020,1170,7.49,12850
445430,Seinarukana -The Spirit of Eternity Sword 2-,26,3,29.99,23
514340,Aliens Go Home Run,63,6,3.99,57
575510,Sakura Agent,389,145,9.99,244
581760,True or False 2,124,16,0.0,108
559610,Love Ribbon,1603,120,9.99,1483
539650,TwelveSky 2 Classic,131,61,0.0,70
577490,Minos Strategos,34,3,7.99,31
505060,Warcube,283,29,9.99,254
575760,Project: R.E.B.O.O.T 2,29,28,2.99,1
477730,Eador. Imperium,902,268,19.99,634
586310,Gunman Taco Truck,165,40,2.99,125
586350,UBERMOSH:WRAITH,190,27,0.49,163
528430,Wells,77,23,3.99,54
575110,Magic Lantern,24,3,0.0,21
585830,Ninja Stealth 2,277,145,0.99,132
469790,Linelight,785,17,9.99,768
495280,Disgaea 2 PC,1187,107,19.99,1080
528610,Double Dragon IV,421,281,6.99,140
554600,Learn Japanese To Survive! Katakana War,382,31,6.99,351
566750,Crimson Trigger,19,2,9.99,17
341890,HitBox,78,52,0.0,26
575680,Square n Fair,39,6,0.99,33
528450,Hunt: The Unknown Quarry,29,13,0.0,16
481600,Finding Hope,33,15,2.99,18
586790,Hold your houses,12,31,0.99,-19
509980,BIGFOOT,10427,2570,19.99,7857
574690,Mr. Triangle's Adventure,17,10,0.99,7
577700,THE VIDEOKID,80,5,3.99,75
585770,Prism Collider,11,2,0.0,9
585560,Finnish Roller,41,67,0.49,-26
513480,Geo,138,22,8.99,116
496820,Ruction: The Golden Tablet,4,5,7.99,-1
577580,Gladiator: Sword of Vengeance,32,14,7.99,18
571880,Angels with Scaly Wings / 鱗羽の天使,1451,39,9.99,1412
562840,Dragon Blood,52,61,0.0,-9
436520,Line of Sight,5334,3700,0.0,1634
576160,A Long Road Home,32,1,1.99,31
526920,SQUAKE,98,48,0.0,50
557400,Midas Gold Plus,1475,224,0.0,1251
581590,Retro Pinball,19,9,4.99,10
438100,VRChat,124156,32375,0.0,91781
572700,Nancy Drew®: Sea of Darkness,102,9,19.99,93
549260,Alwa's Awakening,482,114,9.99,368
560740,Shtriga: Summer Camp,78,31,3.99,47
560730,The Esoterica: Hollow Earth,55,58,3.99,-3
428690,Youtubers Life,9734,3093,24.99,6641
486020,Hero,6,10,0.99,-4
514140,Elite Warriors: Vietnam,18,13,9.99,5
560820,The Saint: Abyss of Despair,57,24,3.99,33
575580,Queen of Seas,87,25,0.99,62
564150,Rosenkreuzstilette,271,67,9.99,204
446790,Diluvion: Resubmerged,651,383,19.99,268
576470,ANIMALITY,542,164,1.99,378
560750,World Keepers: Last Resort,84,31,3.99,53
560760,Sacra Terra: Kiss of Death Collector’s Edition,58,58,9.99,0
567780,Satellite Repairman,28,20,0.99,8
560720,Dark Angels: Masquerade of Shadows,171,36,3.99,135
553960,Husk,272,354,3.99,-82
562490,EvilMorph,72,13,2.99,59
582500,We Were Here,18030,1624,0.0,16406
549760,Evolution VR,95,23,0.0,72
576810,2 Ninjas 1 Cup,188,51,0.99,137
437250,A House of Many Doors,312,59,10.99,253
547930,Precursors,45,30,14.99,15
562090,Kronos,12,7,4.99,5
573780,Xenon Valkyrie,81,38,9.99,43
586690,Dead Reckoning: Silvermoon Isle Collector's Edition,6,0,9.99,6
588290,Goalie Challenge VR,100,8,0.0,92
536930,MOBIUS FINAL FANTASY™,3173,1182,0.0,1991
578440,冒险村传说（Tales of Legends）,30,48,1.99,-18
510840,Evolvation,632,281,9.99,351
564710,Soda Dungeon,5311,313,0.0,4998
568580,GunFleet,122,83,0.0,39
454410,GIGA WRECKER,464,110,4.99,354
570980,Tale of Fallen Dragons,420,56,9.99,364
577990,Ignition,147,19,9.99,128
431650,Phoning Home,632,282,9.99,350
555920,Dark Egypt,31,57,4.99,-26
560170,STAR WARS™ SHADOWS OF THE EMPIRE™,405,138,5.99,267
527280,Nights of Azure,427,185,29.99,242
563150,interLOGIC,35,10,1.99,25
332270,Gunmetal Arcadia,35,11,9.99,24
527270,Atelier Sophie: The Alchemist of the Mysterious Book,1583,233,0.0,1350
446840,Splasher,842,61,14.99,781
510510,WWE 2K17,1097,608,0.0,489
567130,Boogeyman 2,237,54,4.99,183
381890,Induction,113,13,8.99,100
589860,SoulSet,118,10,8.49,108
585990,Echoes of the Fey Episode 0: The Immolation,49,10,0.0,39
396350,Bleed 2,728,29,9.99,699
466160,Arelite Core,21,2,19.99,19
580630,Dimensional Rift,33,1,0.0,32
584800,Civil War: Battle of Petersburg,122,31,0.99,91
562540,Cabals: Card Blitz,52,45,0.0,7
585840,Leaving Lyndow,776,193,3.99,583
585690,Minimalism,1026,399,0.49,627
375750,Invisigun Reloaded,428,61,19.99,367
489260,Brut@l,82,32,14.99,50
558790,Queen's Quest 2: Stories of Forgotten Past,187,21,9.99,166
385130,"DvDrum, Ultimate Drum Simulator!",82,15,4.99,67
372080,Ananias Roguelike,38,9,4.99,29
564940,Alone With You,58,13,9.99,45
244030,Take On Mars,1049,856,26.99,193
414330,We Are Chicago,11,17,14.99,-6
589380,VRog,13,6,3.99,7
382360,John Wick Chronicles,170,93,0.0,77
579820,Robinson: The Journey,222,195,19.99,27
586340,Lamm,46,6,0.99,40
490690,The Barbarian and the Subterranean Caves,42,14,4.99,28
540860,Dragon Kingdom War,41,34,4.99,7
587290,The Thing With Mistletoes,53,27,0.0,26
578830,Cavern of Time,45,24,3.99,21
581970,Zombie Ballz,71,29,1.99,42
571330,Idioctopus,8,0,6.99,8
576980,Western 1849 Reloaded,139,29,3.99,110
416020,Heavy Gear Assault,83,159,0.0,-76
485830,Star Merc,29,19,1.99,10
588180,Totemori,266,40,0.0,226
585950,Wayout 2: Hex,267,39,0.56,228
525070,Captain Lycop : Invasion of the Heters,15,6,0.99,9
575780,Inner silence,65,42,0.99,23
585340,SYMMETRY alpha,35,2,0.0,33
563810,Fumiko!,70,14,6.99,56
304390,FOR HONOR™,80877,37476,14.99,43401
586430,Spheroids,16,4,7.99,12
572710,Nancy Drew®: Labyrinth of Lies,44,12,19.99,32
577160,Skyling: Garden Defense,8,2,0.99,6
362150,Ashes of Immortality II - Bad Blood,13,13,4.99,0
572020,Darwin's Demons,34,4,0.0,30
576260,Winds Of Trade,101,60,11.99,41
428860,Red Haze,139,22,3.99,117
312660,Sniper Elite 4,38308,3980,59.99,34328
502700,Laser Lasso BALL,26,2,1.99,24
410840,Rock God Tycoon,208,77,10.99,131
574710,Dark Shores,4,5,5.99,-1
529760,TAIKU MANSION,103,241,0.99,-138
548480,NightZ,44,85,0.99,-41
528180,Agricola: All Creatures Big and Small,40,60,6.99,-20
588970,Oik,1374,155,0.74,1219
581370,Drizzlepath: Glass,96,59,2.99,37
520720,Dear Esther: Landmark Edition,3326,1133,9.99,2193
505730,Holy Potatoes! We’re in Space?!,584,285,0.99,299
586960,Upside Down,488,102,10.99,386
445720,Battle Islands: Commanders,396,446,0.0,-50
542200,Animal Lover,130,17,9.99,113
587810,Bang Bang Fruit,63,79,0.99,-16
390100,9Dragons,280,131,0.0,149
524580,Fairy Fencer F Advent Dark Force,1903,336,19.99,1567
563520,When Our Journey Ends - A Visual Novel,32,11,6.99,21
450170,BOOR,175,35,0.99,140
561450,Mutant Fighting Cup 2,34,9,5.99,25
589160,Zombie Apocalypse,44,21,0.0,23
579040,DEFCON VR,6,11,0.0,-5
581600,The Albatross,52,43,0.99,9
586240,Soul Searching,226,26,9.99,200
435400,Hidden Folks,7814,268,12.99,7546
572520,Dropzone,598,263,0.0,335
521800,Command Ops 2 Core Game,241,53,0.0,188
582620,Copoka,177,54,4.99,123
489110,Putty Pals,88,3,9.99,85
497730,The Wardrobe - Even Better Edition,304,64,14.99,240
573060,LOGistICAL,174,40,9.99,134
586060,JET HERO,33,20,3.99,13
590280,Canvas The Gallery,269,24,0.0,245
575840,NeverEnd,56,58,1.99,-2
461170,Bucket Detective,210,34,3.99,176
518790,theHunter: Call of the Wild™,98235,14454,19.99,83781
553260,Realpolitiks,671,404,14.99,267
570090,articy:draft 3,75,9,99.99,66
595440,CPU Invaders,537,102,0.49,435
596470,Cartesian,36,1,0.0,35
583040,Princess Maker Refine,203,107,9.99,96
496690,Adventures On The Polluted Islands,89,34,2.99,55
571740,Golf It!,17211,2030,8.99,15181
574310,The Mooseman,858,102,6.99,756
576420,The Curse Of Yendor,65,3,4.99,62
460250,🔴 Circles,83,8,2.99,75
576660,Snake Party,13,26,0.99,-13
567340,The Deal,51,7,5.99,44
455690,Pixel Puzzles Junior Jigsaw,116,16,4.99,100
531270,The Art of Fight | 4vs4 Fast-Paced FPS,234,114,0.0,120
496960,Shoot Mania VR: Fun Zombies,13,9,2.99,4
587930,Under a Desert Sun,29,9,7.99,20
596590,Linked,221,16,0.99,205
591420,Zup! 4,2440,264,0.99,2176
546400,Cavern Escape Extremely Hard game!!!,145,243,0.49,-98
516580,DYSTORIA,48,3,19.99,45
539290,Brick Breaker,35,42,9.99,-7
585550,FEMINAZI: The Triggering,983,232,1.99,751
539300,Solitaire,43,57,9.99,-14
463480,A Shooty Bit,22,6,1.99,16
359420,The Journeyman Project 1: Pegasus Prime,41,1,9.99,40
539270,Mahjong,214,50,9.99,164
539280,Tetraminos,51,22,9.99,29
589640,Spoids,53,22,0.9,31
580680,CYBER JOLT (VR),9,9,0.99,0
342640,Pixel Privateers,621,259,14.99,362
485980,Syrian Warfare,3383,533,13.99,2850
502280,BERSERK and the Band of the Hawk,1945,475,59.99,1470
585750,Chowdertwo,7,2,2.99,5
481510,Night in the Woods,12999,896,19.99,12103
586980,MadOut2 BigCityOnline [CLOSED],3076,942,0.0,2134
595640,Robo Do It,20,11,0.99,9
521700,NOBUNAGA'S AMBITION: Sengoku Gunyuuden,1,4,19.99,-3
380810,Herald: An Interactive Period Drama - Book I & II,124,11,9.99,113
595320,Polterheist,83,149,0.54,-66
461280,Missileman Origins,11,2,1.99,9
359840,Shift Happens,1594,334,1.49,1260
545410,A Trip to Yugoslavia: Director's Cut,199,67,0.99,132
506870,Unexplored,574,78,9.99,496
585180,Open Sorcery,305,4,3.99,301
372330,Beauty Bounce,74,34,3.99,40
396280,Anarchy Online,165,37,0.0,128
588050,"You, With Me - A Kinetic Novel",9,18,2.99,-9
596870,Drop Hunt - Adventure Puzzle,235,39,0.49,196
581520,Sakura Magical Girls,187,70,9.99,117
573040,School of Talent: SUZU-ROUTE,97,12,8.99,85
568490,Frog Hop,21,0,4.99,21
513550,Vive le Roi,48,32,4.99,16
506510,Shadows of Adam,193,20,14.99,173
503400,Four Last Things,731,34,2.71,697
332650,The Exiled,224,239,0.0,-15
503550,DYE,58,19,4.99,39
598240,Stupid Raft Battle Simulator,18,21,5.99,-3
598070,Nevrosa: Prelude,181,25,0.0,156
554330,Choppa,87,29,0.99,58
538840,City Climber,225,75,6.99,150
415090,KByte,27,2,2.99,25
476020,Reflection of Mine,169,36,7.99,133
562160,The Inner Darkness,64,23,4.99,41
408030,UniBall,153,18,0.0,135
503560,911 Operator,12486,1526,14.99,10960
578310,BRAIN / OUT,12401,2701,0.0,9700
489600,The Golf Club VR,344,157,9.99,187
590870,Planetoid,16,23,0.99,-7
520860,Impulse of War,294,155,0.0,139
367520,Hollow Knight,232778,6892,14.99,225886
597810,Shining Plume 2,27,9,3.99,18
592260,Dungeon Painter Studio,2102,284,14.99,1818
595460,Flix and Chill,191,34,0.99,157
272270,Torment: Tides of Numenera,2737,1182,34.99,1555
509130,RC-AirSim - RC Model Airplane Flight Simulator,25,8,6.99,17
422810,River City Ransom: Underground,1731,565,19.99,1166
558420,Stories Untold,3702,540,9.99,3162
431120,Tethered,167,33,18.99,134
555160,Pavlov VR,31064,1808,24.99,29256
581100,Langoth,29,34,0.74,-5
600310,Rogue'n Roll,25,9,4.99,16
551450,Furious Angels,322,47,4.99,275
539660,ChronoClock,111,9,29.99,102
391640,Stage Presence,23,15,9.99,8
576310,Oracle,121,116,0.99,5
525150,Space Fuss,76,19,4.99,57
490250,Locomancer,50,10,0.0,40
390030,DESYNC,383,95,14.99,288
577690,Spooky's Jump Scare Mansion: HD Renovation,1557,77,6.69,1480
601180,Doug and Lily,24,7,0.99,17
562460,Radium 2,27,1,4.99,26
553760,Einlanzer,115,8,3.99,107
496080,"Space, VR!",2,2,1.99,0
534920,Relaxing VR Games: Mahjong,9,11,2.99,-2
600530,Kautic - The Bald Wizard,27,5,0.99,22
600140,Belko VR: An Escape Room Experiment,552,89,0.0,463
562010,Tanki Online,3238,1837,0.0,1401
512020,Box Maze,85,42,0.99,43
592750,SPACE-FRIGHT,25,3,0.0,22
584220,RunningDead,78,17,1.99,61
596400,Azada: Elementa Collector's Edition,6,0,9.99,6
595550,Mastema: Out of Hell,73,43,4.99,30
571350,DED,490,108,0.0,382
494720,Morphblade,473,43,4.99,430
596650,Tap Adventure: Time Travel,549,358,0.0,191
466240,Deceit,65235,17395,0.0,47840
575830,rooMaze,102,71,0.0,31
577460,Zoop! - Hunter's Grimm,154,113,1.99,41
460930,Tom Clancy's Ghost Recon® Wildlands,53673,14411,49.99,39262
583490,InfiniPicross,122,48,1.99,74
357190,ULTIMATE MARVEL VS. CAPCOM 3,3679,368,24.99,3311
503240,Hurricane,93,66,0.99,27
572720,Nancy Drew®: The Shattered Medallion,26,25,19.99,1
332310,LEGO® Worlds,11121,3160,29.99,7961
415880,Disc Jam,1192,364,14.99,828
594720,Star Merchant,51,33,0.99,18
600410,HERO-E,26,9,0.0,17
601640,The guard of dungeon,74,65,6.99,9
443880,Loot Rascals,135,58,9.99,77
569800,LEAVES - The Journey,380,93,0.69,287
527290,Atelier Firis: The Alchemist and the Mysterious Journey / フィリスのアトリエ ～不思議な旅の錬金術士～,514,104,0.0,410
603800,ReThink,193,48,9.99,145
397060,Faeria,5649,1097,19.99,4552
471400,Space Jammers,10,6,14.99,4
588190,Tower!3D Pro,532,269,24.99,263
585620,GameMaker Studio 2 Mobile,85,27,0.0,58
577910,Ghost Blade HD,40,5,9.99,35
364630,AirMech Command,126,57,9.99,69
603090,Dream Stone,25,22,0.49,3
586970,Hungry Flame,168,71,10.99,97
605850,Pinball Inside: A VR Arcade Game,47,14,0.0,33
585600,GameMaker Studio 2 Web,20,6,0.0,14
328070,Reflex Arena,1301,236,9.99,1065
604830,All Alone: VR,43,19,0.51,24
585410,GameMaker Studio 2 Desktop,1745,420,0.0,1325
601570,Fix Me Fix You,38,5,6.99,33
450950,Danmaku Unlimited 3,156,21,9.99,135
538070,Bad Dream: Coma,1612,143,8.99,1469
574270,Lost Grimoires 2: Shard of Mystery,118,32,9.99,86
577390,MAKE IT as an Artist,87,22,0.0,65
598610,Avalon Legends Solitaire,16,9,8.99,7
603190,Tank Destroyer,236,67,0.99,169
589760,Revhead,417,65,19.99,352
589200,Dreadhalls,286,16,9.99,270
596620,Gas Guzzlers: Combat Carnage,70,10,4.99,60
593200,The Adventures of Fei Duanmu 端木斐异闻录,1550,151,3.99,1399
603880,Sounds of Her Love,625,58,0.0,567
389220,Maximum Override,194,98,6.99,96
446610,Bunny Bounce,39,36,9.99,3
518720,Overkill VR: Action Shooter FPS,194,68,3.99,126
604980,Travel Riddles: Trip To India,18,2,9.99,16
602790,Fated Souls 3,19,12,4.99,7
447210,Blink,69,6,6.99,63
569970,Chosen 2,147,84,4.99,63
568780,Multishop Tycoon Deluxe,22,9,6.99,13
493480,ERISLE,10,11,0.0,-1
603750,- Arcane Raise -,69,107,2.99,-38
433900,Helium,57,45,0.99,12
600330,CONTRACTED,13,6,1.99,7
604450,Another Adventure,3935,376,1.99,3559
435100,2Dark,397,123,24.99,274
603810,A Girls Fabric Face,142,26,2.99,116
603220,ROTii,13,3,0.0,10
602890,hack_me 2,523,227,3.99,296
471810,Death Squared,414,44,14.99,370
584170,Freedom Locomotion VR,182,25,0.0,157
509070,Super VR Trainer,18,6,4.99,12
597970,Age of Rivals,187,28,8.99,159
543460,Dead Rising 4,3250,2613,29.99,637
355790,Styx: Shards of Darkness,3438,715,19.99,2723
415300,Monster Monpiece,268,97,9.99,171
594550,Arma: Cold War Assault Mac/Linux,104,20,4.99,84
606860,Nephise,283,114,0.99,169
604000,Like Clay,82,14,0.99,68
604780,aMAZE,549,113,0.51,436
355280,Brave Furries,73,15,0.0,58
360970,Heaven Forest NIGHTS,198,99,0.99,99
569810,LEAVES - The Return,213,30,0.69,183
562640,Introvert Quest,74,28,0.5,46
581230,Soul Saber 2,140,96,9.99,44
539340,Future Unfolding,77,12,19.99,65
536560,CHAOS CODE -NEW SIGN OF CATASTROPHE-,164,23,19.99,141
587860,Tales of Escape,1127,564,0.0,563
595060,Lionheart: Legacy of the Crusader,75,15,9.99,60
564750,Dimension Jump,33,24,0.0,9
509560,Heroes of Dire,135,60,0.0,75
584860,Surfasaurus,9,0,0.99,9
601930,Trianguluv,36,5,1.99,31
589170,Panzer Panic VR,9,15,9.99,-6
317370,The Keep,102,38,14.99,64
530070,Train Sim World® 2020,5383,1556,39.99,3827
368000,100ft Robot Golf,114,45,9.99,69
578850,64.0,1263,125,2.99,1138
569210,Yozora Rhapsody,12,6,6.99,6
585290,Lifeline,89,47,0.0,42
486690,Pastelia Stories,520,276,9.99,244
555260,The Butterfly Sign: Human Error,39,37,4.99,2
594160,The Last Patient,17,26,1.99,-9
592120,Glyphs Apprentice,10,4,0.99,6
515260,Virtual Rides 3 - Funfair Simulator,517,81,24.99,436
562330,Dwarflings,35,15,1.19,20
405830,Turok 2: Seeds of Evil,1769,149,19.99,1620
500790,Moribund,18,1,9.99,17
464100,Codex of Victory,252,107,14.99,145
583270,Cosmic Express,311,19,9.99,292
596910,Life of a Wizard,54,10,2.99,44
470020,"SnarfQuest Tales, Episode 1: The Beginning",3,3,4.99,0
575630,Permute,27,25,1.99,2
498320,Trolley Gold,65,169,1.99,-104
575940,The Tenth Line,98,16,7.99,82
608000,Buzz Aldrin: Cycling Pathways to Mars,106,10,0.0,96
606690,Ecchi Sketch: Draw Cute Girls Every Day!,57,10,9.99,47
365160,Kona,2318,478,14.99,1840
502800,SENRAN KAGURA ESTIVAL VERSUS,4513,243,29.99,4270
425460,Tokyo Twilight Ghost Hunters Daybreak: Special Gigs,45,28,9.99,17
546070,Flower Design,72,34,1.99,38
578590,City Siege: Faction Island,52,23,0.49,29
459640,You... and who else?,19,11,4.99,8
598230,Ascender,7,1,8.99,6
524220,NieR:Automata™,91816,16451,39.99,75365
607680,Popap,17,7,0.99,10
583010,VoiceAttack,757,33,11.99,724
599750,Crisis in the Kremlin,1033,195,4.99,838
607260,McOsu,4504,494,0.0,4010
581340,Narborion Saga,10,11,2.99,-1
455020,Jackpot Poker by PokerStars,184,175,0.0,9
597090,Comit the Astrodian 2,5,1,0.99,4
514290,Factory Engineer,59,68,9.99,-9
449510,The Crow's Eye,126,38,9.99,88
601010,Hotel Anatolia,198,88,0.99,110
564070,Troll and I™,14,24,0.0,-10
521730,Romance of the Three Kingdoms IV with Power Up Kit,16,12,19.99,4
551730,Toukiden 2,1037,269,59.99,768
602120,Molemen Must Die!,51,2,1.99,49
463670,Runeyana,23,25,0.0,-2
607860,Kira,18,9,0.0,9
514460,Cyberline Racing,67,44,0.99,23
600600,MakeThatMoney,19,18,5.99,1
599900,Tower Defense - Fantasy Legends Tower Game,22,20,4.99,2
604140,Broccoli Bob,42,17,4.99,25
572630,LyraVR,21,3,14.99,18
580010,Mystery Case Files: The Black Veil Collector's Edition,22,6,9.99,16
447820,Day of Infamy,18043,3757,14.99,14286
538810,Train Mechanic Simulator 2017,468,231,7.99,237
564470,Battle for Orion 2,54,13,14.99,41
496620,Monster Slayers,885,220,8.99,665
457380,Storm VR,72,27,0.0,45
522230,The Fishing Club 3D: Multiplayer Sport Angling,323,114,0.0,209
491280,Drift Horizon Online,266,282,0.49,-16
591560,Red Death,88,18,0.99,70
580710,Afghanistan '11,245,92,29.99,153
593330,Algotica Iterations,91,80,6.99,11
507300,Club Manager 2017,33,22,0.0,11
465650,Out of the Park Baseball 18,621,55,0.0,566
575670,Five Elements,25,7,4.99,18
578900,Demonheart,548,35,19.99,513
606330,Shadows 2: Perfidia,186,54,9.99,132
588690,"Peace, Death!",1795,105,4.99,1690
404590,Vikings - Wolves of Midgard,2451,1657,29.99,794
576020,Final Theosis,7,11,4.99,-4
588240,Frisky Business,181,38,4.99,143
589420,Grass Cutter - Mutated Lawns,264,33,0.0,231
603260,The Cat Games,803,90,1.99,713
487040,88 Heroes,56,10,14.99,46
461340,A Timely Intervention,27,5,5.99,22
365360,Battle Brothers,14931,2000,29.99,12931
477740,Zero Escape: The Nonary Games,3614,204,29.99,3410
563270,In Vitra - JRPG Adventure,34,17,4.99,17
595930,Steam: Rails to Riches,77,20,8.99,57
591380,Bomb Squad Academy,371,61,4.99,310
599460,Weapon Shop Fantasy,1250,302,6.99,948
611320,Think To Die 3,61,15,4.99,46
542480,Therian Saga,332,137,0.0,195
492290,Has-Been Heroes,278,87,19.99,191
541450,Operation Abyss: New Tokyo Legacy,104,38,19.99,66
602880,Powernaut VANGARDT,10,3,0.99,7
612790,INFINITI VR,40,20,0.0,20
508530,HackyZack,162,73,9.99,89
366870,Narcosis,797,265,14.99,532
543010,Bush Hockey League,158,84,11.99,74
312520,Rain World,6194,610,19.99,5584
296300,Ballistic Overkill,5325,1717,1.99,3608
552970,Sumoman,404,95,16.99,309
383980,Rivals of Aether,23699,1177,29.99,22522
390620,An Alien with a Magnet,43,3,2.99,40
588730,Majotori,1350,35,5.99,1315
446810,Blossom Tales: The Sleeping King,358,53,14.99,305
576400,Elisa: the Innkeeper,99,39,6.99,60
544330,Snake Pass,2099,546,19.99,1553
611980,Oik 2,1128,86,0.99,1042
614900,Devade,34,28,0.99,6
493820,Rivais Em Batalha,30,10,1.99,20
506540,Last Man Standing,11168,7130,0.0,4038
599880,Tequila Zombies 3,55,19,2.99,36
588430,Fallout Shelter,46056,6014,0.0,40042
494170,Miniature Garden,55,15,9.99,40
569860,Thimbleweed Park™,3143,207,19.99,2936
575720,Mighty Party,1319,872,0.0,447
580560,Hero Barrier,22,23,3.99,-1
269950,X-Plane 11,12997,1080,59.99,11917
574940,Downward Spiral: Prologue,106,14,1.99,92
461950,Beat Cop,3365,702,2.24,2663
617700,Weed Shop 2,713,111,9.99,602
552450,Serious Sam VR: The First Encounter,500,79,39.99,421
594300,Chasing Styx,64,11,0.0,53
600420,Mob Rule Classic,154,37,5.99,117
595780,Rogue Port - Blue Nightmare,33,12,0.51,21
576130,State of Anarchy: Master of Mayhem,437,76,2.99,361
605610,Dawn,676,68,0.0,608
602090,Janus VR,38,24,0.0,14
587570,Elsewhere High: Chapter 1 - A Visual Novel,47,23,0.0,24
601240,Ripple,36,16,0.99,20
485610,Ball 3D: Soccer Online,6353,1314,9.99,5039
544310,Jumps,263,12,3.99,251
594310,Reflection of a Fallen Feather,19,7,0.0,12
600210,RoboMatch,30,23,2.99,7
580510,Mr. Donovan,8,2,9.99,6
608800,Guns of Icarus Alliance,1014,317,4.99,697
613120,Tank Battle: East Front,18,6,9.99,12
509530,Gods and Nemesis: of Ghosts from Dragons,22,14,0.0,8
542660,Feral Fury,105,23,6.99,82
535230,Domina,7639,2676,9.99,4963
521350,Use Your Words,592,79,14.99,513
577730,Idle Evolution,131,43,4.99,88
572730,Nancy Drew®: The Silent Spy,82,5,19.99,77
549790,Glorch's Great Escape: Walking is for Chumps,4,2,2.99,2
585090,Black River,15,15,4.99,0
402130,FlatOut 4: Total Insanity,840,774,29.99,66
592660,Zen Garden,76,31,4.99,45
578330,LEGO® City Undercover,5229,677,19.99,4552
453310,Blackwood Crossing,325,68,15.99,257
617600,VR Interior Designer Pro,8,3,0.0,5
598440,Roots of Insanity,283,124,6.99,159
605110,VR Chair Games,4,19,0.99,-15
585970,Tank Assault X,18,12,1.99,6
612070,Kio's Adventure,1637,436,1.99,1201
542590,SoulSaverOnline,164,94,0.0,70
599000,Pizza Connection 2,150,55,0.59,95
568770,Cinderella Phenomenon - Otome/Visual Novel,3524,111,0.0,3413
355010,Race Arcade,58,25,11.99,33
589510,Shovel Knight: Specter of Torment,353,23,9.99,330
598990,Pizza Connection,34,16,0.59,18
614460,Amber Tail Adventure,36,22,0.99,14
600370,Paradigm,1306,76,14.99,1230
574260,The Secret Order 5: The Buried Kingdom,140,31,9.99,109
601170,ZiL Truck RallyCross,45,34,4.99,11
610360,Zup! Zero,2284,157,0.99,2127
544580,BULLET SOUL / バレットソウル - 弾魂 -,52,10,14.99,42
586030,Shardbound,909,288,0.0,621
392280,The Franz Kafka Videogame,428,217,0.69,211
614650,Midnight Calling: Anabel Collector's Edition,2,0,9.99,2
476030,Johnny Graves—The Unchosen One,29,15,3.99,14
613420,BOROS,24,1,4.99,23
610810,Your Friend Hana,389,200,0.99,189
588920,BADASS,15,14,4.99,1
617710,Cannons-Defenders: Steam Edition,77,46,0.99,31
612310,GORB,31,2,0.99,29
615250,M.A.X.: Mechanized Assault & Exploration,110,13,9.99,97
552900,Fields XY,34,7,3.99,27
492200,CapRiders: Euro Soccer,19,0,3.99,19
586390,Missile Cards,51,4,4.99,47
599040,Win That War!,22,13,19.99,9
448320,GIBZ,799,125,7.99,674
473530,Slime-san: Superslime Edition,234,37,14.99,197
619330,Duck Hunting,10,8,7.99,2
501590,Bulletstorm: Full Clip Edition,5511,727,39.99,4784
611350,Evil Tag,411,199,0.99,212
503350,White Noise 2,2248,567,9.99,1681
574740,Fausts Alptraum,867,68,0.0,799
605190,Getaway Island,89,35,3.99,54
619400,Fluffy Creatures VS The World,104,155,0.51,-51
601810,Spark the Electric Jester,640,56,5.99,584
617610,Japanese Women - Animated Jigsaws,126,9,9.99,117
586160,Dash Fleet,4,9,0.99,-5
622150,Bridge to Another World: Burnt Dreams Collector's Edition,6,0,9.99,6
457760,The Signal From Tölva,671,324,19.99,347
564280,Adventuring Gentleman,14,4,0.99,10
619930,Spring Bonus,44,9,6.99,35
499890,Aaero,696,138,14.99,558
587400,Snow Moto Racing Freedom,45,15,12.99,30
583740,AVATARIKA,87,111,0.0,-24
460790,Bayonetta,19411,1647,19.99,17764
548840,A Rose in the Twilight,364,50,19.99,314
592060,Sons of Triskelion,9,12,3.99,-3
606300,Divine Ascent,10,2,4.99,8
466300,Planescape: Torment: Enhanced Edition,3143,171,19.99,2972
552590,The Sexy Brutale,2986,223,19.99,2763
256460,Cosmic Star Heroine,677,82,14.99,595
586380,VITATIO 2,324,138,0.99,186
512180,Nightshade／百花百狼,574,15,34.99,559
596810,Save Their Souls,46,11,0.49,35
293780,Crawl,5755,309,14.99,5446
360830,Yooka-Laylee,3492,1108,5.99,2384
609940,KROSMAGA,706,247,0.0,459
607440,Escape: VR,124,28,1.99,96
555830,Vecitas,13,14,7.99,-1
610780,Crazy Buggy Racing,34,71,4.99,-37
453000,Wave Beta,536,44,0.0,492
585360,Steampunk Syndicate,44,32,1.99,12
615150,Twist of Destiny,31,11,2.99,20
524640,Asura: Vengeance Edition,573,91,9.99,482
414530,Skyforge,2393,1635,0.0,758
619280,Gloom,448,92,9.99,356
587310,Soma Spirits: Rebalance,42,0,0.0,42
500170,Urlaubsflug Simulator – Holiday Flight Simulator,66,57,12.99,9
566190,The Search,790,270,3.99,520
489140,Mr. Shifty,1333,175,14.99,1158
499560,Fourtex Jugo,4,5,4.99,-1
603250,My Own Little Planet,17,13,5.99,4
616240,Premium Pool Arena,57,58,9.99,-1
607020,Last Heroes 4,18,9,2.99,9
619220,GoBlock's Impossible Medley,14,3,0.99,11
558780,Sonya: The Great Adventure,119,42,6.99,77
527700,Containment Initiative,400,50,2.49,350
610860,Shogo: Mobile Armor Division,110,38,9.99,72
564210,Fishermurs,39,20,0.49,19
466220,Kingdom of Loot,198,168,0.0,30
599060,Age of Heroes: Conquest,20,26,0.0,-6
420980,Army Gals,207,22,14.99,185
586750,Sonny,216,153,4.99,63
619740,The Inevitability,50,34,4.99,16
545980,Voodoo Vince: Remastered,359,30,14.99,329
458600,ZRoll,93,67,0.99,26
228360,Full Throttle Remastered,2045,162,14.99,1883
584980,Late Shift,6513,1001,4.93,5512
559680,Vampire: The Masquerade - Redemption,533,79,5.99,454
592780,Bang Bang Car,19,14,0.0,5
560370,SWAT 3: Tactical Game of the Year Edition,166,107,9.99,59
401710,Flinthook,585,196,14.99,389
570580,Zork Anthology,57,3,5.99,54
572050,Call to Power II,45,29,5.99,16
615730,Nancy Drew®: The Final Scene,68,15,6.99,53
511800,ONRAID,1374,436,0.0,938
579950,Marvel's Guardians of the Galaxy: The Telltale Series,1566,233,0.0,1333
610750,Games&Girls,200,67,1.99,133
525040,The Disney Afternoon Collection,657,77,19.99,580
521720,Uncharted Waters,22,3,12.99,19
366640,Shiness: The Lightning Kingdom,260,184,9.99,76
521760,Taiko Risshiden,36,6,12.99,30
521750,Romance of the Three Kingdoms V with Power Up Kit,57,13,19.99,44
532170,WaveLand,63,9,4.99,54
613130,Mega Overload VR,34,1,14.99,33
623360,Grim Tales: The Legacy Collector's Edition,15,6,9.99,9
427270,Orcs Must Die! Unchained,4196,1939,0.0,2257
621150,False Shelter,45,20,0.99,25
344240,Man O' War: Corsair - Warhammer Naval Battles,469,280,0.0,189
558110,Odyssey - The Story of Science,194,63,14.99,131
410900,Forts,11586,1112,14.99,10474
614880,Battle for Enlor,8,14,2.99,-6
617420,Animal Rivals,27,25,6.99,2
589770,Green Elephant 2D,299,25,1.99,274
563560,Alien Swarm: Reactive Drop,16084,860,0.0,15224
469610,Rick and Morty: Virtual Rick-ality,1344,441,29.99,903
459220,Halo Wars: Definitive Edition,5684,622,19.99,5062
624460,Fantasynth One,421,16,0.0,405
598940,Doodle Mafia,82,40,7.99,42
607040,Grimoire Chronicles,44,15,0.51,29
584880,Pixel Sand,49,6,0.0,43
589460,Covert Syndrome,94,48,0.0,46
582270,Everything,2737,541,14.99,2196
416000,Fantasy Farming: Orange Season,252,29,16.99,223
534560,Ramify,13,1,2.99,12
370620,Onyx,13,7,4.99,6
430890,Rytmik Player,38,9,0.0,29
407310,NEKO-NIN exHeart,923,45,9.99,878
546350,Craft Keep VR,74,42,14.99,32
576750,Ropes And Dragons VR,43,9,0.99,34
587970,Dead Drop,57,14,5.99,43
615610,Orbt XL,3051,96,0.99,2955
585430,Flatspace IIk,13,7,15.99,6
628750,aMAZE 2,615,98,0.99,517
620710,TankBlitz,33,6,7.99,27
575860,Tomb Joe,66,91,0.54,-25
624920,Trapped With the Dolls VR,41,11,0.0,30
581980,Candy Machine,14,32,8.99,-18
566860,VR Dungeon Knight,1012,267,19.99,745
522880,PSYCHO-PASS: Mandatory Happiness,113,23,19.99,90
614030,Rhythm Rush!,117,44,0.99,73
414700,Outlast 2,32568,3323,29.99,29245
368070,Sniper Ghost Warrior 3,10133,5375,19.99,4758
628950,Nephise Begins,676,407,0.99,269
614890,Cuit,96,28,0.0,68
331480,Pinstripe,1990,235,14.99,1755
501300,What Remains of Edith Finch,25897,1211,19.99,24686
615670,SOLITUNE,92,21,1.99,71
342150,Games of Glory,322,243,0.0,79
502820,Batman™: Arkham VR,1219,516,19.99,703
574050,DRAGON QUEST HEROES™ II,513,220,59.99,293
579110,Interkosmos,301,49,0.99,252
604190,Storm Riders,60,308,0.0,-248
595140,Immortal Redneck,2613,248,19.95,2365
620670,The Cursed Revolver,12,2,2.99,10
586140,BlazBlue Centralfiction,7429,502,13.19,6927
587430,I Expect You To Die,2017,112,24.99,1905
620310,Bonny's Adventure,11,1,3.99,10
544730,Catan Universe,5318,3985,0.0,1333
418060,Battle Riders,110,54,0.99,56
475190,Scanner Sombre,2553,324,1.19,2229
611140,Dark Passenger,16,13,2.99,3
446030,Corroded,73,14,0.0,59
285190,"Warhammer 40,000: Dawn of War III",9440,10637,39.99,-1197
606520,Grisaia Phantom Trigger Vol.2,120,3,14.99,117
598450,"Slice, Dice & Rice",438,244,9.99,194
606510,Grisaia Phantom Trigger Vol.1,281,19,14.99,262
424840,Little Nightmares,75367,4285,19.99,71082
589690,Queen's Quest 3: The End of Dawn,100,32,9.99,68
562210,Древняя Русь,127,27,0.0,100
618840,Samhain World,1,5,0.0,-4
428200,Attack Heroes,158,69,9.99,89
618950,Agatha Knife,370,21,11.99,349
445190,Expeditions: Viking,2826,547,29.99,2279
567030,Under Leaves,500,19,4.99,481
532320,de Blob,200,26,19.99,174
429780,Bunny Hop League,518,193,5.99,325
622650,Bendy and the Ink Machine,16912,2303,19.99,14609
577480,Higurashi When They Cry Hou - Ch. 5 Meakashi,415,14,5.19,401
561770,Just Ignore Them,427,119,1.07,308
345630,The Eden of Grisaia,78,3,29.99,75
588110,One Dog Story,390,95,11.99,295
608990,The Archotek Project,439,338,0.0,101
437720,Blossoms Bloom Brightest,101,51,0.0,50
336300,Hearthlands,319,65,9.99,254
617660,Dong-Jin Rice-hime（東津萌米）,427,43,19.99,384
529240,"Creature Clicker - Capture, Train, Ascend!",161,188,1.99,-27
609100,Gold Rush! 2,12,8,3.99,4
615680,Vagrant Hearts Zero,9,10,0.49,-1
621050,Crazy Veggies,24,28,1.99,-4
586880,Mini Ghost,352,14,1.99,338
589430,Killer Elite – Time to Die,4,20,0.0,-16
602930,Wordlase,38,34,2.99,4
588710,Neighboring Islands,77,25,0.69,52
564990,Olav: the story of one boy,7,3,2.99,4
521100,MinosMaze - The Minotaur's Labyrinth,31,25,0.54,6
509610,Beachhead 2000,10,28,2.99,-18
562290,Knights of Galiveth,12,10,0.0,2
511660,Beachhead 2002,43,20,2.99,23
581380,Clockwise,28,14,1.99,14
582810,Awesome Metal Detecting,221,119,9.99,102
525690,MMM: Murder Most Misfortunate,70,9,4.99,61
549080,Tank Warfare: Tunisia 1943,262,51,39.99,211
582260,Extreme-G 2,56,44,5.99,12
584930,Conductor,262,16,9.99,246
581130,Metal Waltz: Anime tank girls,1170,303,0.0,867
616110,SPACEPLAN,2034,197,2.99,1837
562260,WAVESHAPER,186,23,1.99,163
612050,VRIQ,21,10,0.0,11
535170,Climbtime,24,17,0.0,7
436670,The Legend of Heroes: Trails in the Sky the 3rd,1188,66,29.99,1122
474830,Time in Time,62,22,1.99,40
618510,Battle Bruise,368,36,0.99,332
480490,Prey,36220,3820,29.99,32400
525360,Shio,1151,311,11.99,840
616030,Eventide Night,25,1,0.99,24
603100,ATOMINE,234,74,0.99,160
606960,CRIMSON METAL Classic 1999,115,111,0.49,4
587580,Nature Treks VR,228,42,9.99,186
621810,Strain Tactics,161,29,14.99,132
597040,Dumbass Drivers!,29,29,0.99,0
378350,Chromadrome 2,23,4,2.99,19
566530,Mass Exodus Redux,208,60,14.99,148
427570,Dawn of Andromeda,102,116,5.39,-14
606490,Duck Life: Space,87,14,3.99,73
614910,#monstercakes,664,90,0.99,574
625990,Welcome to Moreytown,35,8,3.99,27
591960,Animation Throwdown: The Quest for Cards,2414,776,0.0,1638
628700,The Flaws of Gravity,142,92,0.0,50
581120,Griptape Backbone,465,34,0.0,431
627820,England Exchange,59,49,14.99,10
420180,Chronicle of Innsmouth,138,36,12.99,102
384250,Super Rude Bear Resurrection,96,63,14.99,33
370660,Opaline,36,12,5.99,24
530020,World to the West,275,81,14.99,194
581670,The Astral Hero,59,43,5.99,16
440730,Survival Zombies The Inverted Evolution,562,419,4.99,143
630240,Nevertales: Smoke and Mirrors Collector's Edition,4,1,9.99,3
623080,planetarian HD,1891,20,9.99,1871
627950,1914: Prelude to Chaos,50,55,0.99,-5
550900,Metin2,10180,4390,0.0,5790
280790,Creativerse,23937,5722,0.0,18215
545270,NBA Playgrounds,961,397,0.0,564
574820,Cat or Bread?,316,32,0.99,284
632510,Blockle,50,21,4.99,29
505080,Gakuen Club,37,20,29.99,17
623580,POBEDA,52,55,0.99,-3
525700,Birthdays the Beginning,472,303,19.99,169
591930,Genesia Legacy: Ultimate Domain,50,17,19.99,33
442780,STRAFE: Gold Edition,1667,633,14.99,1034
416210,Block'hood,908,320,14.99,588
559210,Rakuen,4930,168,9.99,4762
615090,Royal Offense,65,22,9.99,43
608540,Blastercell,10,5,4.99,5
572330,The Fan,72,43,5.99,29
625370,A SECOND BEFORE US,56,41,3.99,15
632290,The Grand Ball,18,8,4.99,10
615340,Mystic Journey: Tri Peaks Solitaire,75,63,0.0,12
563360,Market Tycoon,178,134,9.99,44
602070,Plasma Puncher,65,5,5.99,60
529360,Void Rangers,29,7,11.99,22
603150,Defence to death,90,88,5.99,2
551050,Die With Glory — Point and Click Adventure Game,33,19,5.99,14
557330,>//:System.Hack,23,7,10.99,16
312650,Battlezone Gold Edition,259,80,34.99,179
268990,The Dishwasher: Vampire Smile,898,55,9.99,843
628920,Tomboys Need Love Too!,148,21,9.99,127
607030,Jade's Journey 2,10,12,3.99,-2
628530,Blobby Tennis,32,13,0.0,19
405290,Charlie Murder,1296,70,9.99,1226
627620,Intelligent Design: An Evolutionary Sandbox,62,75,6.99,-13
599840,Planet RIX-13,83,2,2.99,81
589870,Learn to Fly 3,6113,429,0.0,5684
597700,OVIVO,384,42,4.99,342
530560,STEAM HAMMER,231,332,0.0,-101
546930,Machine Hunt,264,254,2.99,10
378540,The Surge,6204,2053,14.99,4151
507400,Vindictive Drive,46,16,2.99,30
593680,Rocking Pilot,45,2,2.99,43
631660,Immersion Chess,78,39,0.0,39
629030,Employee Recycling Center,37,92,1.99,-55
612250,Eastwood VR,6,10,3.99,-4
575570,ICED,107,49,9.99,58
622540,The Frost,9,17,0.99,-8
548810,Operation Babel: New Tokyo Legacy,61,15,19.99,46
371520,Bounty Train,986,429,0.99,557
620700,EVIL POSSESSION,55,37,0.0,18
569370,Bitdude,12,2,0.0,10
636930,Soundscape VR,66,26,0.0,40
291690,Empathy: Path of Whispers,110,69,19.99,41
612740,Bokida - Heartfelt Reunion,112,34,9.99,78
484830,Deep Blue 3D Maze in Space,55,31,0.99,24
581270,Old Man's Journey,2710,388,7.99,2322
616740,克莉丝的炎之信仰 Cryste: the Faith of Fire Vol.1,264,34,9.99,230
607210,Possessed,59,36,3.99,23
506730,Dinosaur Forest,364,286,0.51,78
616880,No Stick Shooter,21,2,0.99,19
451630,Brute,23,4,6.99,19
600630,Spaceship Looter,138,61,0.0,77
614130,Command: Chains of War,27,2,0.0,25
464150,Regalia: Of Men and Monarchs,401,101,19.99,300
537430,Inner Chains,214,241,3.99,-27
392110,ENDLESS™ Space 2,16218,3255,39.99,12963
529660,Mages of Mystralia,1061,168,19.99,893
579720,Neverout,60,41,3.99,19
436230,Detached,197,133,24.99,64
374040,Portal Knights,16495,3372,19.99,13123
514580,Cooking Witch,194,25,1.99,169
592730,Aerial Destruction,72,38,8.99,34
599560,Ghost Files: The Face of Guilt,168,67,9.99,101
637330,Stack,15,10,3.99,5
509250,TO THE TOP,633,100,19.99,533
636480,Ravenfield,49412,1500,14.99,47912
635310,Ski Sniper,195,34,4.99,161
622890,NecroWorm,86,71,0.49,15
611720,Practisim VR,29,11,19.99,18
545540,The Infectious Madness of Doctor Dekker,397,68,8.99,329
507120,The Superfluous,40,11,1.99,29
636150,Cyberhunt,1004,199,0.49,805
376490,The Great Gatsby: Secret Treasure,31,10,5.99,21
597150,Hyper Knights,636,81,4.99,555
375580,Three Days,44,19,2.99,25
554220,Oafmatch,51,10,5.99,41
575770,Dangerous Bullets,18,17,3.99,1
603130,Masked Shooters,91,40,0.99,51
604490,Running Through Russia,980,391,0.99,589
612300,Sudden Strike Gold,277,42,5.99,235
543390,Aeon,170,64,9.99,106
468000,Impact Winter,173,254,0.0,-81
546410,Grab the Bottle,74,16,0.59,58
306130,The Elder Scrolls® Online,100300,21936,19.99,78364
612520,Sudden Strike 2 Gold,192,36,5.99,156
615780,Nancy Drew®: Treasure in the Royal Tower,97,22,9.99,75
612540,Sudden Strike 3,100,47,5.99,53
318970,StarCrawlers,687,120,19.99,567
626580,Spellspire,67,26,9.99,41
632070,The Fidelio Incident,632,181,9.99,451
600720,Trackmania² Lagoon,164,96,19.99,68
572410,Steel Division: Normandy 44,4291,1481,9.99,2810
352460,Dead Realm,2912,1731,0.0,1181
419480,Starpoint Gemini Warlords,2396,851,34.99,1545
308600,Geneshift,1678,395,14.99,1283
592020,SmuggleCraft,23,2,9.99,21
595740,SAMURAI WARRIORS: Spirit of Sanada,437,91,49.99,346
605990,Heart's Medicine - Hospital Heat,301,11,12.99,290
493180,Dynasty Feud,65,15,0.0,50
382330,Killers and Thieves,70,72,1.99,-2
633440,Unit 4,26,32,14.99,-6
322780,Worlds Adrift,3417,2011,0.0,1406
427240,Cosmic Trip,433,75,7.99,358
622920,P-Walker's Simulation,31,39,2.99,-8
582660,Black Desert,43769,14463,9.99,29306
452060,Caveblazers,3053,430,9.99,2623
489370,Quarantine,244,163,9.99,81
622320,Nano Project,8,6,3.99,2
617830,SUPERHOT VR,5992,2130,24.99,3862
608760,Doodle Devil,109,21,9.99,88
602520,NEKOPARA Vol. 3,11080,323,9.99,10757
594370,Crazy Fishing,55,46,19.99,9
613970,Bravery: Rise of The Last Hero,5,11,4.99,-6
640380,UBERMOSH Vol.5,275,16,0.49,259
396750,EVERSPACE™,7818,2058,29.99,5760
460810,Vanquish,4967,634,19.99,4333
634200,Tanks vs Aliens,26,6,4.99,20
561740,MidBoss,216,35,14.99,181
438740,Friday the 13th: The Game,53814,14370,14.99,39444
493200,RiME,4228,460,29.99,3768
644670,DEUS VULT | Online VR sword fighting,94,54,4.99,40
579020,Constructor,483,163,29.99,320
623550,Timen runner,49,44,0.49,5
502740,50 years,534,61,4.99,473
632000,CrossCells,536,94,0.89,442
523780,Emily is Away Too,4784,321,4.99,4463
496460,Life is Feudal: Forest Village,3518,1830,24.99,1688
504450,StarSmashers,7,13,7.99,-6
612620,Detective Butler: Maiden Voyage Murder,182,43,0.0,139
529630,The Rabbit Hole Remastered,11,8,3.99,3
514360,Freedom Fighter,29,14,3.99,15
637850,Confess My Love,4018,280,0.0,3738
604740,Danger Zone,112,48,14.99,64
365810,Flying Tigers: Shadows Over China,607,251,14.99,356
611120,IKEA VR Pancake Kitchen,202,95,0.0,107
620130,Chaos Town,19,3,0.49,16
561600,MXGP3 - The Official Motocross Videogame,729,122,19.99,607
635730,Dragonia,4868,902,0.0,3966
618640,The Crowded Party Game Collection,16,11,0.0,5
626510,LoveKami -Useless Goddess-,290,67,2.59,223
567060,Putrefaction 2: Void Walker,257,75,4.99,182
583890,Balthazar's Dream,98,13,4.99,85
527100,Star Trek™: Bridge Crew,2173,655,9.99,1518
366910,The Long Journey Home,1057,689,0.99,368
468160,Ancient Go,67,36,4.99,31
451080,Giant Cop: Justice Above All,27,9,24.99,18
490080,Lock's Quest,40,51,14.99,-11
592200,Super Army of Tentacles 3: The Search for Army of Tentacles 2,15,5,10.99,10
587000,First Strike: Classic,1062,171,11.99,891
603350,Don't cut your hand,167,37,0.99,130
418460,Rising Storm 2: Vietnam,43328,7025,24.99,36303
627420,Sorgina: A Tale of Witches,5,3,9.99,2
426310,Perception,384,146,19.99,238
610350,Poker Show VR,20,26,2.49,-6
612020,Zombidle : REMONSTERED,1354,211,0.0,1143
591790,BREACH IT,95,94,0.99,1
619890,Evil Glitch,29,3,2.99,26
536950,Legend of Ares,30,24,0.0,6
597200,Epic Little War Game,35,6,4.99,29
590370,Tiny Troopers 2,41,8,5.99,33
605210,The Last Tree,18,7,1.99,11
638920,BeanVR—The Social VR APP,20,26,0.0,-6
548370,Rezrog,143,177,9.99,-34
364470,The Elder Scrolls®: Legends™,7431,2582,0.0,4849
574440,Ripple Effect,41,19,0.0,22
639790,DEEP SPACE WAIFU,7222,252,4.99,6970
490450,Tokyo 42,417,180,19.99,237
575330,Oh...Sir! The Hollywood Roast,277,43,0.79,234
280180,Hover,1588,374,19.99,1214
617690,Endless Winter,37,3,7.99,34
614960,NEONomicon,75,19,1.99,56
603030,Lamp Head,256,66,0.49,190
526730,Life of Lon: Chapter 1,31,12,0.0,19
643880,Strikey Sisters,622,69,9.99,553
616560,Ultimate Epic Battle Simulator,8403,2737,14.99,5666
408520,FORM,856,81,14.99,775
643900,Alvora Tactics,100,8,9.99,92
340580,Armed with Wings: Rearmed,396,55,9.99,341
389730,TEKKEN 7,56628,12268,39.99,44360
448170,Last Dream: World Unknown,52,15,2.99,37
386140,After The End: The Harvest,51,22,4.99,29
500670,Tormentor❌Punisher,471,60,7.99,411
532920,The Artifact,127,66,7.99,61
235380,Blitzkrieg 3,3851,2849,9.99,1002
339590,Crowman & Wolfboy,58,15,0.99,43
619210,4D Toys,146,23,14.99,123
644540,Dies irae ~Amantes amentes~,392,67,0.0,325
629000,Lydia,479,62,3.99,417
635850,Sentience: The Android's Tale,101,10,0.87,91
606680,Silver,558,43,5.99,515
573660,AereA,26,28,14.99,-2
586320,UFO - Unfortunately Fortunate Organisms,33,2,0.99,31
610130,UltraGoodness,158,51,4.99,107
448690,Lionessy Story,38,29,4.99,9
322750,Drifting Lands,202,51,4.99,151
587420,Cart Racer,605,175,0.99,430
618370,Rescue Quest Gold,35,5,9.99,30
541210,Cold Waters,3105,489,39.99,2616
646820,Might & Mayhem,47,37,0.0,10
580940,Redneck Rampage Rides Again,23,6,9.99,17
446760,Neighborhorde,35,4,4.99,31
639450,"Don't Tax Me, Bro!",44,11,0.0,33
582550,Passpartout: The Starving Artist,4662,699,9.99,3963
603840,Randall,15,4,14.99,11
506260,Cladun Returns: This Is Sengoku!,51,16,19.99,35
636370,The Sun Never Sets,12,4,4.99,8
313780,Conarium,1446,375,19.99,1071
593030,Strategic Command WWII: War in Europe,263,25,39.99,238
588040,WILL: A Wonderful World / WILL：美好世界,4740,321,14.99,4419
593210,Counter Fight: Samurai Edition,69,7,2.99,62
584850,Power Solitaire VR,29,1,0.0,28
388550,Galactic Missile Defense,25,19,1.99,6
629380,Cosmic Pioneer,18,27,0.99,-9
603960,Monolith,1484,28,7.99,1456
585860,Bunker 58,43,102,1.99,-59
628900,Terra Mystica,124,84,14.99,40
523870,Breaking Fast,32,4,9.99,28
401910,Darknet,99,7,14.99,92
421020,DiRT 4,11931,3069,14.99,8862
636040,Pixel Worlds: MMO Sandbox,3752,1259,0.0,2493
615350,Scarlett Mysteries: Cursed Child,188,26,9.99,162
595660,Lux Alliance,45,12,9.99,33
636520,Gevaudan,80,50,2.99,30
642070,VR Theme Park Rides,12,18,2.99,-6
543260,Wonder Boy: The Dragon's Trap,1817,288,19.99,1529
631900,Airtone,192,11,29.99,181
563470,Reaping Rewards,35,24,0.0,11
623840,Ambre - a heartbreaking kinetic novel,453,141,0.0,312
364050,Face It - A game to fight inner demons,923,289,3.99,634
359340,Pixel Puzzles Mosaics,60,7,4.99,53
486990,Jump Stars,13,18,0.99,-5
585080,Hunting Simulator,155,128,19.99,27
620900,Witchinour,52,3,3.89,49
625140,Ragnarok Journey,120,203,0.0,-83
571530,Superdimension Neptune VS Sega Hard Girls,818,57,19.99,761
434510,Formicide,262,61,0.0,201
645790,Home Wars,557,183,9.99,374
642560,Art Of Gravity,541,49,0.99,492
591740,Sniper Fury,1176,1284,0.0,-108
602630,Diorama Worlds,29,3,0.0,26
645090,Zup! 5,2374,157,0.99,2217
355370,Vidar,29,4,9.99,25
592270,Neko Navy,120,3,5.49,117
629650,Symphonic Rain,558,20,39.99,538
423490,Air Missions: HIND,436,110,16.99,326
568720,The Agony,154,113,1.99,41
561610,MotoGP™17,383,106,2.99,277
626680,Kreedz Climbing,751,174,0.0,577
525920,Pro Cycling Manager 2017,301,116,9.99,185
480640,Pathfinder Adventures,450,255,9.99,195
627670,Rocket Wars,36,3,0.99,33
610080,Realm Grinder,5051,753,0.0,4298
580720,Carrier Deck,715,96,9.99,619
606480,Flood of Light,220,14,3.99,206
589590,Kindergarten,5127,228,4.99,4899
571260,THE KING OF FIGHTERS XIV STEAM EDITION,3021,631,59.99,2390
646180,Nightcrawler VR Bowling,4,3,0.0,1
576740,FootRock 2,47,10,0.99,37
607660,21 Days,46,15,1.99,31
645940,OneScreen Solar Sails,26,10,1.99,16
516510,Orake Classic,460,191,0.0,269
437610,SQUIDS FROM SPACE,203,22,0.0,181
554770,Heavily Armed,5,26,14.99,-21
654570,History2048 - 3D puzzle number game,21,11,1.99,10
639280,Lander 8009 VR,9,3,14.99,6
366090,Colony Survival,5470,517,19.99,4953
645410,Ominous Tales: The Forsaken Isle,18,12,6.99,6
613010,Secret in Story,67,34,0.99,33
648120,Pixel Painter,732,255,0.99,477
597770,VINDICTA,63,23,14.99,40
594490,Deadly Hunter VR,210,50,0.0,160
550080,VALKYRIE DRIVE -BHIKKHUNI-,920,157,29.99,763
344740,CRYPTARK,799,146,14.99,653
299950,GET EVEN,1112,340,29.99,772
644570,Material Girl,7359,688,0.0,6671
404540,Nex Machina,1637,231,19.99,1406
236110,Dungeon Defenders II,15318,4512,0.0,10806
661430,LineWay,395,25,0.99,370
272620,Serious Sam's Bogus Detour,334,67,9.99,267
619810,Fabulous - Angela's High School Reunion,57,5,12.99,52
644610,Drums Hero PC,22,11,4.99,11
632200,Kuro survival,33,16,0.99,17
604010,Chimpology,67,9,1.99,58
465710,Heroes Tactics,160,99,0.0,61
518060,Chess Ultra,1141,364,12.99,777
655160,welcome to heaven,368,140,0.0,228
661950,FlyingRock: Arena,27,22,0.0,5
639720,A Bloody Night,74,17,2.99,57
635060,Castle of no Escape,67,44,4.99,23
643700,Fix Me Up Doc! – Dark Humor,176,32,1.99,144
563190,de Blob 2,98,7,19.99,91
530700,Argo,5686,5403,0.0,283
360400,Zombie Quarantine,1,3,0.99,-2
653950,Your Smile Beyond Twilight:黄昏下的月台上,520,27,1.99,493
652570,Mystika 3 : Awakening of the dragons,56,5,4.99,51
657180,The Adliberum Engine (ADLENGINE),6,4,0.0,2
588620,Mary Le Chef - Cooking Passion,76,10,12.99,66
660880,b,3398,345,0.0,3053
650110,Princess Maker 3: Fairy Tales Come True,168,122,0.0,46
555950,Danganronpa Another Episode: Ultra Despair Girls,3622,476,29.99,3146
554510,The Golf Club 2™,489,309,0.0,180
645830,Son Korsan,34,77,0.0,-43
628090,NOBUNAGA'S AMBITION: Haouden with Power Up Kit,8,6,19.99,2
579940,Race for the Galaxy,303,26,7.99,277
370440,No70: Eye of Basir,195,139,9.99,56
659540,Warsim: The Realm of Aslona,844,23,7.99,821
652340,Flagsplosion,46,4,2.99,42
535850,Micro Machines World Series,156,370,9.99,-214
621080,Persian Nights: Sands of Wonders,207,16,9.99,191
640970,In Game Adventure: Legend of Monsters,94,30,0.0,64
656200,电竞俱乐部/ESports Club,830,707,8.99,123
649600,Swords and Sandals 2 Redux,311,93,8.99,218
666960,Cowboy's Adventure,37,41,0.99,-4
538000,Hop Step Sing! Kisekiteki Shining! (HQ Edition),49,6,4.99,43
612720,SAELIG,448,111,14.99,337
549240,Beans: The Coffee Shop Simulator,99,42,4.99,57
638930,Dal Segno,113,11,39.99,102
622040,Zooicide,265,134,4.99,131
623160,Zombie Solitaire 2 Chapter 1,54,15,8.99,39
642840,Red Bull Doodle Art - Global VR Gallery,9,0,0.0,9
645480,Spider-Man: Homecoming - Virtual Reality Experience,266,255,0.0,11
587710,Xenobox VR,3,0,4.99,3
659900,Aetherspace,42,26,0.0,16
647280,Pixel Shooter,55,104,9.99,-49
631770,Pixplode,80,28,2.99,52
574760,Starship Theory,498,497,0.0,1
569290,Metamorfose S,69,25,5.99,44
656680,Bomb Defense,20,86,4.99,-66
661530,Gold Rush In The Oort Cloud,7,13,2.99,-6
624890,Adventure Craft,132,27,0.0,105
586600,The Adventures of Fluffy,16,23,1.99,-7
659460,RiotZ,7,10,3.99,-3
628440,Multiplayer FPS Demo,107,92,0.0,15
646600,Baobabs Mausoleum Ep.1: Ovnifagos Don´t Eat Flamingos,97,35,5.99,62
641860,Trenches of War,53,6,0.0,47
469720,Monsters' Den: Godfall,374,67,14.99,307
533970,Blocks by Google,164,23,0.0,141
304930,Unturned,443320,41385,0.0,401935
589730,Tyd wag vir Niemand (Time waits for Nobody),26,24,1.99,2
577760,Tears of a Dragon,16,3,0.0,13
525380,Demon Peak,141,65,4.99,76
514540,HFH Discontinued  [Upgrading to 3D and Leaving Steam],8,1,0.0,7
653220,Chroma Blast,203,47,0.0,156
665040,Visual Novel Engine,77,25,0.0,52
543240,√Letter - Root Letter -,379,90,1.99,289
613270,Dinosis Survival,149,135,4.99,14
505640,Antihero,645,88,14.99,557
411480,BATTLECREW™ Space Pirates,103,86,0.0,17
656570,In the Raven Shadow – Ve stínu havrana,65,10,3.99,55
652410,Brigand: Oaxaca,252,11,5.99,241
388370,Nova Blitz,118,43,0.0,75
639170,Minecraft: Story Mode - Season Two,1352,125,0.0,1227
585910,Wild Guns Reloaded,282,46,14.99,236
308060,Black The Fall,1183,334,14.99,849
495290,AccuRC 2,341,42,49.99,299
608660,Psebay,100,11,9.99,89
583470,The End Is Nigh,2372,159,14.99,2213
674310,THE 2048,71,8,0.99,63
600750,Star Trek Timelines,721,402,0.0,319
662210,Metal as Phuk,235,11,4.99,224
628660,Lode Runner Legacy,109,22,11.99,87
647430,Game of Emperors,3,5,0.0,-2
654900,qop,818,76,0.99,742
654910,YANKAI'S PEAK.,48,4,5.99,44
466810,Soulslayer～灭魂·误佳期～,488,23,9.99,465
506900,Downward,354,137,9.99,217
652980,Loading Screen Simulator,7207,1084,0.0,6123
654990,Dude Simulator,1074,726,4.99,348
626630,Two Worlds II HD - Call of the Tenebrae,26,26,14.99,0
498990,Balloon Chair Death Match,40,14,0.0,26
645260,Trophy Fishing 2,612,241,0.0,371
407000,Survival Is Not Enough,18,34,4.99,-16
655770,Crimson Gray,328,12,9.99,316
522210,Serial Cleaner,2285,363,2.99,1922
656600,Slash It Ultimate,366,149,10.99,217
502520,Ultimate General: Civil War,5816,702,29.99,5114
489570,Antisphere,48,30,1.99,18
618490,Mr Blaster,26,21,0.51,5
615080,Runaway Train,12,2,2.99,10
663390,Rento Fortune: Online Dice Board Game (大富翁),1395,1392,4.99,3
303610,Suicide Guy,1272,198,4.99,1074
654850,Masked Forces: Zombie Survival,276,112,0.99,164
647960,Rusted Warfare - RTS,2769,74,4.99,2695
602510,Gettysburg: The Tide Turns,41,20,9.99,21
415600,Kart Racing Pro,242,40,39.99,202
643270,OLDTV,5011,266,0.0,4745
655790,Fly Simulator,466,239,0.99,227
662470,SoundLites,17,8,0.0,9
661000,Flow:The Sliding,222,65,2.99,157
625560,The Overdreamer,13,2,10.99,11
580200,Yonder: The Cloud Catcher Chronicles,2348,502,24.99,1846
657590,Grav Blazer,52,44,4.99,8
598530,Naev,119,33,0.0,86
665090,The Initial,1452,446,9.99,1006
526450,Hack Time,0,4,2.99,-4
657200,Hand Simulator,28635,5429,1.99,23206
657120,Flix and Chill 2: Millennials,43,7,0.99,36
652550,Vickinachi,35,169,0.99,-134
454750,Aeternum,9,3,5.99,6
436290,Children of Zodiarcs,345,139,17.99,206
588950,Kingsway,1230,110,9.99,1120
327690,Gigantic,5641,1780,0.0,3861
585040,Dry Erase: Infinite VR Whiteboard,28,15,9.99,13
569770,StarShip Constructor,176,80,4.99,96
476360,Strike Vector EX,644,106,0.0,538
666610,Endless ATC,258,7,5.99,251
672160,OldMaidGirl,53,22,1.99,31
670440,Obscure - Challenge Your Mind™,12,12,4.99,0
667450,Fire Fighter,0,1,0.99,-1
593400,Float Gallery,9,5,0.0,4
575950,Blood Feed,397,194,4.99,203
661970,SPACE BATTLE: Humanity,8,11,1.99,-3
649580,Twins of the Pasture,222,78,7.99,144
573130,Aporia: Beyond The Valley,518,96,16.99,422
655730,This Strange Realm Of Mine,383,76,12.99,307
619910,Just Cause™ 3: Multiplayer Mod,1910,533,0.0,1377
674400,Einar,892,561,0.0,331
665330,Wrestling Revolution 3D,325,49,9.99,276
569480,Kingdoms and Castles,20253,1605,9.99,18648
529440,Behold the Kickmen,330,49,3.99,281
639130,Ultrawings,344,44,7.49,300
639960,OzGrind Virtual Reality Showroom,4,1,0.0,3
654880,Dream Daddy: A Dad Dating Simulator,4788,446,14.99,4342
529180,Dark and Light,5928,5033,17.99,895
658600,Lawnmower Game,339,77,0.51,262
666260,Formless Adventure,17,15,1.99,2
603940,Pixel Shopkeeper,123,33,6.99,90
637060,Tiny Tales: Heart of the Forest,141,41,9.99,100
627070,inVokeR,52,11,14.99,41
654660,Pharmakon - Tactical Puzzle,14,11,3.99,3
643960,Cursed Treasure 2,321,55,4.99,266
670100,Mint,41,34,2.99,7
655480,Solar Settlers,250,10,9.99,240
674980,Dirty Fighter 1,5,3,3.99,2
674190,Conquest of the New World,60,3,9.99,57
630060,Consummate:Missing World 寇莎梅特：困世迷情,886,40,0.99,846
563120,Desolate Wastes: Vendor Chronicles,88,76,1.99,12
673660,Neon Hardcore,94,57,3.99,37
681160,Breach of Contract Online,14,21,2.99,-7
586150,Armored Freedom,6,16,9.99,-10
678410,Chimeras: The Signs of Prophecy Collector's Edition,4,1,9.99,3
237850,Dreamfall Chapters,3448,706,24.99,2742
665740,Book Of Potentia 2,78,28,0.0,50
414490,Crashnauts,30,3,9.99,27
609410,Iron Tides,55,17,2.99,38
460430,The Letter - Horror Visual Novel,1035,142,19.99,893
425240,Pressure Overdrive,96,37,12.99,59
463700,Super Cloudbuilt,248,34,0.0,214
446550,Infinite Minigolf,88,27,14.99,61
511680,Fate/EXTELLA,3610,323,39.99,3287
647740,Airmen,253,50,14.99,203
511250,Cloudbase Prime,18,7,9.99,11
462770,Pyre,7108,733,19.99,6375
658610,位面穿越者-三国传(A Bit Crosser-Three Kingdoms),31,66,0.59,-35
484900,Aven Colony,1589,514,29.99,1075
628030,Romance of the Three Kingdoms VII with Power Up Kit,64,25,19.99,39
628100,NOBUNAGA’S AMBITION: Shouseiroku with Power Up Kit,20,8,19.99,12
575480,WAGAMAMA HIGH SPEC,278,27,39.99,251
656460,Vostok Inc.,56,37,14.99,19
637110,Runes of Avalon - Path of Magic,2,0,8.99,2
386180,Crossout,38720,11395,0.0,27325
634230,Project First Contact,75,83,1.99,-8
665300,Stream Avatars,1300,63,14.99,1237
528160,Solstice Chronicles: MIA,219,73,14.99,146
664650,Canadian Football 2017,20,10,0.99,10
562590,Galactic Junk League,1222,555,0.0,667
603700,The Low Road,147,51,14.99,96
615970,Displaced,95,75,5.99,20
549100,GravNewton,264,76,0.99,188
651470,Onirim - Solitaire Card Game,158,37,0.0,121
619340,EGOS - Tales of Fallen Souls,35,30,0.99,5
652230,CrazyCar,24,56,5.99,-32
349790,Galaxy of Pen & Paper +1,266,94,14.99,172
592030,Just In Time Incorporated,164,34,4.99,130
668770,Solarium,86,41,0.0,45
496340,Fighting Fantasy Legends,107,56,6.99,51
631980,Immortal Planet,225,121,14.99,104
644550,篱笆庄秘闻 / Mysteries of Fence,256,29,3.99,227
597990,I'm Titanium,3,3,7.99,0
393080,Call of Duty®: Modern Warfare® Remastered,4304,2361,19.99,1943
505460,Foxhole,19208,3770,29.99,15438
656900,RHEM I SE: The Mysterious Land,32,8,9.99,24
658530,Grisaia Phantom Trigger Vol.3,120,3,14.99,117
667800,Loco Dojo,48,5,19.99,43
397900,Business Tour - Board Game with Online Multiplayer,37445,23790,0.0,13655
649810,Windstorm: Start of a Great Friendship,81,31,14.99,50
368390,The Darkside Detective,2937,159,12.99,2778
629440,Graze Counter,221,8,9.99,213
645630,Car Mechanic Simulator 2018,39413,4088,19.99,35325
553340,SolarGun,168,31,0.99,137
679660,aMAZE ZER0,197,37,0.99,160
679190,The Hunting God,75,36,2.39,39
661040,Time Trap - Hidden Objects Puzzle Game,101,38,3.99,63
535480,Sundered®: Eldritch Edition,3437,714,19.99,2723
632710,Princess Evangile W Happiness - Steam Edition,57,3,34.99,54
628760,The Adventurer - Episode 1: Beginning of the End,140,111,0.49,29
674570,Bear Football,72,30,0.99,42
654680,Ziggurat 3D Chess,13,10,0.0,3
671800,Run!ZombieFood!,868,190,2.79,678
545060,BULLET SOUL INFINITE BURST / バレットソウル - インフィニットバースト -,42,15,14.99,27
215280,Secret World Legends,5655,2794,0.0,2861
589850,Leashed Soul,25,3,4.99,22
625470,The Red Stare,333,40,0.0,293
658150,Skeleton Boomerang,120,4,9.99,116
572240,Snake 3D Adventures,20,7,1.99,13
447290,Redeemer: Enhanced Edition,2168,334,14.99,1834
244750,Aztez,129,36,19.99,93
343860,Tacoma,3323,544,19.99,2779
638200,Capitalism 2,314,63,9.99,251
665490,The Monster Inside,1311,184,0.0,1127
673070,The Ranger: Lost Tribe,282,71,0.0,211
573170,Fidel Dungeon Rescue,352,20,11.99,332
659480,The Initiate,150,42,9.99,108
675030,Super Samurai Rampage,38,5,1.99,33
600280,Supreme Ruler The Great War,68,39,19.99,29
433340,Slime Rancher,90636,1970,19.99,88666
305620,The Long Dark,82602,7682,34.99,74920
538680,The Legend of Heroes: Trails of Cold Steel,4221,212,39.99,4009
581200,Nash Racing,66,85,0.55,-19
553880,Archangel™: Hellfire - Enlist FREE,195,149,0.0,46
683890,Operation Sheep Defense,19,2,0.99,17
587450,Saurian,948,541,19.99,407
610670,Alchemyland,60,77,0.99,-17
622380,RETNE,36,9,0.0,27
426190,Miner Meltdown,101,35,6.99,66
650220,Interplanetary: Enhanced Edition,584,106,2.24,478
653930,Tiny Town VR,489,41,10.49,448
665180,Dark Elf,4438,519,0.0,3919
663110,Sunrise: survival,215,194,0.0,21
667970,VTOL VR,7253,176,29.99,7077
616040,Tales of the Tiny Planet,23,4,9.99,19
644710,Gary Grigsby's War in the West,115,16,79.99,99
686870,Lost Items,26,9,0.0,17
651340,Shephy,108,32,4.99,76
631540,Community Inc,79,109,14.99,-30
682780,Breaking Good,75,13,1.99,62
630830,The Legacy: Forgotten Gates,72,4,6.99,68
636400,CUBOTS The Origins,34,14,2.99,20
650670,Grimoire : Heralds of the Winged Exemplar (V2),396,170,9.99,226
639270,Operation Warcade VR,271,13,19.99,258
501320,The Shrouded Isle,857,353,9.99,504
508300,Strategy & Tactics: Dark Ages,112,76,14.99,36
673900,Avem33,21,15,0.0,6
555370,1812: The Invasion of Canada,16,19,24.99,-3
664180,Draw Puzzle 画之谜,772,15,4.99,757
667870,MINDNIGHT,2481,454,0.0,2027
681780,Distorted Reality,15,51,4.99,-36
656340,SOLITAIRE ULTRA,1,2,0.0,-1
670500,RC Plane 3,119,78,0.0,41
669830,Asteroids Millennium,21,6,7.99,15
414340,Hellblade: Senua's Sacrifice,47523,4485,29.99,43038
635250,Evil Genome 光明重影,350,153,14.99,197
676470,Sommad,27,6,0.0,21
616220,Hide vs. Seek,218,404,0.0,-186
412210,Warfront Defenders,22,24,4.99,-2
506500,Party Panic,2186,672,16.99,1514
601400,qb,39,12,7.99,27
642650,Pepper's Puzzles,104,5,6.99,99
675630,Super POTUS Trump,265,183,0.0,82
374460,Impossiball,48,8,0.99,40
593280,Cat Quest,6188,306,12.99,5882
648630,Damascus Gear Operation Tokyo HD,12,16,14.99,-4
495050,Mega Man Legacy Collection 2,857,120,19.99,737
573080,Peregrin,226,56,14.99,170
594680,Shuyan Saga™,412,77,19.99,335
675530,M1: A Death in the Desert,22,8,2.99,14
338810,Demise of Nations,359,89,0.0,270
606730,Sine Mora EX,318,168,9.99,150
675260,Batman: The Enemy Within - The Telltale Series,5828,572,14.99,5256
663200,Rift Coaster HD Remastered VR,32,48,0.99,-16
420520,Lost Technology,416,65,4.99,351
677720,Tangrams Deluxe,49,10,4.99,39
627410,BlackEye,27,12,4.99,15
684720,Battlegun,190,91,0.99,99
678520,Gal*Gun VR,381,67,29.99,314
673450,Time Lock VR-1,396,137,9.99,259
601750,Range Day VR,15,13,15.99,2
636450,Rez Infinite,860,71,24.99,789
651660,Halcyon 6: Starbase Commander (LIGHTSPEED EDITION),587,148,14.99,439
503620,Fictorum,772,229,9.99,543
684870,Spiral Splatter,61,27,0.49,34
553330,"Clutter 7: Infinity, Joe's Ultimate Quest",5,0,9.99,5
288860,Realms of Arkania: Star Trail,117,45,7.49,72
508980,Crashday Redline Edition,1207,159,11.99,1048
504300,Gangs of Space,309,102,0.0,207
672640,War Robots VR: The Skirmish,588,137,0.0,451
357650,Project Explore,166,74,4.99,92
582920,From Shadows,21,16,0.49,5
597220,West of Loathing,7199,177,10.99,7022
445870,Phantom Trigger,52,30,14.99,22
657040,The Myth Seekers: The Legacy of Vulcan,140,27,9.99,113
669340,The Royal Cosmonautical Society,13,1,6.99,12
661120,Mercury: Cascade into Madness,37,8,8.99,29
663190,Dream Coaster VR Remastered,44,35,1.99,9
504460,Team Racing League,64,25,9.99,39
681100,Supermagical,32,9,4.99,23
680320,The Heiress,1365,207,0.0,1158
650570,Code 7: A Story-Driven Hacking Adventure,99,5,5.99,94
666250,Equalizer,35,47,1.79,-12
680480,ICY: Frostbite Edition,302,50,12.99,252
677910,Life on Mars Remake,35,3,17.99,32
677220,Silver Tale,52,22,6.99,30
397310,Looterkings,315,111,1.79,204
501530,SturmFront - The Mutant War: Übel Edition,37,4,4.99,33
373930,Sudden Strike 4,5078,1578,19.99,3500
603140,Connected Hearts - Visual novel,251,30,0.0,221
685790,Ruthless Safari,117,121,24.99,-4
684820,Singularity Roller,8,27,4.99,-19
660270,Space Scumbags,5,8,1.99,-3
677790,SOULS,113,9,7.99,104
650760,侠客风云传前传(Tale of Wuxia:The Pre-Sequel),1731,500,16.99,1231
685750,The soldier in the mine,46,39,4.99,7
666020,Shark Dating Simulator XL+,780,98,0.99,682
467660,Paranormal Activity: The Lost Soul,498,165,29.99,333
586130,Survival Driver,32,38,0.49,-6
658490,Drive Isle,58,34,2.99,24
653760,Crushing Blow,14,13,2.99,1
613670,The Chronicles of Dragon Wing - Reborn,170,41,19.99,129
441790,Fragmented,840,1091,9.99,-251
234270,Ken Follett's The Pillars of the Earth,4656,342,1.99,4314
584370,The Trail: Frontier Challenge,209,68,14.99,141
684380,MermaidVR Video Player,92,32,0.0,60
643620,Night Trap - 25th Anniversary Edition,131,24,14.99,107
514900,>observer_,4466,1169,0.0,3297
304530,Agents of Mayhem,2580,1752,29.99,828
535520,Nidhogg 2,837,193,14.99,644
686340,Insanity VR: Last Score,141,27,0.0,114
639470,Original Journey,134,48,11.99,86
638160,Moero Chronicle,394,172,9.99,222
689180,Trivia Vault: 1980's Trivia,48,28,9.99,20
689350,Ruin City Gasolina,25,54,0.99,-29
686440,Hard Time,152,25,4.99,127
322110,20XX,3695,310,14.99,3385
569630,Out of Ammo: Death Drive,62,24,5.99,38
661300,Radical Spectrum: Volume 2,8,10,1.99,-2
671170,Great eSports Manager,100,19,9.99,81
672860,StellarHub,71,62,0.99,9
666050,Rescue Team 7,34,3,6.99,31
554750,Axis Football 2017,106,58,4.99,48
429360,Lupinball,56,1,9.99,55
675210,CastleMiner Warfare,36,43,4.99,-7
274520,Darkwood,12466,709,14.99,11757
687650,Childhood grocery 辣条杂货店 学校小卖部 :令人感动的童年回忆，经典策略模拟经营解密,167,143,5.99,24
676820,Subsurface Circular,1547,91,5.99,1456
361800,Tree of Life,4420,2346,0.0,2074
692200,aMAZE Dark Times,126,50,0.99,76
227860,Castle Story,5069,3123,24.99,1946
532190,Super Blood Hockey,785,64,14.99,721
681060,Shooty Squad,49,9,0.0,40
683730,CrownFall,10,9,0.0,1
589740,Blue Horizon,32,34,5.99,-2
622170,Offensive Combat: Redux!,214,140,14.99,74
687850,Head Goal: Soccer Online,510,134,0.0,376
678200,VR Table Sports,10,5,7.99,5
662920,WESTSLINGERS,30,6,7.99,24
682130,Discord Bot Maker,2023,241,9.99,1782
678820,Gun-Running War Dogs,39,16,1.99,23
641990,The Escapists 2,21436,2324,19.99,19112
684250,月之暗面 The Dark Side Of The Moon,32,24,0.0,8
691080,3D Hardcore Cube,82,59,2.99,23
466130,White Day: A Labyrinth Named School,1518,409,29.99,1109
683830,Weable,129,45,0.99,84
587470,Chroma Lab,295,10,4.99,285
611500,Quake Champions,24692,9362,0.0,15330
656970,MagiCat,415,40,4.99,375
693880,Trivia Vault: 1980's Trivia 2,39,41,9.99,-2
635200,Distrust: Polar Survival,1528,559,11.99,969
648100,Raging Loop,2924,85,29.99,2839
683530,FreeFly Burning,30,42,0.99,-12
689650,Les Fleursword,158,146,0.0,12
644080,Alphabear: Hardcover Edition,82,17,9.99,65
651090,Aces High III,194,131,0.0,63
679820,Solitaire Mystery: Stolen Power,15,13,6.99,2
684680,Polygoneer,1154,295,0.49,859
655120,Space Hero Line,49,28,4.99,21
515220,F1™ 2017,5158,760,0.0,4398
381020,Sky Rogue,874,65,19.99,809
665360,Comedy Night,5906,1965,4.99,3941
642170,Legendary Hunter VR,39,13,9.99,26
301520,Robocraft,86140,32448,0.0,53692
655700,F.E.X (Forced Evolution Experiment),6,49,6.99,-43
589530,Hakuoki: Kyoto Winds,1138,104,9.99,1034
687830,Transparent Black,216,9,0.99,207
486380,Shigatari,193,5,2.99,188
495140,NARUTO: Ultimate Ninja STORM,3306,1126,19.99,2180
571720,One Piece: Unlimited World Red - Deluxe Edition,235,83,5.99,152
687510,WireNet,21,11,4.99,10
670160,D'LIRIUM,819,41,4.99,778
686110,Robot Heroes,56,12,0.99,44
665440,Civil War: Gettysburg,22,5,9.99,17
543870,NARUTO SHIPPUDEN: Ultimate Ninja STORM 2,2123,269,19.99,1854
680930,Fairy Lands: Rinka and the Fairy Gems,21,7,2.3,14
686570,Freedom Defender,89,49,0.0,40
674750,Yet Another Zombie Defense HD,1571,293,3.99,1278
696370,BROKE PROTOCOL: Online City RPG,2075,721,4.99,1354
689360,The Thirst of Hearts,48,85,0.99,-37
680310,Poker World - Single Player,134,159,0.0,-25
346110,ARK: Survival Evolved,461567,98701,29.99,362866
686180,Cat Girl,278,201,0.0,77
687870,CINEVR,17,39,0.0,-22
434460,Rock of Ages 2: Bigger & Boulder™,2414,423,14.99,1991
594950,The Witches' Tea Party,90,2,7.99,88
380600,Fishing Planet,30666,5663,0.0,25003
618720,1bitHeart,618,52,2.99,566
689580,TurnSignal,537,53,0.0,484
673600,Prison Boss VR,192,22,19.99,170
584400,Sonic Mania,19404,1415,19.99,17989
407530,ARK: Survival Of The Fittest,6112,3554,0.0,2558
628110,NOBUNAGA'S AMBITION: Reppuden with Power Up Kit,28,10,19.99,18
475090,Project Remedium,46,87,14.99,-41
628040,Romance of the Three Kingdoms VIII with Power Up Kit,66,26,19.99,40
655550,NOKBAK,237,85,0.0,152
473690,Absolver,9542,3897,29.99,5645
610190,WARRIORS ALL-STARS,459,163,59.99,296
628150,Sangokushi Eiketsuden,38,11,12.99,27
377060,On a Roll,240,142,19.99,98
696460,Pixel Traffic: Circle Rush,95,25,3.99,70
587100,Ys SEVEN,587,45,24.99,542
676770,Island Dash,420,81,0.0,339
462640,Surf World Series,29,11,14.99,18
658620,Wonderful Everyday Down the Rabbit-Hole,1007,50,29.99,957
408410,X-Morph: Defense,2583,233,19.99,2350
613210,BlobCat,54,4,9.99,50
490490,Blasters of the Universe,203,29,1.49,174
580910,idleBeer,12,31,0.99,-19
661670,Renegade Grounds: Episode 1,7,5,4.99,2
622060,XOXO Droplets,183,58,0.0,125
544610,Battlestar Galactica Deadlock,1996,333,39.99,1663
554620,Life is Strange: Before the Storm,33143,2447,16.99,30696
696990,Fear For Freedom,79,81,0.0,-2
656610,Red Wake Carnage,117,130,0.99,-13
629430,The Last Birdling,55,1,5.99,54
693250,Panda Run,66,40,1.99,26
614250,Carrier,30,7,0.0,23
629770,Tiny Echo,489,74,14.99,415
596940,Hide and Seek,146,220,0.0,-74
673750,Super Bunny Man,2936,430,15.99,2506
662190,The Secret Order 6: Bloodline,145,12,9.99,133
670080,SuperLuminauts,3,6,4.99,-3
678560,鸿源战纪 - Tales of Hongyuan,364,95,14.99,269
619310,Ways of History,113,115,0.0,-2
367080,Songbringer,192,53,19.99,139
431700,Age of Fear 3: The Legend,154,11,14.99,143
679860,ZAP Master,20,18,0.99,2
689400,Madu Maths,118,23,0.0,95
644390,D&D Lords of Waterdeep,1166,80,9.99,1086
454910,Twin Saga,595,239,0.0,356
625430,Doodle God Blitz,465,226,0.0,239
591390,a nifty game,2,0,6.99,2
241300,Card City Nights 2,137,23,7.99,114
679430,Skyraine,27,11,1.99,16
370800,Fields of Battle,125,53,0.0,72
675950,Peninsular War Battles,15,15,9.99,0
558490,Crossroad Mysteries: The Broken Deal,67,25,9.99,42
646470,Alicia Quatermain: Secrets Of The Lost Treasures,108,17,2.99,91
603360,CryptoMoneya,95,53,0.99,42
671550,Brickochet,84,2,2.99,82
646310,ProjectM : Daydream,63,25,4.99,38
610960,红石遗迹 - Red Obsidian Remnant,682,128,8.99,554
672730,Find You,359,18,0.0,341
635410,The Adventurer and His Backpack,55,15,0.89,40
637960,ProjectM : Dream,61,10,0.0,51
699550,Forest Guardian,25,51,16.99,-26
667760,Super Lumi Live,30,0,5.99,30
328590,Don't Knock Twice,331,125,19.99,206
251950,WWII Online,1538,1703,0.0,-165
664290,The Mexican Dream,76,45,6.99,31
687320,MINE!,10,5,0.0,5
610310,Star Story: The Horizon Escape,149,30,14.99,119
704680,AMPLITUDE: A Visual Novel,37,12,10.99,25
705390,Aya's Journey,10,19,0.59,-9
704210,BLOCK WARRIORS: Classic Edition,318,325,0.99,-7
657630,Fidget Spinner,527,118,0.99,409
701460,Billiards,14,11,4.99,3
650750,HYPERNOVA: Escape from Hadea,60,13,11.99,47
701100,Amoreon NightClub,49,15,0.0,34
466660,Stash,437,213,0.0,224
543100,Beat The Game,116,47,4.99,69
603530,A Robot Named Fight!,622,79,12.99,543
562810,MONOPOLY® PLUS,4995,6623,14.99,-1628
570770,古剑奇谭二(GuJian2),1802,518,15.99,1284
570780,古剑奇谭(GuJian),3461,862,11.99,2599
687260,Tokyo Dark,1003,161,17.99,842
660520,The IOTA Project,61,22,0.0,39
613450,Please Knock on My Door,210,13,12.99,197
696560,Bouncing Duck Simulator,101,14,4.99,87
691930,MSI Electric City: Core Assault,66,7,0.0,59
703940,Ball 2D: Soccer Online,214,69,0.0,145
640990,Fashioning Little Miss Lonesome,248,45,24.99,203
680450,DAMN!,5,2,1.99,3
550590,Archaica: The Path of Light,209,16,14.99,193
385410,The Journey: Bob's Story,16,11,3.99,5
701720,2D Neon Cube,115,63,3.99,52
542400,Pixel Gladiator,278,59,4.99,219
702200,Lost with Dinosaurs,45,64,0.51,-19
691730,FPV Drone Simulator,217,107,0.0,110
694980,Fjong,61,25,1.99,36
696490,TOTOBALL,38,9,0.99,29
685310,Transport Defender,306,80,0.0,226
623920,Chicago 1930 : The Prohibition,76,38,0.54,38
696020,Surface: Game of Gods Collector's Edition,5,0,9.99,5
661960,Dragon Lords: 3D Strategy,80,30,0.0,50
571340,Seeking Evil: The Wendigo,35,29,4.99,6
656070,Better Off Tread,54,33,0.0,21
607880,Accel World VS. Sword Art Online Deluxe Edition,756,250,7.49,506
529920,Resurgence,13,8,1.99,5
537740,Dino Dini's Kick Off™ Revival - Steam Edition,32,29,9.99,3
587790,Deadly Animal Duel,8,34,1.99,-26
670900,NASCAR Heat 2,244,129,12.99,115
286000,Tooth and Tail,3005,754,19.99,2251
529840,Brawl of Ages,535,243,0.0,292
556480,Rugby League Live 4,83,36,49.99,47
669580,The Ultimatest Battle,410,106,0.0,304
464360,3030 Deathwar Redux - A Space Odyssey,1002,59,14.99,943
568930,The Land of Pain,361,119,9.99,242
658790,Samurai Riot Definitive Edition,56,13,11.99,43
592580,PRO EVOLUTION SOCCER 2018,2513,1543,0.0,970
704190,Bitcoin Collector,81,65,0.99,16
404530,Voxel Turf,426,63,7.99,363
386620,"Cook, Serve, Delicious! 2!!",2358,285,12.99,2073
701930,Short Stories Collection of Class Tangerine,790,23,7.99,767
517720,Epic Tavern,194,103,24.99,91
673060,Floor Plan: Hands-On Edition,81,7,5.99,74
696400,NeoBoom,24,43,0.59,-19
555150,The First Tree,3661,1169,9.99,2492
623940,HIVESWAP: ACT 1,3522,263,7.99,3259
672970,Swords and Sandals Medieval,27,10,6.99,17
691540,Space Fighter,68,37,0.0,31
610120,Little Kite,106,15,6.99,91
357310,Oriental Empires,2207,537,29.99,1670
643810,Fugl,405,82,9.99,323
656120,Fantasya Final Definitiva REMAKE,100,6,0.0,94
503580,Duck Season,1003,192,19.99,811
689090,Microtransaction Simulator,692,106,0.0,586
435150,Divinity: Original Sin 2 - Definitive Edition,141779,5852,44.99,135927
575060,Nemo_D.O,9,2,3.99,7
623090,BAJA: Edge of Control HD,249,68,29.99,181
614570,Dishonored®: Death of the Outsider™,8053,1139,29.99,6914
631920,Somewhere on Zibylon,20,8,4.49,12
556820,Warbands: Bushido,795,346,0.0,449
703500,ReThink | Evolved,53,5,9.99,48
707400,Attack Of Insects,63,18,9.99,45
706320,Trivia Vault: Mini Mixed Trivia,35,29,0.99,6
693810,Treasure At The Top,13,7,0.0,6
670490,Rise of Man,27,113,9.99,-86
636960,Wo Yao Da  我要大,169,30,2.99,139
689830,DUELEUM,11,7,0.0,4
703430,Star Rangers VR - Free Demo,14,10,0.0,4
700440,Jellyfish,27,22,0.99,5
671310,Pararea--Social VR for Everyone (Beta),21,15,0.0,6
621830,WRC 7 FIA World Rally Championship,3503,1134,19.99,2369
613390,DUNGEONS OF CHAOS,142,17,8.99,125
640890,Will Glow the Wisp,204,33,2.99,171
690930,Evening Surprise,556,68,0.0,488
619430,World of Castles,64,82,29.99,-18
672650,MONITOR: The Game,53,10,0.0,43
629960,夏花的轨迹——A summer promise to forever,222,68,1.99,154
664090,Eternity Warriors™ VR,255,56,11.24,199
681750,Voxelaxy [Remastered],33,19,0.99,14
698740,Loot'N Shoot,79,43,0.0,36
654610,Mr. Dubstep,88,45,10.99,43
521590,Subterra,68,35,4.99,33
550470,NosTale - Anime MMORPG,1824,751,0.0,1073
684270,Silicon Zeroes,203,22,14.99,181
601790,Eternal Lore,32,9,9.99,23
493840,Marvel vs. Capcom: Infinite,1422,863,39.99,559
702150,Project Mercury,274,194,0.99,80
674520,Fight'N Rage,2101,179,19.99,1922
705750,American Patriots: Boston Tea Party,67,9,0.99,58
610380,Ratty Catty,540,298,3.74,242
681240,Dujanah,186,16,6.99,170
657690,The Caribbean Sail,372,21,14.99,351
566160,Zup! 6,2006,113,0.99,1893
705070,FEMINAZI: 3000,38,40,1.99,-2
619880,ATOMEGA,1033,300,9.99,733
551770,ECHO,1112,291,24.99,821
465240,Serious Sam VR: The Last Hope,1103,196,9.99,907
398810,openCanvas 7,359,95,59.99,264
686190,Killing Time,886,305,0.0,581
287220,Autocraft,166,130,9.99,36
668630,Tricolour Lovestory,21680,3007,1.99,18673
661740,Morphite,70,29,14.99,41
599510,SpaceDweller,14,11,0.99,3
668210,Super Fancy Pants Adventure,1186,118,9.99,1068
675940,SpaceShot,156,45,0.99,111
604040,Legion Tale,10,3,4.99,7
628800,Super Hydorah,159,14,19.99,145
559910,Terroir,265,94,7.99,171
639300,Age of Gladiators II: Death League,57,28,12.99,29
699240,Keyboard Killers,183,189,0.0,-6
440650,Niche - a genetics survival game,3806,572,17.99,3234
689910,Another Lost Phone: Laura's Story,621,50,2.99,571
687280,The Awakening,28,27,0.0,1
378860,Project CARS 2,13755,3336,59.99,10419
702210,Princess Serena ~Raid of Demon Legion~,98,37,1.99,61
579760,The Journey Down: Chapter Three,384,36,14.99,348
268130,Heat Signature,6007,328,14.99,5679
709800,Hardcore ZBoy,21,43,0.99,-22
553210,"Warhammer 40,000: Space Wolf",773,396,17.99,377
593620,The Last Conflict,160,60,0.0,100
680780,DEATH TRAIN - Warning: Unsafe VR Experience,18,14,9.99,4
521790,Ancient Frontier,79,39,24.99,40
689900,Darkestville Castle,408,26,14.99,382
386100,Pylon: Rogue,16,7,14.99,9
458680,Auto Age: Standoff,74,37,0.0,37
699160,A Plot Story,21,42,4.99,-21
679770,Dr. Cares - Pet Rescue 911,56,4,12.99,52
299400,XING: The Land Beyond,247,26,19.99,221
600090,The Coma: Recut,1238,224,5.99,1014
711560,Stone Flower,34,31,0.51,3
553470,Destination Ares,12,10,9.99,2
571310,SteamWorld Dig 2,4794,205,4.99,4589
708680,Octopus Bar,107,11,0.0,96
706380,LOGistICAL: Norway,3,1,6.99,2
537020,Legions of Tyrandel,4,1,9.99,3
461350,The King's Heroes,19,9,9.99,10
640590,The LEGO® NINJAGO® Movie Video Game,4491,758,19.99,3733
493540,Figment,1256,197,19.99,1059
436180,Spacelords,1637,1503,0.0,134
705300,Suicide Adventures,28,27,1.99,1
710780,Sky Jump,178,61,0.99,117
682970,MineFight,45,107,0.0,-62
447920,Drift (Over) Drive,18,24,1.99,-6
704690,Elisa: Seduce the Innkeeper,129,49,4.99,80
657050,Humanity Must Perish,169,34,0.0,135
567640,Danganronpa V3: Killing Harmony,12933,2135,39.99,10798
713650,Sevgilim Olur musun ?,497,226,0.0,271
642390,Blocksworld,457,287,0.0,170
709670,Clarent Saga: Tactics,41,4,0.0,37
686900,Bronze Age - HD Edition,184,65,2.99,119
464060,RUINER,9051,993,19.99,8058
477910,Wanderer of Teandria,10,0,4.99,10
448930,About Elise,99,29,0.0,70
598840,Ninja Shodown,16,11,1.49,5
617160,Home Sweet Home,2628,373,16.99,2255
658980,Valnir Rok Survival RPG,445,483,9.99,-38
712380,Temple Escape,48,9,3.99,39
414740,RAID: World War II,1027,956,19.99,71
658260,BLUE REFLECTION,864,166,59.99,698
442120,Pinball FX3,3380,467,0.0,2913
257030,Project Nimbus: Complete Edition,1217,192,6.99,1025
700920,Placement,26,8,0.0,18
696940,DreamWorks Voltron VR Chronicles,44,16,9.99,28
622470,Road Dogs,68,66,0.0,2
676910,Magic Potion Destroyer,23,5,9.99,18
404680,Hob,3891,476,19.99,3415
715090,Rescue Team 4,24,4,3.99,20
577940,Killer Instinct,3186,283,39.99,2903
595560,Legend of Hand,71,4,6.99,67
681290,Hare,11,1,0.99,10
624270,The Painscreek Killings,2459,268,19.99,2191
646100,Woodlands,96,216,5.99,-120
697610,Idle Bouncer,299,43,0.0,256
432950,Orange Moon,68,34,9.99,34
600430,Ticket to Ride: First Journey,183,95,4.99,88
593670,Sponchies,40,5,0.0,35
713680,Ablepsia,95,77,0.49,18
499140,Operator Overload,18,2,9.99,16
594570,Total War: WARHAMMER II,107577,8177,59.99,99400
695110,Twickles,88,7,0.69,81
674940,Stick Fight: The Game,91539,6124,4.99,85415
683900,RollerCoaster Tycoon® Classic,1380,168,19.99,1212
671260,GOKEN,54,24,14.99,30
544630,River City Melee : Battle Royal Special,56,57,2.99,-1
714570,Hidden Object - Tools,3,2,1.99,1
629690,Vaporum,674,101,19.99,573
684530,Lance A Lot: Enhanced Edition,70,2,7.99,68
633950,Fall of Light: Darkest Edition,161,125,2.99,36
268910,Cuphead,107896,3869,19.99,104027
696590,XXZ: XXL,152,40,5.99,112
692920,XXZ,463,172,0.0,291
595280,Throne of Lies®: Medieval Politics,2095,607,0.0,1488
715980,Eared Hero,42,101,0.49,-59
665120,Jetman Go,141,35,1.99,106
598170,Super,20,16,0.0,4
700480,Microsoft Allegiance,112,34,0.0,78
695980,Labyrinths of the World: Forbidden Muse Collector's Edition,8,3,9.99,5
713530,ARMORED KITTEN,252,56,2.49,196
685050,Spartan,17,4,0.99,13
704040,Castle Clicker : Building Tycoon,412,200,0.0,212
712790,Crimson Memories,51,21,0.0,30
691150,Saku Saku: Love Blooms with the Cherry Blossoms,228,21,19.99,207
696480,The Norwood Suite,819,124,9.99,695
696140,No Heroes Here,382,40,14.99,342
716850,Jewel of WonderLand,1,1,3.99,0
505630,Let Them Come,865,126,7.99,739
680980,HEADLINER,635,185,4.99,450
646200,Dead Effect 2 VR,924,211,24.99,713
707580,AFFECTED: The Manor - The Complete Edition,122,31,9.99,91
451020,Battle Chasers: Nightwar,5637,774,29.99,4863
679270,Antaria Online,220,117,0.0,103
654050,JYDGE,596,89,14.99,507
622010,The Fall of Lazarus,52,37,11.99,15
680340,Omega Strike,246,59,12.99,187
300380,Road Redemption,8496,1888,19.99,6608
696810,EMPYRE: Lords of the Sea Gates,9,4,29.99,5
437220,The Culling,10248,7697,0.0,2551
685680,Sakura Gamer,335,63,9.99,272
253230,A Hat in Time,43271,861,29.99,42410
583590,Arms Race - TCWE,46,19,14.99,27
656530,Pro Gamer Manager 2,26,143,19.99,-117
436320,Raw Data,1880,525,39.99,1355
634120,Inmates,155,103,9.99,52
656450,Alien Hallway 2,92,39,4.99,53
713260,Beyond the Sunset 斜阳下的彼岸,148,7,0.99,141
562250,Beastmancer,58,16,9.99,42
517780,Ogre,133,64,24.99,69
690060,SORE,187,101,0.0,86
713050,Vampires!,131,28,1.99,103
710030,Cinderella Escape 2 Revenge,313,38,14.99,275
632800,Beyond Eden,70,9,34.99,61
595420,Franchise Hockey Manager 4,94,52,19.99,42
339250,Winged Sakura: Endless Dream,16,7,9.99,9
678310,Pinball Deluxe: Reloaded,112,5,7.99,107
694370,Space Pilgrim Academy: Year 1,98,8,1.13,90
698780,Doki Doki Literature Club!,172656,6015,0.0,166641
593490,Empire Architect,115,56,14.99,59
715320,Legend of Egypt - Pharaohs Garden,1,0,9.99,1
457730,Mushroom Wars 2,563,324,14.99,239
402330,Press X to Not Die,3032,330,0.74,2702
384740,CAT Interstellar,721,287,4.99,434
717950,Rainbow Snake,132,43,1.99,89
665270,弹幕音乐绘 ～风雷幻奏曲～ / Barrage Musical  ~A Fantasy of Tempest~,315,11,9.99,304
715370,Fidget Spinner Editor,81,10,0.99,71
356190,Middle-earth™: Shadow of War™,67538,9880,49.99,57658
718330,Cubic,251,48,1.99,203
623170,Zombie Solitaire 2 Chapter 2,40,4,8.99,36
668170,Incline,226,222,0.0,4
722020,Bitcoin Collector: Spinners Attack,23,31,0.99,-8
570050,Raiden V: Director's Cut | 雷電 V Director's Cut | 雷電V:導演剪輯版,235,193,29.99,42
582560,The Invisible Hours,417,25,29.99,392
657470,Take Off - The Flight Simulator,50,52,8.99,-2
656880,Cybercube,139,33,10.99,106
673940,Dragon Glory,35,45,0.0,-10
485390,Machine Made: Rebirth,100,26,4.99,74
692530,Community Garden,2,8,9.99,-6
716600,Premier Buggy Racing Tour,10,29,0.99,-19
614090,Deadbeat Heroes,55,28,14.99,27
712050,Otaku's Fantasy,2657,350,0.0,2307
663380,Tales from Candlekeep: Tomb of Annihilation,1356,591,0.0,765
671390,Metropolis: Lux Obscura,327,86,7.99,241
710640,PRO DRIFT RELOADED 2020,7,15,0.0,-8
715510,Run Zeus Run,838,111,0.0,727
722250,Feeding The Monster,58,29,0.49,29
715840,PooSky,51,30,4.99,21
705020,Bottom of the 9th,39,8,0.99,31
695630,Chinese Paladin：Sword and Fairy,843,910,4.99,-67
508200,Bacon Tales - Between Pigs and Wolves,21,13,1.99,8
632050,The Village,42,41,0.49,1
418650,Space Pirate Trainer,2574,149,14.99,2425
642090,Coming Out on Top,1116,50,14.99,1066
595960,Pinball Wicked,142,20,9.99,122
601430,The Evil Within 2,20269,1665,39.99,18604
602430,Yono and the Celestial Elephants,182,24,14.99,158
686680,Computer Tycoon,682,125,19.99,557
660160,Field of Glory II,598,76,29.99,522
433530,Heliborne Collection,2671,927,29.99,1744
713540,Neptunian Donut,101,15,0.0,86
715010,Diamo XL,418,27,0.99,391
700170,Deserving Life,96,20,0.0,76
493900,Dungeons 3,15764,904,29.99,14860
663160,Pocket Universe : Create Your Community,6,8,19.99,-2
664320,Holy Potatoes! What the Hell?!,60,60,0.69,0
723790,The Pirate: Plague of the Dead,388,115,0.0,273
567690,Songs of Araiah: Re-Mastered Edition,1,3,0.0,-2
451340,Gold Rush: The Game,8654,3415,9.99,5239
636460,Rugby League Team Manager 2018,36,11,39.99,25
694180,MobileZombie,16,9,0.0,7
717190,Super Dungeon Master Ace RPG,35,10,0.0,25
663090,Granado Espada,594,396,0.0,198
709820,Wasted Pizza,45,82,0.99,-37
726070,Hidden Object - Sweet Home,33,88,2.99,-55
488790,South Park™: The Fractured But Whole™,14989,3342,49.99,11647
410830,ARENA GODS®,93,21,14.99,72
25000,Overgrowth,5467,1561,19.99,3906
722730,Cogmind,1210,47,19.99,1163
678800,SAS: Zombie Assault 4,5714,964,0.0,4750
704510,Mercury Fallen,147,26,19.99,121
342190,Skyworld,191,45,4.99,146
581310,Riskers,34,39,4.99,-5
552440,The Talos Principle VR,589,119,39.99,470
725680,Golf 2D,36,36,1.99,0
628120,NOBUNAGA'S AMBITION: Ranseiki with Power Up Kit,25,12,19.99,13
529490,Rogue Trooper Redux,224,62,24.99,162
718320,FoxyLand,105,54,2.99,51
556260,Gil's Lucid Dreams,19,10,0.99,9
291550,Brawlhalla,246362,46611,0.0,199751
457590,Luna Online: Reborn,249,155,0.0,94
612100,These nights in Cairo,225,18,7.99,207
411300,ELEX,12710,4334,29.99,8376
628170,Uncharted Waters II,62,22,12.99,40
575890,Katy and Bob Way Back Home,71,18,4.99,53
628050,Romance of the Three Kingdoms IX with Power Up Kit,291,55,29.99,236
664430,WWE 2K18,1155,1004,0.0,151
674440,Skipper - Puzzle Across The Sea,44,5,3.99,39
709920,Tametsi,624,19,2.99,605
610180,The Jackbox Party Pack 4,2304,126,24.99,2178
726060,CAR THIEF SIMULATOR 2017,1,11,9.99,-10
679400,Relik,139,30,0.0,109
715310,Urban Rivals,287,170,0.0,117
526140,The Gallery - Episode 2: Heart of the Emberstone,317,60,3.74,257
733810,Clutter VI: Leigh's Story,4,0,9.99,4
676430,PUSH,499,73,0.99,426
679500,Campfire Cooking,40,0,5.99,40
626010,Office Space: Idle Profits,193,128,0.0,65
659630,Tiny Toyfare,26,11,0.0,15
620940,Invisibox,53,5,0.99,48
650440,Warbanners,351,137,9.99,214
622370,Freaky Awesome,124,98,9.99,26
722680,BLOK DROP NEO,43,18,2.99,25
578720,A Mortician's Tale,764,351,9.99,413
610840,JASEM: Just Another Shooter with Electronic Music,111,41,9.99,70
358920,Star Control I and II,83,22,3.99,61
537800,Bomber Crew,9768,1350,3.99,8418
358930,Star Control III,12,10,3.99,2
712840,King Exit,6408,312,0.0,6096
480430,Hide and Shriek,3609,731,0.0,2878
678970,Modern Tales: Age of Invention,184,19,9.99,165
476540,Google Spotlight Stories: Pearl,332,14,0.0,318
726230,The Superlatives: Aetherfall,22,2,5.99,20
720670,Cats Make You Smarter!,144,12,0.0,132
723510,The Cave VR,3,4,1.99,-1
573600,Think of the Children,114,89,9.99,25
513330,Party Tycoon,157,136,4.99,21
720240,Legend of Fainn Dynasty ～Battles of Beautiful Warlords～,89,32,3.99,57
613470,The Inner World - The Last Wind Monk,265,29,19.99,236
573680,Real Farm,120,171,0.0,-51
669050,Mutiny!!,219,29,9.99,190
611750,Welcome to Hanwell,136,128,14.99,8
729660,Blackout Z: Slaughterhouse Edition,1341,249,0.99,1092
719430,Taima Miko Yuugi,595,55,0.0,540
556780,Neptune: Arena FPS,45,18,2.99,27
722670,Chinese Chess/ Elephant Game: 象棋/ 中国象棋/ 中國象棋,163,47,9.99,116
658160,ClickRaid,233,55,4.99,178
661830,Lunarsea,45,15,0.0,30
672680,Call of War: World War 2,2518,1186,0.0,1332
703270,"Run, my little pixel",10,13,0.59,-3
711390,Anti Gravity Warriors VR,8,12,0.0,-4
729330,The Girl on the Train,46,57,0.0,-11
681620,Cube Link,69,25,4.99,44
545830,Princess of Tavern Collector's Edition,33,14,9.99,19
673000,High Hell,1100,159,9.99,941
604500,Tank Force,1123,687,0.0,436
676340,Undarkened,9,3,4.99,6
721090,SKYBOX VR Video Player,420,139,0.0,281
618070,Jet Buster,35,2,9.99,33
588080,Numantia,25,6,9.99,19
636570,Nights of Azure 2: Bride of the New Moon,250,77,59.99,173
723090,Meltys Quest,446,10,19.99,436
630310,The Mummy Demastered,381,90,19.99,291
625980,Yomawari: Midnight Shadows,545,27,19.99,518
725960,Ballistic Mini Golf,45,38,4.99,7
673430,Mahjong Magic Islands,51,22,0.0,29
716340,Blackberry Honey,429,11,12.99,418
734120,Bonbon,127,54,2.99,73
583060,The Cavern,7,8,12.99,-1
566380,Speedball Arena,30,9,9.99,21
701290,Legendary Mahjong,27,5,5.99,22
714970,Metonymy,29,27,0.0,2
716630,Battlevoid: Sector Siege,88,72,9.99,16
331870,AER Memories of Old,4805,786,1.49,4019
645690,Fantasia of the Wind - 风之幻想曲,341,47,3.99,294
685420,Grace of Zordan,86,70,0.0,16
691450,Misao: Definitive Edition,1348,44,4.99,1304
727020,Arcade Moonlander,895,73,0.99,822
709450,Towards The Pantheon: Escaping Eternity,107,11,0.0,96
727730,Shiver,260,32,0.0,228
716260,Guns'n'Stories: Preface VR,219,43,0.0,176
680170,VR Triber,7,14,0.0,-7
335430,Grimoire: Manastorm,695,322,0.0,373
726390,Scream Collector,567,88,0.0,479
742150,Heart of the House,50,2,5.99,48
582160,Assassin's Creed® Origins,69262,10761,59.99,58501
497800,Golden Krone Hotel,232,13,9.99,219
712730,SIMULACRA,2985,296,4.99,2689
612510,The Far Frontier,33,17,2.99,16
741320,The Song of Terminus  終焉的迴響:護界者之歌,34,33,0.0,1
723890,Don't Make Love,335,62,0.0,273
612880,Wolfenstein II: The New Colossus,26618,7024,39.99,19594
729580,Malzbie's Pinball Collection,109,29,0.0,80
729530,Legends of Talia: Arcadia,157,50,1.99,107
603060,Tarim: Guardians,52,16,0.49,36
730030,Ultimate Spinner Simulator - Unstress Yourself,24,8,0.99,16
627450,RUGBY 18,48,49,19.99,-1
607890,Sword Art Online: Hollow Realization Deluxe Edition,5538,1342,49.99,4196
541200,GTTOD: Get To The Orange Door,2018,251,14.99,1767
705210,Cube Racer,693,74,0.0,619
731180,Coffee Run,85,26,0.0,59
727510,Void Memory,125,62,14.99,63
608510,You Must be 18 or Older to Enter,151,30,0.0,121
661280,Dresden Files Cooperative Card Game,82,20,16.99,62
718220,NeoBoom2,24,30,0.99,-6
714580,Google Spotlight Stories: Son of Jaguar,77,15,0.0,62
675010,MudRunner,22300,2526,19.99,19774
355180,Codename CURE,13484,2492,0.0,10992
745760,Perceptions of the Dead,292,26,0.0,266
412360,SightLineVR,33,4,0.0,29
725340,Lines X Free,1300,104,0.0,1196
735280,EMERGENCY 20,1021,220,29.99,801
676630,Attentat 1942,297,17,10.99,280
724740,Lines X,613,134,0.99,479
427700,Zwei: The Ilvard Insurrection,482,29,19.99,453
624710,Cow Milking Simulator,33,2,2.99,31
707590,Defense Clicker,90,40,0.0,50
393220,Super Man Or Monster,87,10,12.99,77
529520,Mutant Football League,624,42,14.99,582
718200,Forever Home,144,12,0.99,132
685240,Paradiddle,239,23,9.99,216
627910,Bubsy: The Woolies Strike Back,97,76,4.99,21
718370,LSD,143,123,0.59,20
728990,Pixel Car,36,38,0.99,-2
731910,JumpSky,59,54,0.0,5
729670,LSD: Wanderlust (Lo-fi Edition),38,50,4.99,-12
635940,Little Busters! English Edition,643,9,34.99,634
592990,ChemCaper™: Act I - Petticles in Peril,3,4,19.99,-1
641780,The Drone Racing League Simulator,2471,467,9.99,2004
724640,AuroraBound Deluxe,21,1,4.99,20
730280,Protect your planet,14,18,0.49,-4
711990,Elise the Devil,2072,157,0.0,1915
732670,Dyana Moto,6,13,0.99,-7
729300,Cleansuit,39,0,3.99,39
727530,Expelled,49,28,0.99,21
658570,FURIDASHI: Drift Cyber Sport,999,212,17.99,787
476620,Call of Duty®: WWII,11394,8523,59.99,2871
687540,Tasty Planet,134,28,5.99,106
326360,Warspear Online,1566,477,0.0,1089
730090,Travel VR,14,22,0.0,-8
725980,Path Out,152,9,0.0,143
726340,Alchemist's Castle,51,10,0.99,41
649900,Mini Guns - Omega Wars,253,153,0.0,100
725510,Merper VR,32,4,0.0,28
726630,Mare Nostrvm,24,2,19.99,22
720280,Fox Hime,3201,518,1.99,2683
744520,NEKO-NIN exHeart +PLUS Nachi,232,14,1.99,218
718500,Derpy Dinos,48,13,0.0,35
476600,Call of Duty®: WWII,21294,11381,59.99,9913
703700,Our End of the World,3262,833,9.99,2429
723610,Dream Golf VR,90,26,0.0,64
718080,Artifact Quest 2 - Match 3 Puzzle,27,6,6.99,21
718730,One Strike,59,1,4.99,58
525480,.hack//G.U. Last Recode,2498,357,7.49,2141
716380,The Chemist,56,43,11.99,13
613730,Need For Drink,739,256,0.99,483
629540,Alien Arena: Warriors Of Mars,110,32,0.0,78
725380,Maddening Euphoria,7,0,0.99,7
705410,World War Party: Game Of Trump,17,17,0.0,0
705120,Death Coming/死神来了,2838,304,6.99,2534
546220,Red Comrades 3: Return of Alaska. Reloaded,249,58,4.99,191
637100,Sonic Forces,3761,2306,39.99,1455
488480,SpaceRoads,10,7,2.99,3
252470,Space Pirates And Zombies 2,2120,560,19.99,1560
485510,Nioh: Complete Edition,23944,5778,49.99,18166
493080,Card Quest,245,33,9.99,212
456670,Hand of Fate 2,4359,734,7.49,3625
498740,Way of Redemption,33,13,6.99,20
732430,Superflight,9612,347,2.99,9265
673260,Starblast,545,117,9.99,428
577970,Punch Planet - Early Access,150,7,19.99,143
712390,Team Four Star RPG,66,14,0.0,52
504370,Battlerite,49197,9097,0.0,40100
566430,Ultimus bellum,18,11,9.99,7
732290,Schatte ～The Witch and the Fake Shadow～ / 魔女と偽りの影,17,6,0.99,11
494670,TransRoad: USA,187,179,29.99,8
567670,Serious Sam 3 VR: BFE,422,70,39.99,352
655100,Oik 3,593,81,0.74,512
555050,Racket Fury: Table Tennis VR,232,47,19.99,185
624120,Football Manager Touch 2018,127,56,0.0,71
556860,Gladiator School,208,94,9.99,114
745850,KARAKARA2,557,33,9.99,524
649790,Harvest Life,124,122,14.99,2
733760,MegaRace 2,16,2,0.59,14
739410,Zorbit's Orbits,17,11,1.99,6
606710,Sphinx and the Cursed Mummy,401,30,14.99,371
735350,Bottle: Pilgrim Redux,148,46,1.99,102
691770,Eiyu*Senki – The World Conquest,612,67,29.99,545
659190,"Sorry, James",584,151,1.24,433
569570,Light Apprentice - The Comic Book RPG,47,7,9.99,40
488760,Left-Hand Path,105,19,29.99,86
670090,FallenCore,21,12,2.99,9
725280,Psi Project,59,77,0.49,-18
741360,VR Hybrid War 2117 - VR 混合战争 2117,4,1,0.0,3
570840,家有大貓 Nekojishi,3595,286,0.0,3309
690350,Endless Combat,53,16,0.0,37
683930,A Wonder,58,57,0.0,1
464340,Syberia 3,1773,1671,29.99,102
566970,EscapeVR: Trapped Above the Clouds,37,12,11.99,25
647830,LEGO® Marvel Super Heroes 2,5534,845,19.99,4689
745510,Fidget Spinner In Space,66,23,0.99,43
682810,GUTS,27,8,9.99,19
585900,Harvest Moon: Light of Hope Special Edition,795,235,19.99,560
686740,Haunted Dungeons: Hyakki Castle,14,10,13.99,4
696360,Chinese Paladin：Sword and Fairy 6,165,138,14.99,27
738470,God Of Thunder,66,3,0.0,63
618970,Outcast - Second Contact,555,142,14.99,413
690810,Killing Floor: Incursion,464,415,19.99,49
552910,Tokyo Tattoo Girls,19,25,9.99,-6
552990,World of Warships,84095,20197,0.0,63898
648550,Choice,16,4,0.99,12
666220,CS2D,7380,824,0.0,6556
657280,Rytmik Studio,202,32,29.99,170
576940,Hunt For Gods,60,34,0.0,26
740040,Play With Gilbert - Remake,100,12,6.74,88
739000,Grobda Remix,566,189,0.0,377
738290,SpaceCoaster VR,2,1,1.99,1
592600,PRO EVOLUTION SOCCER 2018 LITE,783,782,0.0,1
703180,Ben 10,192,61,24.99,131
745670,3D Tower,37,92,0.99,-55
601510,Yu-Gi-Oh! Duel Links,31355,6029,0.0,25326
642770,Vinyl Reality - DJ in VR,121,8,24.99,113
633460,Tannenberg,6998,1073,19.99,5925
678850,Uurnog Uurnlimited,77,21,9.99,56
612370,PAKO 2,287,16,5.99,271
530950,Tower 57,423,235,2.39,188
601770,Sparc,342,89,0.0,253
699780,Endless Fables 2: Frozen Path,148,12,14.99,136
590970,Hollow,110,170,19.99,-60
650860,Wrath of Loki VR Adventure,34,25,2.99,9
702110,THE LAST BLADE 2,218,19,9.99,199
743640,Achievement Clicker,1806,410,0.99,1396
748580,Bridge to Another World: The Others Collector's Edition,3,0,9.99,3
639490,Umineko When They Cry - Answer Arcs,640,26,29.99,614
443110,Armored Warfare,2296,1050,0.0,1246
618470,Qbik,89,6,0.54,83
750990,NEKO-NIN exHeart +PLUS Saiha,167,14,1.99,153
430210,Megaton Rainfall,1106,436,15.99,670
635260,CarX Drift Racing Online,44360,2186,14.99,42174
745880,Touhou Tenkuushou ~ Hidden Star in Four Seasons.,4393,63,14.99,4330
713320,Google Spotlight Stories: Sonaria,30,7,0.0,23
519890,Star Boss,10,3,0.99,7
452570,Battle Chef Brigade Deluxe,1971,68,19.99,1903
748480,Wild Romance: Mofu Mofu Edition,142,36,14.99,106
732950,Pairs,26,7,0.0,19
434030,Aerofly FS 2 Flight Simulator,1490,408,37.49,1082
537000,Nelo,91,34,4.99,57
552700,WORLD OF FINAL FANTASY®,2136,459,24.99,1677
608530,TARTARUS,109,96,19.99,13
749010,Yatzy,16,8,4.99,8
724350,King of the Couch: Zoovival,204,50,0.0,154
748270,VR Roller Coaster - Cave Depths,12,3,0.99,9
749340,Chocolate makes you happy,116,38,0.99,78
708340,Shark Simulator,365,58,0.0,307
702510,Mille Bornes,20,28,0.0,-8
662540,Haque,127,16,14.99,111
746620,Bakery,91,21,7.99,70
746360,Orblitz,8,3,0.99,5
732730,War Trigger 2,482,402,0.0,80
744570,Substance Painter 2018,173,31,0.0,142
691240,Going Nowhere: The Dream,20,4,3.99,16
725020,SoM Soul Of Mask,8,1,0.99,7
657320,Reverse Fantasy Legend,21,17,18.99,4
745740,Reflex,549,92,0.99,457
522470,The House of Da Vinci,3767,447,19.99,3320
733050,Lines Infinite,392,39,0.99,353
701730,Yi and the Thousand Moons,130,25,2.99,105
747340,Unforgiving - A Northern Hymn,1001,203,14.99,798
638110,Desert Bus VR,1328,180,0.0,1148
746280,Alpha Locus VR,24,4,0.0,20
722060,Dominions 5 - Warriors of the Faith,1701,102,39.99,1599
734910,Eternal Hour: Golden Hour,735,79,0.0,656
753990,Psi Project: Legacy,36,52,0.99,-16
692930,DreadEye VR,103,27,7.99,76
618710,Elminage ORIGINAL - Priestess of Darkness and The Ring of the Gods,49,6,9.99,43
749140,Prehistorik 2,39,6,9.99,33
754040,Piggy Poggy Pog,413,108,1.99,305
609150,STAR OCEAN™ - THE LAST HOPE -™ 4K & Full HD Remaster,873,356,20.99,517
694130,My Free Zoo,288,182,0.0,106
748610,Airport Madness 3D: Volume 2,121,29,19.99,92
727090,Village of Adventurers 2,155,55,0.0,100
500440,Take the Cake,6,4,4.99,2
598810,Carcassonne - Tiles & Tactics,1478,283,9.99,1195
721030,La Tale,235,182,0.0,53
752500,Ghoulboy - Dark Sword of Goblin,154,63,4.99,91
628890,NOBUNAGA'S AMBITION: Taishi,424,466,59.99,-42
667600,Sky Force Reloaded,1595,107,9.99,1488
718180,Super Dungeon Boy,164,40,0.99,124
491070,Shout Of Survival,3,2,4.99,1
705550,Burgle Bros.,26,5,3.99,21
746350,Air Combat Arena,31,26,0.99,5
749270,Magic Siege - Defender,49,40,4.99,9
704830,Esports Life: Ep.1 - Dreams of Glory,107,96,0.0,11
717790,Hold Your Own,297,171,14.99,126
686360,Dungeons & Treasure VR,51,15,19.99,36
603550,Schlag den Star - Das Spiel,27,43,9.99,-16
726250,Unknightly,160,52,19.99,108
512270,Home - A VR Spacewalk,231,89,0.0,142
650000,DOOM VFR,1388,1080,14.99,308
627270,Injustice™ 2,12599,2043,49.99,10556
747910,Disassembly 3D,209,54,29.99,155
747770,Super Shoot Owl,23,19,0.0,4
648780,It's Quiz Time,132,52,19.99,80
640050,Soldiers of the Universe,207,235,4.99,-28
669910,Miles & Kilo,54,2,0.79,52
368180,Polyball,758,346,14.99,412
573650,3 days: Zoo Mystery,12,16,4.99,-4
645820,Odysseus Kosmos and his Robot Quest (Complete Season),122,21,14.99,101
757030,Christmas Stories: A Christmas Carol Collector's Edition,38,0,9.99,38
718720,DEATHPIT 3000,27,7,3.99,20
590720,Cobalt WASD,152,28,0.0,124
730870,Burger Shop 2,207,6,6.99,201
665890,Jay Fighter: Remastered,156,55,0.0,101
572660,Nick,59,16,0.0,43
666330,Inertia,477,85,0.99,392
757450,Samurai of Hyuga Book 3,22,6,5.99,16
741670,Easy Red,767,184,3.99,583
740260,Crimson Imprint plus -Nonexistent Christmas-,1821,122,1.99,1699
745250,YAPP: Yet Another Puzzle Platformer,38,4,1.99,34
756260,Kingdom Defense,38,51,0.49,-13
471010,Seven: Enhanced Edition,1140,328,5.99,812
730840,Burger Shop,149,1,6.99,148
573340,Northern Tale 2,14,2,3.99,12
677210,Gift to Humanity: Alpha,12,11,2.99,1
674130,Bare Metal,65,15,0.0,50
761320,Black Jewel,76,13,1.99,63
634160,Cattails | Become a Cat!,1913,82,14.99,1831
463530,Empires of the Undergrowth,6149,336,19.99,5813
749870,MyTD 我的塔防,32,20,0.0,12
698980,sWORD MASTER,9,4,0.99,5
750770,Labyronia Elements,16,6,0.49,10
752910,Cookies vs. Claus,198,36,2.99,162
756440,Your Bunny Wrote,148,19,1.99,129
731920,Government Simulator,78,92,9.99,-14
741930,Hydroactive,3,8,1.99,-5
703980,Star Wars: Imperial Assault - Legends of the Alliance,122,20,0.0,102
740470,Echoed World,426,138,0.0,288
758580,Grim Tales: The Wishes Collector's Edition,14,2,9.99,12
741390,最強の囲碁 ～名人への道～ / Igo Meijin,2,1,79.99,1
738060,Freddy Fazbear's Pizzeria Simulator,19812,1257,0.0,18555
486460,Twilight Town,61,42,0.0,19
747310,Hyper Knights: Battles,47,32,4.99,15
607460,Epic Snails,283,26,0.0,257
737870,Conduct DELUXE!,117,20,9.99,97
628060,Romance of the Three Kingdoms X with Power Up Kit,339,69,29.99,270
746910,Chicken Farm 2K17,231,69,0.0,162
628130,NOBUNAGA'S AMBITION: Soutenroku with Power Up Kit,36,21,29.99,15
471550,Nine Parchments,2742,799,4.99,1943
730410,Music Band Manager,188,158,7.99,30
754120,Ninja Stealth 3,226,58,0.49,168
240720,Getting Over It with Bennett Foddy,42079,8756,7.99,33323
717640,Reigns: Her Majesty,887,152,2.99,735
576860,Summer Nightmare,248,222,0.0,26
736710,Yōdanji,24,6,4.99,18
726910,Star Wars: Droid Repair Bay,372,48,0.0,324
597840,Live Wallpaper Master,384,151,3.99,233
432940,Breakneck,97,28,9.99,69
573720,Viking Saga: Epic Adventure,18,4,4.99,14
735570,Project Rhombus,1254,102,0.79,1152
311290,SpellForce 3 Reforced,4840,1574,39.99,3266
688470,汉匈决战/Han Xiongnu Wars,2192,1558,6.99,634
558990,Opus Magnum,4666,123,19.99,4543
570420,X Rebirth VR Edition,139,105,39.99,34
427490,Shadowhand: RPG Card Game,567,111,14.99,456
639780,Deep Space Waifu: FLAT JUSTICE,1449,67,2.99,1382
483770,Autobahn Police Simulator 2,632,465,19.99,167
580040,Formata,510,241,9.99,269
758600,Christmas Stories: Hans Christian Andersen's Tin Soldier Collector's Edition,11,4,9.99,7
587260,Tokyo Xanadu eX+,1181,181,59.99,1000
756190,Sky Road,45,42,0.99,3
644200,Starlight of Aeons,255,52,3.49,203
388140,Strategic Command Classic: WWI,21,5,19.99,16
262810,Super Turbo Demon Busters!,89,73,11.99,16
758480,Ukrainian ball in search of gas,632,43,0.99,589
610560,Tales of the Lumminai,6,7,0.69,-1
521890,Hello Neighbor,7455,1873,29.99,5582
701440,Phantom Jump,42,5,0.0,37
704910,Tenta Shooter,126,9,9.99,117
550340,Umineko: Golden Fantasia,286,34,24.99,252
574070,Space Wars: Interstellar Empires,146,73,0.0,73
575090,Flame of Memory,21,11,0.0,10
712650,Azure Sky Project,16,6,0.0,10
733800,Frosty Nights,128,35,4.99,93
593530,Jelly in the sky,68,61,5.99,7
611660,Fallout 4 VR,4150,2450,59.99,1700
662230,Trendpoker 3D: Texas Hold'em Poker,57,24,9.99,33
576410,Nihilist Simulator,53,11,1.99,42
733990,I Can't Believe It's Not Gambling,1359,119,0.99,1240
702320,March of Empires,790,399,0.0,391
544550,Stationeers,3751,729,29.99,3022
740290,Irony Of Nightmare,494,58,0.99,436
285900,Gang Beasts,33003,7877,8.99,25126
757330,qop 2,361,19,0.99,342
587620,Okami HD,6355,481,19.99,5874
411970,TY the Tasmanian Tiger 2,564,21,14.99,543
723270,Rumu,443,41,9.99,402
736930,Delicious - Moms vs Dads,44,23,12.99,21
476420,Heart of Crown PC,418,100,24.99,318
661990,Arcana Heart 3 LOVEMAX SIXSTARS!!!!!! XTEND,197,42,29.99,155
584100,Mad Digger,111,51,4.99,60
658560,Zup! 7,1834,80,0.99,1754
606870,MetaMorph: Dungeon Creatures,48,36,6.99,12
758500,Loot Box Quest,374,25,0.99,349
652190,Emily Wants to Play Too,289,57,1.59,232
540190,Tetropunk,83,22,3.99,61
662320,METRO CONFLICT: THE ORIGIN,811,697,0.0,114
666860,Bit Heroes,2036,478,0.0,1558
760660,Retro Miami,14,39,0.99,-25
462240,Post Human W.A.R,93,19,14.99,74
605230,Grey Hack,825,96,19.99,729
557600,Gorogoa,11465,299,14.99,11166
733610,Tales of Winds: Tomb of the Sol Empire,132,27,0.0,105
740090,Lost Grimoires 3: The Forgotten Well,106,28,14.99,78
713460,Train Frontier Classic,145,25,9.99,120
759970,HIBIKAKEYIRONOKISEKI / 裂色的奇迹 / ひびかけ色のキセキ,301,32,0.0,269
738610,Train Station Simulator,145,99,16.99,46
686520,Gnomes Garden New home,37,4,0.49,33
734750,PickCrafter,4450,693,0.0,3757
337340,Finding Paradise,13596,290,9.99,13306
347950,Palace of Cards,116,60,0.0,56
700740,Teenage Mutant Ninja Turtles: Portal Power,45,27,9.99,18
763930,Tally Ho,79,3,6.99,76
723100,Orbital Racer,32,28,1.49,4
754530,IL-2 Sturmovik: Cliffs of Dover Blitz Edition,910,390,9.99,520
763360,Nice Way,73,27,0.99,46
745960,A Sky Full of Stars 仰望夜空的星辰,657,26,17.99,631
606370,Romancing SaGa 2™,135,73,24.99,62
520600,Purrfect Date - Visual Novel/Dating Simulator,272,166,9.99,106
703950,Just Fishing,691,233,0.0,458
649640,Ashes Cricket,341,79,24.99,262
722230,L.A. Noire: The VR Case Files,466,378,14.99,88
683280,Omega Quintet,121,37,29.99,84
764010,Insane Cold: Back to the Ice Age,47,42,1.99,5
750850,The Dream Collector,56,8,1.99,48
751590,Dinosaurs A Prehistoric Adventure,86,113,0.0,-27
517160,Richie's Plank Experience,452,105,14.99,347
593740,Dragon Climax,28,3,3.99,25
765900,Leisure Suit Larry - Magna Cum Laude Uncut and Uncensored,299,93,5.99,206
765860,Leisure Suit Larry 5 - Passionate Patti Does a Little Undercover Work,19,12,4.99,7
500710,Wild Terra Online,1013,649,0.0,364
767690,Heart of the Emberstone: Coliseum,57,7,0.0,50
554660,Puzzle Poker,30,5,2.99,25
763970,Leisure Suit Larry 1 - In the Land of the Lounge Lizards,129,41,3.99,88
715580,Hoshizora no Memoria -Wish upon a Shooting Star-,178,5,19.99,173
765910,Leisure Suit Larry 6 - Shape Up Or Slip Out,44,12,4.99,32
756600,Trianga's Project: Battle Splash 2.0,65,8,9.99,57
765840,Leisure Suit Larry 2 - Looking For Love (In Several Wrong Places),38,18,3.99,20
733070,Sudoku Universe / 数独宇宙,1843,86,1.99,1757
727310,Major League Gladiators,22,6,0.0,16
529890,Maniac Mansion,106,17,5.99,89
564230,Fire Pro Wrestling World,2381,300,29.99,2081
757040,Desert Golfing,72,1,1.99,71
764560,Chocolate makes you happy 2,80,29,0.99,51
757200,EMERGENCY 3,95,27,9.99,68
723780,Modern Combat Versus,4356,2339,0.0,2017
583090,SeaBed,291,13,13.39,278
763410,Long Live Santa!,2567,358,0.0,2209
726990,Succubus Rem,839,96,0.0,743
719640,War Planet Online: Global Conquest,413,250,0.0,163
658320,Oldage,201,93,0.0,108
713840,Goblin Storm,5,4,11.99,1
741400,Wands,40,31,19.99,9
426050,LEGIE,66,5,1.99,61
701870,Swarm Queen,123,16,7.49,107
694500,Army Men RTS,559,85,5.99,474
661050,Quadrablaze,5,2,4.99,3
684410,Bridge Constructor Portal,3767,340,1.99,3427
295950,新流星搜劍錄,691,409,0.0,282
549160,Army Men,66,19,5.99,47
765770,Forest Legends: The Call of Love Collector's Edition,59,12,9.99,47
765690,Dark Strokes: The Legend of the Snow Kingdom Collector’s Edition,89,5,8.99,84
654260,旧手表 - Old Watch,536,93,9.99,443
759610,House of Evil,32,62,3.99,-30
756700,Neon Seoul: Outrun,31,6,11.99,25
703310,Hidden & Dangerous: Action Pack,64,20,5.99,44
672230,I fell from Grace,50,18,7.99,32
549170,Army Men II,68,37,5.99,31
703320,Hidden & Dangerous 2: Courage Under Fire,511,24,9.99,487
578080,PUBG: BATTLEGROUNDS,1154655,895978,0.0,258677
764430,The Legend of Bean,36,21,2.99,15
763230,Fruity Smoothie,175,24,0.0,151
724970,神舞幻想 Faith of Danschant,2687,1732,29.99,955
758990,Ancient Warfare 3,1702,105,9.99,1597
759940,前程似锦 Excellent Expectations,753,108,2.99,645
751500,TINY METAL,177,71,24.99,106
534220,Dragon's Sin,313,154,0.0,159
523740,Techwars: Global Conflict,207,90,0.0,117
541300,Survive the Nights,2095,1211,24.99,884
678920,Symploke: Legend of Gustavo Bueno (Chapter 2),14,1,1.99,13
741590,Hex Commander: Fantasy Heroes,187,60,0.0,127
677280,Sigi - A Fart for Melusina,94,13,4.99,81
583930,Faerie Solitaire Remastered,418,56,14.99,362
703510,Wooden Battles,293,93,9.99,200
743370,Soccer Manager 2018,298,137,0.0,161
765890,Leisure Suit Larry 7 - Love for Sail,121,20,5.99,101
509920,Doc Apocalypse,10,6,0.99,4
763650,Comets Wake,21,7,0.0,14
347600,Total Miner,429,141,2.99,288
756880,NVL,237,103,1.99,134
394120,Atom Universe,167,264,0.0,-97
768300,Zhulik.exe,56,20,0.99,36
765640,Change,349,28,4.99,321
734550,Wheel Riders Online OBT,66,191,0.0,-125
763790,TrainerVR,53,3,9.99,50
733480,Flora,146,54,0.0,92
736430,Clicker bAdventure,23,61,2.99,-38
749520,Sakura no Mori † Dreamers,689,62,17.99,627
755150,Aurora Trail,81,14,0.0,67
768290,Snow White Solitaire. Charmed Kingdom,44,6,6.99,38
769690,Reading Simulator,51,39,0.99,12
754810,Six Days of Snow,239,70,0.0,169
767170,Dolphins-cyborgs and open space,26,33,0.99,-7
246920,Bombernauts,139,33,9.99,106
581910,Iron Armada,123,29,0.0,94
769680,愛神餐館2,47,0,34.99,47
700330,SCP: Secret Laboratory,128828,11947,0.0,116881
565020,Global Adventures,65,110,0.0,-45
738500,The Parallax Effect,113,129,0.0,-16
766700,PearsAndGrayWitch,7,9,4.99,-2
719590,Mesozoica,126,433,0.99,-307
756360,LINCH,103,66,5.99,37
754620,High School Simulator,154,62,0.0,92
711440,Mortars VR,99,62,0.99,37
640250,Kitty Hawk,6,1,0.99,5
773640,Colony On Mars,10,32,1.99,-22
772540,Battle Royale Trainer,954,697,5.99,257
610660,Russian Roads,93,34,5.99,59
670290,Real Pool 3D - Poolians,5562,1482,0.0,4080
643980,Ironbound,170,82,0.0,88
760890,Hello Charlotte EP3: Childhood's End,1055,15,2.99,1040
764030,Realm Revolutions,242,80,0.0,162
612820,Fallen Legion: Rise to Glory,48,25,29.99,23
758530,Sprout,1357,57,0.0,1300
716710,東方憑依華　～ Antinomy of Common Flowers.,1626,173,24.99,1453
773240,Raceland,68,145,0.99,-77
715670,DashPanel,285,63,0.0,222
765250,Mind the Vikings,37,41,10.99,-4
658420,Agents of Aggro City Online,4,6,0.0,-2
644480,Outbreak: The New Nightmare,175,86,12.99,89
772470,8-in-1 IQ Scale Bundle,55,11,14.99,44
768100,GizmoVR Video Player,236,105,0.0,131
622910,The trial of witch,28,3,3.99,25
636070,Corridor Z,162,54,0.79,108
576670,Sky Is Arrows,11,5,9.99,6
772420,COMPLEX a VR Puzzle Game,11,5,0.0,6
705810,Wuxing Master 五行师(CCG),162,53,0.0,109
642580,Cally's Caves 4,102,23,1.99,79
650700,Yume Nikki,4420,315,0.0,4105
771840,Royal Casino: Video Poker,80,21,2.99,59
693580,Goblins of Elderstone,141,49,19.99,92
769440,Beach Restaurant,38,43,16.99,-5
770440,Hangover,70,68,0.53,2
770070,Swords and Sandals 5 Redux: Maximus Edition,99,46,6.99,53
719730,Uptasia,112,77,0.0,35
767420,Wauies - The Pet Shop Game,186,100,0.0,86
576950,Westard,31,21,14.99,10
513600,Energy Invasion,21,19,2.99,2
699700,DYING: Reborn,158,48,12.99,110
744810,A Raven Monologue,2174,122,0.0,2052
776490,永远消失的幻想乡 ～ The Disappearing of Gensokyo,2820,487,10.99,2333
776820,Sit on bottle,39,13,4.99,26
744800,Banyu Lintar Angin - Little Storm -,643,23,0.0,620
744190,Rusty Lake Paradise,3088,172,3.99,2916
762480,Chinese inn,48,21,7.99,27
743830,SuperTrucks Offroad,35,16,9.99,19
770900,Off The Record: Liberty Stone Collector's Edition,3,0,9.99,3
747610,Zula Global,3336,1503,0.0,1833
776580,Abasralsa,297,128,0.99,169
611620,TheNightfall,94,32,24.99,62
700030,Life is Feudal: MMO,2814,3737,0.0,-923
717120,A Collection of Bad Moments,15,10,3.79,5
769920,Odysseus Kosmos and his Robot Quest: Episode 1,290,83,0.0,207
663210,12 Labours of Hercules VII: Fleecing the Fleece (Platinum Edition),127,12,2.99,115
771450,ERROR: Human Not Found,43,5,0.0,38
618750,Choose Wisely,56,21,3.99,35
703730,Sorcery Jokers All Ages Version,67,6,39.99,61
777050,TOXIC PLUMBING,68,52,1.99,16
764670,Sea Dogs,80,29,11.99,51
597230,Shotgun Legend,620,59,0.99,561
573710,Farm Mania 2,41,4,4.99,37
773320,TcNo TimeKeeper,1,1,0.0,0
772610,Q-YO Blaster,155,9,9.99,146
500150,Time Gap,108,46,0.0,62
628080,Romance of the Three Kingdoms XII with Power Up Kit,144,58,39.99,86
628070,Romance of the Three Kingdoms XI with Power Up Kit,2021,178,39.99,1843
618260,Endurance,6,4,0.0,2
771570,Zombie City,19,6,3.99,13
743000,Progeny VR,7,2,0.0,5
347000,InnerSpace,156,93,19.99,63
764570,Beavers Be Dammed,281,34,0.0,247
628140,NOBUNAGA'S AMBITION: Tenkasousei with Power Up Kit,71,30,29.99,41
670260,Solace Crafting,304,64,14.99,240
736570,The Crooked Man,558,46,2.99,512
755950,Fantasy Quest Solitaire,70,11,8.99,59
658970,CasinoRPG,138,84,0.0,54
776960,Mouse (Sneaking),719,179,0.49,540
752030,Paradise Lost: FPS Cosmic Horror Game,5,3,1.79,2
766940,Snares of Ruin,41,4,5.99,37
416600,Full Metal Furies,2181,202,19.99,1979
770500,Goblin Gearshop,151,53,0.0,98
469820,Genital Jousting,8353,727,6.99,7626
775850,Piwall,16,13,0.0,3
721390,Pipe Push Paradise,130,5,9.99,125
776340,Gay World,537,111,0.99,426
614950,Shootout on Cash Island,269,46,1.99,223
621220,Nantucket,600,153,17.99,447
666100,Shooty Fruity,143,8,19.99,135
776890,Clicker: Mining Simulator,54,97,0.5,-43
715650,The Endless Journey,202,36,9.99,166
659920,Transports,68,31,17.99,37
594320,Return of Red Riding Hood Enhanced Edition,45,5,2.99,40
546150,Primordian,80,26,19.99,54
770870,Queen's Tales: Sins of the Past Collector's Edition,3,0,9.99,3
770460,The Dummy Experiment,158,88,0.0,70
746140,The Walking Zombie: Dead City,294,95,2.99,199
775490,Super Steampunk Pinball 2D,42,23,1.99,19
752550,Ripped Pants at Work,24,4,2.99,20
391140,Blast-off,282,36,0.99,246
680700,OK K.O.! Let’s Play Heroes,105,8,19.99,97
781100,Winner Winner Chicken Dinner!,16,26,1.99,-10
746920,Rapid Tap,353,27,0.0,326
747920,Hero Plus,115,84,0.0,31
786040,Haunted Hotel: Lonely Dream,6,1,6.99,5
551550,ASSASSINATION BOX,40,83,5.99,-43
589780,The Red Strings Club,7983,488,14.99,7495
734590,Civil Warfare: Another Bullet In The War,45,82,0.99,-37
757810,Mahlone One,81,81,0.0,0
706960,Super Slime Arena,40,12,14.99,28
264710,Subnautica,191795,7238,29.99,184557
619080,SOS,1931,4984,0.0,-3053
781760,Trivia Vault: Health Trivia Deluxe,39,28,1.49,11
525240,LOST SPHEAR,101,74,49.99,27
734020,Legendary DXP,47,39,0.0,8
393520,Iconoclasts,3278,464,19.99,2814
337290,Still Not Dead,125,33,4.99,92
782300,Unstoppable Hamster,88,45,1.99,43
774281,Achievement Lurker: We Give Up!,50,18,1.99,32
484390,Hanger World,27,1,3.99,26
556740,LEGRAND LEGACY: Tale of the Fatebounds,286,126,19.99,160
765650,TSUKUMOHIME,99,37,0.0,62
427680,Zwei: The Arges Adventure,269,53,14.99,216
577080,A Dump in the Dark,212,92,0.49,120
741260,Mobile Empire,803,641,3.99,162
504230,Celeste,54974,1253,19.99,53721
765210,Your Royal Gayness,85,26,14.99,59
762590,Zombie Derby 2,83,18,3.99,65
773390,Aim Trainer Pro,74,51,4.99,23
761670,Grisaia Phantom Trigger Vol.4,99,1,14.99,98
713060,The Beanstalk,9,5,0.0,4
773670,Delete,1133,45,1.99,1088
619500,cyubeVR,620,59,14.99,561
678950,DRAGON BALL FighterZ,47784,5347,59.99,42437
684210,7,132,31,0.0,101
676440,Trash Squad,111,21,0.49,90
503940,Railway Empire,6665,1409,29.99,5256
771350,Achievement Clicker 2018,426,132,0.99,294
771950,SUMETRICK,305,72,0.99,233
755570,Chinbu's Adventure,31,26,2.49,5
758090,Monobeno,572,25,24.99,547
636100,Tesla vs Lovecraft,945,102,14.99,843
757240,Aimtastic,2373,147,0.0,2226
760460,WEED,113,93,0.99,20
783200,Forbidden Clicker Party,94,29,2.99,65
747970,Scions of Fate,81,47,0.0,34
741250,The Sand Man,152,9,2.99,143
710170,The Broken Seal,182,21,18.99,161
738920,Sexy Serial Killer,118,88,2.99,30
614660,Magic Technology,30,8,2.99,22
778850,Please close the doors,49,43,0.49,6
750790,Hollow Throne,6,3,0.99,3
633360,Remothered: Tormented Fathers,1326,440,19.99,886
760990,WeakWood Throne,42,29,4.99,13
786670,Loot Box Simulator 20!8,27,57,0.99,-30
520670,Strikers Edge,76,34,14.99,42
587180,Wulverblade,156,35,14.99,121
468240,VR Regatta - The Sailing Game,139,22,7.49,117
691830,Avernum 3: Ruined World,208,43,19.99,165
772700,MatchyGotchy,111,39,0.0,72
590910,炎黄战纪之三国烽烟,185,96,0.0,89
784940,Countryballs: Over The World,126,121,0.99,5
618080,Martial Arts Brutality,571,99,0.0,472
591630,Candleman: The Complete Journey,949,76,14.99,873
776190,Galactic Battles,39,63,0.99,-24
589220,UAYEB: The Dry Land - Episode 1,52,29,12.99,23
705220,Tactical Monsters Rumble Arena,4029,488,0.0,3541
779590,Scavenger SV-4,308,33,14.99,275
628770,Tangledeep,1068,199,14.99,869
249630,Delver,2308,337,14.99,1971
778230,Mighty Gemstones,25,25,1.99,0
667780,Rosebaker's Icy Treats - The VR Iceman Sim,24,1,5.99,23
595520,FINAL FANTASY XII THE ZODIAC AGE,5268,604,49.99,4664
776370,Next 2,90,18,0.99,72
735460,Highway Madness,27,11,0.0,16
775530,Puzzlement,184,14,1.99,170
677160,We Were Here Too,4697,1121,9.99,3576
789730,Not Without My Poop,144,36,0.99,108
574140,Project LUX,306,34,24.99,272
788510,Aeve:Zero Gravity,30,85,1.99,-55
753660,AtmaSphere,139,31,1.22,108
680730,Plight,23,5,0.0,18
759530,Struckd - 3D Game Creator,207,182,0.0,25
780750,Snake Classic,158,56,0.49,102
680360,Regions Of Ruin,3664,517,11.99,3147
705370,The Cursed Tower,57,34,0.0,23
786680,Dungeons Forever,95,21,0.0,74
590590,Remnants of Naezith,479,62,9.99,417
446150,GUNS UP!,3900,1541,0.0,2359
717070,R-COIL,32,11,4.99,21
765160,Weable 2,38,15,0.99,23
738840,Brutal Alice -The Hundred Day's War-,125,17,0.0,108
720380,Ancestors Legacy Free Peasant Edition,585,167,0.0,418
327860,Salt,1675,491,14.99,1184
555880,Sairento VR,1349,217,29.99,1132
382310,Eco,8109,1740,29.99,6369
215830,Closers,3320,1127,0.0,2193
612390,Dandara: Trials of Fear Edition,684,182,14.99,502
780210,Freeways,851,157,3.99,694
742250,OPUS: Rocket of Whispers,936,90,8.99,846
714010,Aim Lab,69441,3929,0.0,65512
788890,Tomato Jones - Episode 3,7,4,2.99,3
745000,Card Crawl,115,42,2.99,73
787250,Clash of Castle,25,25,0.99,0
740230,Just Ski+,132,18,0.0,114
734920,MEANDERS,376,27,2.99,349
501080,Fishing: Barents Sea,1726,474,24.99,1252
782690,Gazing from beyond,309,161,1.99,148
790930,Primitive Shooter,60,16,0.99,44
781660,Space Rocket,34,26,0.99,8
783050,Bear With Me - Collector's Edition,283,49,0.0,234
404200,WARTILE,484,140,19.99,344
720030,Indecision.,469,82,4.99,387
525620,Octogeddon,578,62,8.88,516
252490,Rust,703687,108223,39.99,595464
717610,A Case of Distrust,380,76,14.99,304
590690,Sprint Vector,560,104,29.99,456
300260,Planetoid Pioneers,245,134,19.99,111
621930,Attack of the Earthlings,272,46,19.99,226
791380,Way Out,3,5,0.99,-2
371140,Aegis Defenders,1162,299,19.99,863
671720,Robin,486,76,0.0,410
416870,Kitty Powers' Love Life,141,15,12.99,126
800050,The Great Tournament,24,2,4.99,22
610570,Paradox Soul,33,36,1.34,-3
788010,Carried Away: Winter Sports,22,5,0.0,17
547360,BREAK ARTS II,501,176,14.99,325
508190,Dragon Knight,1959,624,0.0,1335
711770,Hotel Dracula,33,24,1.99,9
786820,SOK MAX,43,4,1.99,39
591000,Deep Sixed,80,14,5.99,66
670610,Swaps and Traps,70,2,8.99,68
761170,Radical Dungeon Sweeper,149,34,12.99,115
774131,Nostradamus - The Four Horsemen of the Apocalypse,11,18,7.99,-7
744050,Space Invaders Extreme,159,13,19.99,146
730050,Verdant Skies,305,63,19.99,242
510490,The Fall Part 2: Unbound,447,103,16.99,344
744750,Devil and the Fairy,25,11,9.99,14
749840,The Boogie Man,123,29,2.99,94
791930,BombTag,1209,231,0.0,978
733740,Sakura Cupid,231,25,9.99,206
730310,DYNASTY WARRIORS 9,3075,6009,44.99,-2934
715050,The Islander,275,110,2.99,165
379430,Kingdom Come: Deliverance,80381,17141,29.99,63240
331690,Crossing Souls,1071,277,14.99,794
682470,真实幻象 / Behind The Truth,52,7,3.99,45
690150,Fossil Hunters,60,10,14.99,50
791470,DYO,626,21,0.0,605
488920,Knockout League - Arcade VR Boxing,269,71,19.99,198
777200,KOEWOTAYORINI SP / 声之寄托SP,209,15,1.99,194
795940,Fantasy Mosaics 19: Edge of the World,4,0,6.99,4
504110,The Longest Five Minutes,36,12,19.99,24
744600,Balloonatics,20,1,9.99,19
790790,Impossible Runner,150,85,0.0,65
711750,Monster Energy Supercross - The Official Videogame,615,139,19.99,476
796130,Virus Petya,14,10,10.99,4
746400,Speed Dating for Ghosts,349,15,6.99,334
667890,Dead Maze,3152,1090,0.0,2062
500260,Ben and Ed - Blood Party,1615,220,14.99,1395
420660,Burnin' Rubber 5 HD,207,26,9.99,181
792160,Heroes Of Hellas 4: Birth Of Legend,31,2,5.99,29
790060,The Void Rains Upon Her Heart,451,0,12.99,451
753420,Dungreed,6903,574,9.99,6329
778150,Crossroad,101,26,4.49,75
622770,Hacktag,260,116,19.99,144
778410,Dead Ground,60,42,4.99,18
782280,Beer!,18,5,1.99,13
787980,4D Minesweeper,166,15,0.0,151
797090,Neon Sun,19,25,1.99,-6
286300,Algo Bot,89,17,9.99,72
748490,The Legend of Heroes: Trails of Cold Steel II,2113,125,39.99,1988
787970,miraclr - Divine Dating Sim,34,6,9.99,28
568910,Ambition of the Slimes,36,5,4.99,31
637670,Secret of Mana,1555,677,39.99,878
792650,Super Jigsaw Puzzle,86,10,0.74,76
771240,YumeCore,153,7,4.99,146
509570,In Celebration of Violence,397,48,7.99,349
796360,JQ: countries,61,40,0.55,21
774411,Temple of Xiala,35,34,1.99,1
795040,E.Z,184,19,1.99,165
793620,Hellbreaker,17,6,7.99,11
752640,National Rugby Manager,29,14,18.99,15
791300,Canek: Quest for Corn [Demo],23,5,0.0,18
798610,Mermaid Adventures: The Frozen Time,26,11,5.99,15
704200,The Chronicles of Nyanya,139,8,19.99,131
591360,Dreams of Dali,109,20,0.0,89
753220,Mhakna Gramura and Fairy Bell,535,7,4.99,528
565120,The Station,770,128,14.99,642
708450,Pembrey,31,23,3.99,8
796910,Please Love My Computer Game,108,38,0.0,70
772990,Bird Watcher,43,17,1.99,26
746710,Cypher,494,44,4.99,450
648430,Hand of the Gods,743,547,0.0,196
781440,"OH MY GOD, LOOK AT THIS KNIGHT",1621,64,0.0,1557
791370,Xploquest 2,10,1,0.0,9
763520,Hard Place,25,22,1.99,3
775430,Discovery Tour by Assassin’s Creed®: Ancient Egypt,121,20,19.99,101
768750,MonteCrypto: The Bitcoin Enigma,130,147,1.99,-17
537520,SYMMETRY,102,89,11.99,13
603020,Skautfold: Usurper,205,81,9.99,124
745330,StrikeForce Kitty,353,49,7.99,304
688070,Legendary Gary,36,2,14.99,34
796640,Mr.Jezko,73,42,2.99,31
323220,Vagante,3469,391,14.99,3078
788470,Stonies,182,173,0.0,9
797620,Dissembler,60,3,3.99,57
469830,Fable Fortune,381,164,0.0,217
543900,METAL GEAR SURVIVE,3123,1656,29.99,1467
805660,Rad Rodgers - Radical Edition,102,49,19.99,53
786580,Gleaner Heights,237,90,9.99,147
794820,Knights of Pen and Paper 2: Free Edition,144,64,0.0,80
758020,DMD Mars Mission,6,5,8.99,1
671620,Beast Battle Simulator,816,133,9.99,683
762520,Demon Hunter 4: Riddles of Light,91,46,14.99,45
774351,Citystate,545,182,14.99,363
799070,Zup! 8,3537,133,0.99,3404
788740,A Salem Witch Trial - Murder Mystery,42,22,2.99,20
389980,Pluto,23,42,0.0,-19
774811,YUMENIKKI -DREAM DIARY-,780,332,19.99,448
777240,Tren0,200,61,1.49,139
633060,Orwell: Ignorance is Strength,1084,312,9.99,772
691020,Fog Of War - Free Edition,884,831,0.0,53
611960,Pilam Sky,39,7,3.99,32
548280,NeonBall,36,30,0.0,6
791330,Fallen ~Makina and the City of Ruins~,1318,216,14.99,1102
800350,Casino Blackjack,7,1,2.99,6
626690,Sword Art Online: Fatal Bullet,13764,3508,39.99,10256
320330,Earthworms,131,29,0.59,102
628290,All Walls Must Fall - A Tech-Noir Tactics Game,173,66,9.99,107
696200,Mike Dies,40,0,9.99,40
655290,Escape The Pacific,411,157,14.99,254
788270,Exiled Kingdoms,604,84,7.99,520
772070,Harvest Seasons,220,135,0.0,85
646050,Past Cure,19,39,29.99,-20
640150,Tale of Toast,388,358,0.0,30
760330,BYTEPATH,253,13,1.99,240
441010,Mount Your Friends 3D: A Hard Man is Good to Climb,302,39,2.79,263
723390,Hunt Down The Freeman,1143,1499,9.99,-356
630100,SoulWorker - Anime Action MMO,11440,2961,0.0,8479
801280,Cowboy Escape,23,36,0.99,-13
804290,Training aim,32,10,0.99,22
782660,Modern Tanks,135,134,0.0,1
803390,Thunderbolt,23,19,0.49,4
788770,Meteor 60 Seconds!,3824,148,0.0,3676
791150,EV3 - Drag Racing,98,97,0.0,1
476700,Island 359™,328,98,14.99,230
779330,Ninja Tycoon,285,108,4.99,177
623640,Mulaka,136,13,19.99,123
562230,Space Tyrant,484,78,19.99,406
588230,Beckett,90,37,9.99,53
808580,The Lone Chameleon,17,2,0.0,15
749850,DragonFangZ - The Rose & Dungeon of Time,116,37,24.99,79
552920,Sailaway - The Sailing Simulator,608,283,45.0,325
613830,CHRONO TRIGGER®,5512,843,14.99,4669
803150,Nephise: Ascension,92,19,2.49,73
558260,Gravel,588,219,29.99,369
632350,Cyberdimension Neptunia: 4 Goddesses Online,3934,568,29.99,3366
804600,Trivia Vault Football Trivia,32,28,9.99,4
590380,Into the Breach,14222,832,10.04,13390
546050,Puyo Puyo™Tetris®,4181,806,19.99,3375
797300,Fantasy Mosaics 21: On the Movie Set,4,1,6.99,3
592890,Insidia,142,79,0.0,63
789100,My Little Farmies,197,173,0.0,24
805090,Blackjack In Space,20,15,0.99,5
778640,Super Bit Adventure: Paragons of Life,20,2,0.99,18
802890,Muv-Luv Alternative (マブラヴ オルタネイティヴ),1710,77,39.99,1633
438000,PIXELMAN,126,25,0.99,101
779430,Full Ace Tennis Simulator,266,32,24.99,234
576120,Purgatory II,11,20,1.99,-9
433850,Z1 Battle Royale,115417,92764,0.0,22653
802880,Muv-Luv (マブラヴ),793,39,29.99,754
805880,Trivia Vault Olympics Trivia,35,25,9.99,10
505330,Apocalipsis,260,110,6.99,150
799840,Life and Debt: A Real Life Simulator,15,14,4.99,1
802180,DesertShootout,2,15,10.29,-13
559030,Siege Saga,24,13,4.99,11
798840,Panzer War : Definitive Edition (Cry of War),499,53,5.99,446
447120,Where the Water Tastes Like Wine,887,220,19.99,667
798650,Squeakers,48,0,0.49,48
804970,Shoottera,23,31,0.99,-8
670750,0°N 0°W,222,36,4.99,186
629220,Rise of Insanity,781,206,9.99,575
677120,Heroes of Hammerwatch,6585,851,11.99,5734
624970,Battlezone: Combat Commander,578,70,19.99,508
806100,PLATI NALOG: Favorite Russian Game,103,22,0.99,81
798730,rOt,37,22,0.0,15
749920,Eternal Dread,36,11,9.99,25
662830,Bombix,908,397,0.0,511
369560,The Story Goes On,102,19,4.99,83
806850,aMAZE Gears,72,27,0.99,45
772500,Distortions,105,63,9.99,42
773770,The Way of Kings: Escape the Shattered Plains,23,17,0.0,6
356450,Creature Romances: Kokonoe Kokoro,294,111,2.99,183
525510,"Guns, Gore and Cannoli 2",2926,176,12.99,2750
491010,IN-VERT: Definitive Edition,61,15,4.99,46
803080,Bad Day,93,48,0.99,45
291860,Pit People®,6901,461,19.99,6440
799510,Squidlit,365,32,1.99,333
806140,Achievements printer,712,182,0.99,530
787990,Resume: The Video Game,24,10,0.0,14
668590,Omen Exitio: Plague,376,46,9.99,330
805040,European Mystery: Flowers of Death Collector's Edition,2,0,9.99,2
750170,Diesel Railcar Simulator,250,16,17.99,234
807140,Marble Run 2D,62,22,2.99,40
798280,CrocoMars,135,27,0.0,108
809320,Silent Tweets,83,19,1.99,64
790950,Feed Eve,4,7,0.99,-3
453690,Dark Quest 2,447,87,3.19,360
702810,Shooty Skies,1251,111,0.0,1140
467760,Trapper's Delight,253,20,7.99,233
800120,Lonely Yuri,115,9,9.99,106
789540,The Adventures of Nick & Willikins,104,11,0.0,93
546900,Fear Effect Sedna,73,92,19.99,-19
619550,Vision,43,11,0.0,32
783940,Forgotten Hill Mementoes,140,15,1.99,125
812110,Alice in Wonderland - Hidden Objects,33,25,1.99,8
637650,FINAL FANTASY XV WINDOWS EDITION,34699,7419,34.99,27280
803010,Supermedium - Virtual Reality Browser,34,15,0.0,19
625680,Way of the Passive Fist,149,38,14.99,111
707350,Damascus Gear Operation Osaka HD Edition,11,9,19.99,2
711660,CHUCHEL,2108,482,9.99,1626
787790,Epic Roller Coasters,304,192,0.0,112
466560,Northgard,39481,5314,29.99,34167
390710,Acceleration of SUGURI 2,869,238,4.49,631
598880,Domiverse,44,3,0.0,41
775220,Crusaders of Light,347,239,0.0,108
696170,SENRAN KAGURA Peach Beach Splash,2831,714,29.99,2117
490220,Prismata,921,193,0.0,728
734380,Sacrament,11,20,0.0,-9
802740,Wild Glory,43,3,2.99,40
567140,Mahjong Magic Journey,68,14,4.99,54
586950,The Wizards - Enhanced Edition,376,102,9.99,274
685690,Guns'n'Stories: Bulletproof VR,339,43,3.99,296
612470,Bio Inc. Redemption,1448,169,7.79,1279
707300,Hatsune Miku VR,407,156,14.99,251
577670,Demolish & Build 2018,1022,311,9.99,711
643200,Keep in Mind: Remastered,261,80,1.99,181
753610,J.A.W.S,69,73,0.0,-4
799860,BREATHE,174,182,0.0,-8
341710,Crest - an indirect god sim,246,119,9.99,127
761030,EARTHLOCK,355,129,29.99,226
552500,Warhammer: Vermintide 2,73796,14606,29.99,59190
580170,My Lovely Daughter,734,287,14.99,447
780800,Ball laB,519,275,0.99,244
800600,Wayhaven Chronicles: Book One,258,14,4.99,244
746010,Rig or Skill: PC Brawl,14,10,0.0,4
788050,Re;Lord 1 ~The witch of Herfort and stuffed animals~,47,14,9.99,33
459150,Super Cat Herding: Totally Awesome Edition,24,5,9.99,19
788210,The Bonfire: Forsaken Lands,123,42,7.99,81
687920,Tropical Liquor,568,133,9.99,435
786370,Alien Crusader,48,31,0.0,17
749560,Cycle 28,39,8,6.99,31
815560,Dead Reckoning: The Crescent Case Collector's Edition,2,1,9.99,1
799180,Unfinished Battle,9,5,0.51,4
780580,Lost in the Dungeon,69,44,5.99,25
793350,Swarmlake,1462,65,2.99,1397
803590,Little Gold Miner,12,1,1.99,11
678450,Full-On Paintball,12,19,0.0,-7
773580,Game Dev Studio,485,77,9.99,408
342940,Project: Gorgon,1569,257,39.99,1312
697650,The 25th Ward: The Silver Case,221,20,19.99,201
790450,ANYKEY,56,13,0.0,43
672590,Azure Saga: Pathfinder,65,19,12.99,46
736810,The Raven Remastered,202,43,19.99,159
631510,Devil May Cry HD Collection,5245,504,29.99,4741
785130,Clawface,124,18,0.0,106
417290,Ghost of a Tale,3723,305,24.99,3418
287630,The Council,3560,663,0.0,2897
534370,Pure Farming 2018,995,380,19.99,615
360620,Spellsworn,1163,142,0.0,1021
707060,Beast Quest,17,30,2.99,-13
733340,Hakuoki: Edo Blossoms,620,26,9.99,594
359100,Q.U.B.E. 2,1134,211,24.99,923
771060,Iron League,576,229,0.0,347
771310,Welcome to Light Fields,249,11,0.0,238
786520,SAO Utils: Beta,2327,339,3.99,1988
584990,The Long Reach,306,49,14.99,257
815950,Chocolate makes you happy 4,101,37,0.51,64
788910,Apartment of Love,150,94,0.0,56
601050,Attack on Titan 2 - A.O.T.2,4516,386,59.99,4130
811750,Breach of Contract Reloaded,104,123,0.0,-19
456180,The American Dream,72,34,14.99,38
497190,Pichon,40,6,3.99,34
787110,Usotsuki Game / 谎言游戏,198,67,1.99,131
530930,Soulblight,46,65,14.99,-19
464920,Surviving Mars,18918,3468,29.99,15450
815780,PIPE by BMX Streets,5203,353,9.99,4850
817460,Sea Dogs: Caribbean Tales,55,32,11.99,23
682080,Pato Box,83,17,14.99,66
528230,SYNTHETIK: Legion Rising,10159,584,19.99,9575
461410,Protonwar,75,13,0.0,62
800620,Fallen Hero: Rebirth,255,7,3.99,248
772480,Super Inefficient Golf,159,40,4.99,119
404960,The Way of Life: DEFINITIVE EDITION,69,32,14.99,37
784950,CONFLICT OF NATIONS: WORLD WAR 3,1776,618,0.0,1158
695360,Veritex,53,87,0.0,-34
718250,Nova Flow,30,1,6.99,29
808100,Galimulator,356,44,4.99,312
635900,Tunnels of Despair,44,20,5.99,24
814920,Sol705,65,19,0.0,46
624320,Loyalty and Blood: Viktor Origins,49,8,9.99,41
756490,Next Hero,29,19,9.99,10
699040,Millidor,96,58,0.0,38
815580,Dark Parables: Return of the Salt Princess Collector's Edition,19,2,9.99,17
813530,FPV Freerider Recharged,95,13,9.99,82
759000,.projekt,118,11,4.99,107
810670,NALOGI,1230,322,0.69,908
797450,Fantasy Mosaics 27: Secret Colors,5,0,2.09,5
786490,Brew-Ha,11,4,0.0,7
716770,Exorder,45,16,12.99,29
634340,Legend of Himari,276,34,0.49,242
694090,Apex Construct,147,59,0.0,88
434660,Octahedron: Transfixed Edition,140,11,12.99,129
810760,Starman's VR Experience,20,13,0.0,7
724110,PlayUSA,12,20,0.0,-8
581630,Sword With Sauce,4771,862,2.99,3909
816250,JQ: dogs & cats,68,13,0.55,55
714610,Google Spotlight Stories: Rain or Shine,49,5,0.0,44
751340,ASSAULT GUNNERS HD EDITION,69,25,9.99,44
762500,Rhythm Girl,21,4,1.99,17
810200,blue.,52,43,0.0,9
748460,RealFlight 8,60,14,0.0,46
813240,Grim Town: Battle Tales,5,13,0.0,-8
820380,Russian Prisoner VS Nazi Zombies,40,36,0.99,4
798850,Achievement Lurker: Easiest Cosmetic Numbers,47,12,1.99,35
529910,ARK Park,165,184,39.99,-19
774711,The Best Of MagiCats,68,21,0.0,47
797200,International Space Station Tour VR,58,11,0.0,47
742490,Nonogram - The Greatest Painter,206,27,2.99,179
730820,The Curse of Monkey Island,1742,42,6.99,1700
816490,Hidden Paws,529,66,1.64,463
746840,Chronicles of Magic: Divided Kingdoms,133,29,14.99,104
817640,Adelantado 4 Aztec Skulls,5,5,4.99,0
619290,Out of the Park Baseball 19,634,108,0.0,526
814200,Simple Story - Alex,337,187,0.99,150
588160,Pizza Connection 3,442,471,1.99,-29
724470,Lazy Galaxy,127,29,4.99,98
778330,Squirm,169,7,2.99,162
789050,Paradise,34,4,1.99,30
750010,Combat Tested,57,28,19.99,29
785840,Moe Jigsaw,285,55,3.99,230
691690,Ash of Gods: Redemption,2244,743,24.99,1501
766320,The Mage's Tale,111,38,29.99,73
589360,Ni no Kuni™ II: Revenant Kingdom,7812,1429,11.99,6383
809050,Detective Holmes: Trap for the Hunter. Hidden objects. 探し物,46,15,2.99,31
821520,Trivia Vault: Boxing Trivia,34,29,9.99,5
634070,Murnatan,68,41,0.0,27
814960,Blackbox,9,1,0.0,8
774091,Ostalgie: The Berlin Wall,518,41,5.99,477
818530,8 Ball,69,26,0.49,43
758370,Through the Ages,1543,155,15.99,1388
787450,KOEWOTAYORINI / 声之寄托,762,125,0.0,637
635880,Chicken Labyrinth Puzzles,118,58,0.49,60
552520,Far Cry® 5,100620,25286,59.99,75334
801290,Diabolic,284,48,3.99,236
756590,Atelier Lydie & Suelle ~The Alchemists and the Mysterious Paintings~,508,40,0.0,468
576690,Chess: King of Crowns Chess Online,3,6,0.0,-3
520940,MX vs ATV All Out,1027,278,39.99,749
823920,Kawaii Rainbow Portal,26,12,1.99,14
553480,The Pirate's Fate,281,36,19.99,245
816270,Sounds of Verity,146,34,4.99,112
734580,BattleRush,1966,900,0.0,1066
812560,CROSS†CHANNEL: Steam Edition,206,25,4.49,181
798940,勇士冲冲冲-Classic Rodeo play,21,10,0.0,11
326160,Shroud of the Avatar: Forsaken Virtues,1498,1371,0.0,127
823770,Labyrinths of Atlantis,9,45,0.99,-36
626610,TT Isle of Man Ride on the Edge,838,343,19.99,495
704450,Neverwinter Nights: Enhanced Edition,5443,680,19.99,4763
785780,OF MICE AND SAND -REVISED-,189,58,9.99,131
618140,Barro,2806,807,0.49,1999
575970,Golem Gates,89,18,24.99,71
727760,Umiro,106,26,2.99,80
700470,Selenophobia,127,58,0.0,69
740790,Goldmine,98,143,0.99,-45
510540,Long Gone Days,265,14,14.99,251
822460,Trivia Vault: Auto Racing Trivia,31,24,9.99,7
611040,Tube Tycoon,399,124,10.99,275
817510,Golfing Over It with Alva Majo,968,359,4.99,609
639560,Spacescape,50,12,1.99,38
446020,Jalopy,6260,1868,14.99,4392
753900,End Space,62,26,19.99,36
822700,Beer and Skittls VR,20,3,0.0,17
654220,Flash Point: Fire Rescue,109,25,19.99,84
812450,The m0rg VS keys,29,21,0.5,8
786410,An Aspie Life,79,39,0.0,40
809210,LifeZ - Survival,157,61,9.99,96
530630,Empires Apart,1455,652,0.0,803
793940,MOAI 5: New Generation Collector’s Edition,19,8,7.99,11
567750,Gamer Career Tycoon,215,50,6.99,165
822900,Trivia Vault: Golf Trivia,32,24,0.99,8
816350,The Flood,921,170,0.0,751
802960,Oracle: Threads of Fate,11,7,0.0,4
826370,Spirits of Mystery: The Silver Arrow Collector's Edition,3,0,9.99,3
789970,Let's Kill Zombies VR,1,1,4.99,0
817820,"The Quiet, Please! Collection",6,0,4.99,6
788130,Otaku's Fantasy 2,463,214,0.0,249
206500,AirMech Strike,8441,1608,0.0,6833
620210,Fatal Twelve,643,31,19.99,612
816060,Kingdom Clicker,18,14,0.49,4
817760,The Castle Disaster,77,27,0.99,50
771920,TOGETHER VR,196,106,12.99,90
525640,Bullets And More VR - BAM VR,456,62,9.99,394
611670,The Elder Scrolls V: Skyrim VR,6399,2041,59.99,4358
809850,Sudoku Zenkai,149,16,2.99,133
458520,Wrath of Anna,80,150,19.99,-70
806510,Her Lie I Tried To Believe,785,183,0.0,602
674150,Simon the Sorcerer: 25th Anniversary Edition,61,24,8.99,37
702120,THE KING OF FIGHTERS '97 GLOBAL MATCH,675,225,9.99,450
821560,螢幕判官 Behind the Screen,197,34,8.99,163
774441,Island Time VR,45,19,14.99,26
824270,KovaaK's,23480,1785,12.99,21695
346500,Road Scars: Origins,123,49,0.99,74
396710,The Adventure Pals,1311,101,14.99,1210
817360,The Outer Rim: Survivor,49,15,0.0,34
609490,Minit,1844,196,9.99,1648
799240,My Free Farm 2,303,227,0.0,76
763270,Fritz Chess 16 Steam Edition,28,11,39.99,17
837790,Around the World in 80 Days,32,11,0.49,21
597030,Aircraft Evolution,191,38,9.99,153
795580,THE DAY Online,343,248,0.0,95
789950,INFERNIUM,114,56,24.99,58
720250,Welcome to the Game II,1842,295,9.99,1547
678830,Buried Alive VR,7,2,0.99,5
758980,Poker Legends: Texas Hold'em Poker Tournaments,430,129,0.0,301
767560,War Robots,8243,4885,0.0,3358
814540,Changed,8730,946,5.99,7784
828910,aMAZE Frozen,60,41,0.51,19
820790,FEAST: Book One «Family Ties»,67,20,0.0,47
440660,Void Vikings,20,5,4.99,15
821500,Ria's Hook,348,94,2.99,254
707010,Will To Live Online,9243,3508,0.0,5735
644640,Band of Defenders,197,181,13.99,16
820090,Solitaire Knights,33,19,0.0,14
631830,Sarcophag,144,64,0.99,80
827780,Margot's Word Brain,1,4,2.99,-3
822110,Magika Land of Fantasy,84,18,0.0,66
821260,LIGHT,5,4,0.99,1
828150,WIN THE GAME!,177,86,0.99,91
770090,La Camila: A VR Story,41,10,0.0,31
822150,WAY HOME,21,8,3.99,13
495560,Farm Manager 2018,1803,724,19.99,1079
826100,Find someone else,105,9,0.0,96
553660,PWND,637,267,0.0,370
825930,Royal Battleships,36,11,2.99,25
820750,Cryptocurrency Clicker,43,62,0.0,-19
527150,Dead,164,12,4.99,152
587390,LOR - League of Runners,8,13,0.0,-5
823160,Knife Hit Dash,29,46,3.99,-17
798810,Natural Locomotion,435,68,9.99,367
751440,VR Kanojo / VRカノジョ,1303,406,49.99,897
830510,Bounty Hunter: Ocean Diver,5,16,1.99,-11
570710,Extinction,92,214,4.49,-122
656510,Epic Car Factory,120,71,0.99,49
820760,Tactics & Strategy Master:Joan of Arc,30,17,4.99,13
568220,Lobotomy Corporation | Monster Management Simulation,18694,1179,24.99,17515
667790,Downbreak,23,5,4.99,18
755980,DEPLOYMENT,526,109,9.99,417
554280,Time Carnage VR,66,20,19.99,46
809960,Radical Heights,6105,3906,0.0,2199
748970,Zen Chess: Mate in One,224,35,0.99,189
606890,Masters of Anima,240,44,6.99,196
726950,Dark Rose Valkyrie,62,84,19.99,-22
361230,Super Daryl Deluxe,364,48,19.99,316
414550,Death Toll,193,80,0.0,113
802300,Baseball Kings VR,1,1,14.99,0
824720,Pure Rock Crawling,771,131,14.99,640
831590,VRQ Test,9,3,0.0,6
803220,Winions: Mana Champions,53,54,0.0,-1
708420,Broken Ground,302,113,0.0,189
573120,Dead In Vinland,1093,306,19.99,787
793670,The Wastes,21,4,9.99,17
839940,Silverworld,23,1,6.99,22
762930,Supipara - Chapter 2 Spring Has Come!,89,0,14.99,89
834000,Cross Country Skiing VR,12,4,0.0,8
809240,Vandals,47,9,4.99,38
795100,Friday the 13th: Killer Puzzle,4647,309,0.0,4338
329070,SpyParty,935,194,24.99,741
428490,Germination,34,9,3.99,25
617480,Tower of Time,1653,292,24.99,1361
778700,Amorous,5608,1265,0.0,4343
648390,Marie's Room,5429,334,0.0,5095
833040,Hiveswap Friendsim,1111,85,12.99,1026
757490,Mapas do Horizonte - Um jogo para conhecer BH,8,1,0.0,7
684050,Achievement Idler: Black,242,46,0.99,196
713180,Eredia: The Diary of Heroes,38,7,7.99,31
714020,Idle Adventure,274,146,0.0,128
806970,Loader,26,21,1.99,5
796370,Desert of Vice,12,3,2.99,9
821320,SPAGHET,138,12,1.99,126
824190,Achievement Clicker 2019,467,124,0.99,343
823700,AUTOCROSS MADNESS,36,32,3.99,4
828410,OniBushi VR,2,10,9.99,-8
829370,Nicky - The Home Alone Golf Ball,27,4,0.99,23
814570,The Great Escape,14,12,3.99,2
812410,Dimension of Monster Girls,115,17,4.99,98
797040,Reboant - Endless Dawn,15,18,1.99,-3
668430,V-Racer Hoverbike,205,23,19.99,182
747210,Voyage Senki VR 海洋传说 VR,18,22,0.0,-4
831490,Draw Near,14,6,0.0,8
821790,Who Am I: The Tale of Dorothy,349,28,0.0,321
613590,Dungeon Of Zaar - Open Beta,88,40,0.0,48
793050,UNDEAD FACTORY:Zombie Pandemic,45,38,0.0,7
579180,Ys VIII: Lacrimosa of DANA,3592,534,59.99,3058
743350,Slay.one,75,57,9.99,18
779650,Ready Player One: OASIS beta,290,193,0.0,97
695600,This Grand Life,162,53,5.99,109
584150,Casey Powell Lacrosse 18,19,10,49.99,9
436690,Tempest Citadel,35,11,19.99,24
831450,Kolb Antarctica Experience,6,5,2.99,1
305940,Project AURA,435,229,14.99,206
704860,Keepsake,222,43,0.99,179
837260,Roller Coaster Apocalypse VR,3,1,2.99,2
719210,Supposedly Wonderful Future,12,1,9.99,11
735850,Trailer Park Boys: Greasy Money,950,225,0.0,725
598490,Healer's Quest,206,32,14.99,174
750470,War Brokers,296,30,4.99,266
450700,The Spatials: Galactology,173,67,12.99,106
826480,VR Benchmark Kanojo,176,53,0.0,123
839890,Kama Bullet Heritage 2,20,58,0.0,-38
603330,Blasted Road Terror,76,11,8.99,65
551170,Onmyoji,2004,447,0.0,1557
644560,Mirror,80419,2554,1.99,77865
332700,Mike was Сursed,58,24,11.99,34
831710,Electronic Piano,15,23,0.0,-8
622460,Steampunk Tower 2,239,68,7.99,171
830980,Doodle Date,181,81,1.99,100
832650,Royal Adventure,19,8,6.99,11
667690,Bedlamball,14,0,9.99,14
787720,Block'hood VR,3,8,14.99,-5
788690,Psychonauts in the Rhombus of Ruin,391,52,19.99,339
349250,Copy Kitty,291,7,14.99,284
698770,Watch Me Jump,30,4,0.0,26
527230,For The King,25040,3101,5.99,21939
564050,Bud Spencer & Terence Hill - Slaps And Beans,1325,104,19.99,1221
835520,Dodge Show,134,17,0.99,117
792720,Boxing Apocalypse,9,1,19.99,8
833890,NeoSticks,48,39,1.19,9
742480,The Big Journey,253,33,4.99,220
834180,#CuteSnake 2,46,14,0.99,32
838540,City Escaper,14,23,0.99,-9
839920,9 Balls,10,39,0.99,-29
787930,American Railroads - Summit River & Pine Valley,94,57,19.99,37
833300,Fantasyland,5,34,8.99,-29
485670,Mini Golf Arena,234,241,8.99,-7
809770,DeerHunterX,9,48,5.99,-39
837310,Telophase,47,13,0.0,34
829210,AIdol,34,11,10.99,23
728730,Holyday City: Reloaded,1198,267,0.0,931
823470,Glitchball,17,11,0.0,6
676090,Legend Of Mercy 神医魔导,334,111,3.99,223
842290,ArcBall 2,4,32,0.99,-28
637090,BATTLETECH,21676,4556,39.99,17120
820700,Free road,14,4,0.99,10
763610,Freakshow:Anniversary,22,14,0.0,8
619780,The Swords of Ditto: Mormo's Curse,1315,799,14.99,516
323190,Frostpunk,73661,6864,29.99,66797
620650,Puzzle With Your Friends,125,18,4.99,107
844420,Demon's Rise - Lords of Chaos,118,25,6.99,93
757210,EMERGENCY 4 Deluxe,1041,72,17.99,969
841600,Aura of Worlds,77,4,11.99,73
837380,DeoVR Video Player,388,178,0.0,210
819480,Pizza Titan Ultra,67,9,11.99,58
504920,39 Days to Mars,223,30,14.99,193
831060,Black Jack Story,47,17,0.99,30
696180,Bullet Witch,321,147,14.99,174
844750,Go-Kart Racing,71,58,0.99,13
574200,EARTH DEFENSE FORCE 4.1 WINGDIVER THE SHOOTER,112,49,19.99,63
835450,Neon Force Pushers,13,7,0.0,6
702160,Rocketboat - Pilot,43,13,0.0,30
416830,Light Fall,92,13,14.99,79
851330,Pizza Connection 3 - Pizza Creator,49,11,0.0,38
591750,Solo,77,11,14.99,66
827220,Overclocked: The Aclockalypse,35,13,0.0,22
785480,Titanic: Adventure Out Of Time,211,30,5.99,181
814030,Queen's Quest 4: Sacred Truce,90,31,14.99,59
820730,Adventure of a Lifetime,678,26,12.99,652
821370,MLB Home Run Derby VR,17,7,4.99,10
723450,Dragon Hunt,41,30,0.49,11
758100,E-Startup,80,73,9.99,7
638070,Murderous Pursuits,1743,1007,9.99,736
743450,Monster Prom,10279,717,11.99,9562
462940,Making History: The Second World War,178,48,14.99,130
792680,Containment Initiative: PC Standalone,4,4,0.99,0
799300,Go Guess,31,10,0.0,21
302670,Call to Arms,14311,3786,14.99,10525
673740,Space Battlecruiser,51,12,4.99,39
814480,Mini World: Block Art,1798,1592,0.0,206
841500,Sheep Game,35,7,0.0,28
828580,NEKO-NIN exHeart 2,257,12,9.99,245
683870,Quest of Vidhuraa,22,4,0.99,18
840100,Magic Scroll Tactics / マジックスクロールタクティクス / 魔法卷轴 / 魔法捲軸,141,33,11.99,108
596240,Apocryph: an old-school shooter,143,118,14.99,25
838730,Grim Tales: The Stone Queen Collector's Edition,7,2,9.99,5
334920,Zero-K,2566,155,0.0,2411
336940,Basingstoke,234,99,34.99,135
545180,Muffled Warfare - Echolocation Shooter,90,16,9.99,74
803030,Seek Or Die,108,50,0.0,58
314630,The Thin Silence,21,5,9.99,16
754150,Rolling Line,1286,62,19.99,1224
839310,Signal Simulator,662,123,19.99,539
843900,Demon's Rise - War for the Deep,82,14,6.99,68
836480,恋爱模拟器 Love Simulation,570,453,1.99,117
836550,Viking Brothers 3,21,2,6.99,19
649770,Coregrounds,50,21,0.0,29
840700,Qvabllock,76,16,0.49,60
836560,Viking Brothers 4,22,2,6.99,20
599010,Hanse - The Hanseatic League,28,80,0.0,-52
414870,Super Mega Baseball 2,909,117,19.99,792
802490,Fabulous - Angela's Wedding Disaster,42,7,12.99,35
836540,Viking Brothers 2,27,4,6.99,23
242760,The Forest,368986,18577,19.99,350409
820210,Ashi Wash,24,1,2.99,23
820190,FORWARD,24,4,0.0,20
798950,Logout,24,17,0.0,7
840620,Geometry Boxer,42,21,0.0,21
400350,Battle Fleet: Ground Assault,33,13,14.99,20
823580,Isoland 2 - Ashes of Time,247,9,2.99,238
685400,Skelly Selest,236,13,4.99,223
842420,A Walk in the Woods,212,306,0.0,-94
841300,Together,156,56,0.0,100
599390,Battle for Wesnoth,3567,221,0.0,3346
831570,Isoland,200,15,0.99,185
843890,WIN THE GAME: DO IT!,190,116,0.99,74
712870,Vectorium,59,16,4.99,43
841270,Trap welcome to Beryl Part 1,176,28,0.0,148
712100,A Total War Saga: THRONES OF BRITANNIA,8273,3805,39.99,4468
468330,HIVE: Altenum Wars,61,26,9.99,35
682480,恒水中学连环虐杀 / The untold story of hengshui school,308,58,3.99,250
781640,Run Jump Fail,38,5,6.99,33
840410,Mushroom Heroes,127,23,0.0,104
832080,Google Spotlight Stories: Back to the Moon,41,1,0.0,40
837900,Bitcoin Trader,28,40,0.59,-12
608110,Null Vector,254,8,4.99,246
439370,Midair,465,377,0.0,88
732370,Juicy Realm,2887,397,9.99,2490
437690,Venture Kid,125,27,9.99,98
699180,Human-powered spacecraft,529,44,0.49,485
817660,Soul Smith of the Kingdom,89,57,6.99,32
455980,Judgment: Apocalypse Survival Simulation,1573,377,19.99,1196
702030,Starbear: Taxi,30,6,1.99,24
292330,Starship Corporation,221,294,19.99,-73
821610,My Sunny Resort,98,96,0.0,2
836940,【SCP】器関ノ彷徨 -The will of a single Tale-【DEMOver.】,297,32,0.0,265
817770,30 Seconds To Jail,55,22,2.99,33
842500,Kickshot,47,13,0.0,34
301840,City of Brass,556,144,19.99,412
851530,Mini-Dead,725,43,0.0,682
630900,Illwinter's Floorplan Generator,370,28,6.99,342
596380,Coffee Crisis,116,50,9.99,66
740250,Neos VR,944,208,0.0,736
771250,Doodle God: Mighty Trio,87,41,0.0,46
822930,Wolf Tails,769,34,9.99,735
843250,The Last DeadEnd,75,23,7.99,52
724250,Princess Maker 5,275,152,29.99,123
822760,Fureraba ~Friend to Lover~,278,4,29.99,274
851650,LOGistICAL: ABC Islands,38,18,0.0,20
758410,AO International Tennis,255,99,24.99,156
844180,Slab,60,13,5.99,47
829560,Katie,25,5,2.99,20
444090,Paladins®,280999,47510,0.0,233489
850290,Grimmwood Open Beta,189,85,0.0,104
825630,STEINS;GATE 0,4062,161,34.99,3901
747470,Doughlings: Arcade,76,4,4.99,72
621970,Trailblazers,42,29,2.99,13
560130,Pillars of Eternity II: Deadfire,13018,1863,39.99,11155
847890,小黄条/YYNote,40,10,0.0,30
440900,Conan Exiles,62942,16629,15.99,46313
836490,月夜下的紅茶杯 ~ Blacktea With Moon,481,30,0.99,451
853380,Air Threat,118,38,1.99,80
764300,Shantae: Half-Genie Hero Ultimate Edition,594,66,29.99,528
666940,Welcome Back To 2007,132,42,1.99,90
821060,Desktop Mascot Engine,114,77,2.99,37
833140,Supaplex,159,8,9.99,151
841440,ShellBlast: Legacy Edition,6,0,3.99,6
844380,Cave Digger VR,259,79,7.99,180
840610,Fortune-499,121,15,4.99,106
850450,Escape First,248,127,4.19,121
743860,Wild West Online,275,671,0.0,-396
570460,Laser League: World Arena,1295,319,0.0,976
640880,Hyper Sentinel,44,6,7.99,38
666570,Infectonator 3: Apocalypse,639,139,12.99,500
810510,Welcome Back Daddy,24,49,6.99,-25
845480,Kinaman vs Gray Elephant,12,23,0.49,-11
805760,Desire,48,29,19.99,19
696530,Lake Ridden,202,67,12.99,135
853480,Pestis,67,14,24.99,53
717980,伏雨录：少年篇,72,8,6.99,64
677450,Medieval Shopkeeper Simulator,143,83,0.0,60
533540,MONMUSU,4025,1012,0.0,3013
805400,Mahjong Solitaire,39,16,1.99,23
654470,Blood Waves,113,55,9.99,58
800820,2236 A.D.,45,3,14.99,42
838390,Merry Glade,200,11,3.99,189
848280,Viki Spotter: Space Mission,111,4,3.99,107
492410,Rogues Like Us,45,6,9.99,39
758190,Dragon Cliff,5672,628,2.99,5044
804730,Third Front: WWII,224,134,7.99,90
664750,Wrongworld,400,24,14.99,376
828950,Howlville: The Dark Past,43,15,9.99,28
850050,Achievement Idler: Red,182,28,0.99,154
842170,Hyperspace Dogfights,84,7,9.99,77
840930,Bing Bong XL,180,13,0.99,167
846200,Bastard,79,52,2.69,27
843430,Righty Tighty XL,115,4,0.99,111
662930,Dominari Empires,63,1,4.99,62
843440,Pivot XL,128,6,0.99,122
791140,Shatter EVERYTHING (VR),10,1,5.99,9
512160,Volleying,209,90,0.99,119
850000,Noel the Mortal Fate S1-7,1645,76,14.99,1569
389140,Horizon Chase Turbo,3966,256,19.99,3710
849980,Color by Numbers - Dinosaurs,7,0,4.99,7
790600,Stormbound,682,275,0.0,407
445980,Wizard of Legend,14794,1407,15.99,13387
542050,Forgotton Anne,1389,136,19.99,1253
834380,Cube Zone,27,2,4.99,25
710470,Little Witch Academia: Chamber of Time,924,256,5.99,668
455820,Omensight: Definitive Edition,1203,150,19.99,1053
703840,Animal Super Squad,428,82,9.99,346
853210,Gopnik Simulator,33,46,0.5,-13
787400,Fantasy Versus,388,115,3.49,273
616750,1943 Deadly Desert,41,30,9.99,11
851730,Sandmade,123,10,0.99,113
783180,Fairune Collection,58,7,9.99,51
555510,MachiaVillain,437,218,19.99,219
539400,Son of a Witch,328,42,19.99,286
753230,STAY,337,144,11.99,193
850500,Slum Ball VR Tournament,39,4,14.99,35
857010,HUBE: Seeker of Achievements,100,46,0.99,54
842810,Märchen Forest: Mylne and the Forest Gift [Legacy ver.],320,62,9.99,258
821640,Floor Kids,141,21,19.9,120
761890,Albion Online,39485,10008,0.0,29477
788420,Potion Explosion,164,27,6.99,137
603400,FOX n FORESTS,113,40,9.99,73
704360,SACRALITH : The Archer`s Tale,212,35,19.99,177
508900,Zup! X,5752,183,0.99,5569
794800,Clue/Cluedo: The Classic Mystery Game,1885,253,11.99,1632
739190,AntVentor,289,59,4.99,230
613100,House Flipper,59039,4160,12.49,54879
845250,Fish Tycoon 2: Virtual Aquarium,105,82,0.0,23
843620,Forest Below,9,1,0.0,8
322450,FRAMED Collection,1428,113,9.99,1315
856980,7-in-1 Brain Sharpness Bundle,21,13,12.99,8
727540,ReX,78,11,1.79,67
846110,The friends of Ringo Ishikawa,1308,170,14.99,1138
633110,FAST BEAT LOOP RACER GT | 環狀賽車GT,360,180,9.99,180
504430,The Watchmaker,38,33,9.99,5
839240,Penny Black,80,5,0.0,75
584890,Stayin' Alive,207,71,4.99,136
385270,Jet Racing Extreme: The First Encounter,826,390,3.99,436
804700,The House in Fata Morgana: A Requiem for Innocence,573,17,14.99,556
844130,Future Proof,62,8,2.99,54
854250,FPV Freerider,127,20,5.99,107
609320,FAR: Lone Sails,10524,640,14.99,9884
735500,Creepy Road,94,41,9.99,53
848260,Super GTR Racing,24,17,3.99,7
574590,Koloro,67,3,9.99,64
770100,One Deck Dungeon,499,129,9.99,370
851810,Ultimate Sudoku Collection,95,34,0.0,61
859610,S.T.R.E.T.C.H.,10,19,0.99,-9
717850,Sable's Grimoire,113,5,14.99,108
845530,Imperialism: The Dark Continent,9,33,0.0,-24
856430,Pinball 2018,23,28,1.99,-5
758320,Cursed Lands,73,22,24.99,51
502130,Ctrl CV,204,54,0.49,150
857140,"Snake, snake, snake!",23,9,1.99,14
722920,Hex Empire 3,66,17,9.99,49
827860,Destined,226,121,0.0,105
740200,The Mercury Man,476,92,3.99,384
519190,Next Day: Survival,6368,3733,9.99,2635
816810,Unlight:SchizoChronicle,58,29,0.0,29
805850,Wrecked,1771,525,0.0,1246
732810,Slipstream,1133,184,9.99,949
693700,Prime Mover,168,21,14.99,147
854060,Bob The Cube,16,11,3.99,5
858760,Scalak,760,20,1.99,740
758930,Captain Forever Trilogy,113,13,9.99,100
853500,Quarantine Circular,338,47,5.99,291
802730,Mother Simulator,455,89,1.99,366
516130,Runner3,185,59,19.99,126
849520,Rheum,16,3,2.99,13
575820,I Hate Running Backwards,159,40,14.99,119
636230,Safe House,13,19,9.99,-6
816090,Space Hulk: Deathwing Enhanced Edition,5298,2044,8.99,3254
620590,Ancestors Legacy,5324,1400,34.99,3924
526290,MY FIGHT,40,27,3.99,13
570940,DARK SOULS™: REMASTERED,60505,7460,39.99,53045
759540,Wanted Killer VR,104,23,9.99,81
753110,Chronicles of Vinland,59,86,0.0,-27
841320,Whitevale Defender,10,4,4.99,6
562500,Warstone TD,2546,548,14.99,1998
501790,Unforeseen Incidents,609,74,19.99,535
844930,Fox Hime Zero,3936,101,1.99,3835
783240,Die pig die,106,215,0.0,-109
834880,Acro FS,85,68,0.0,17
810660,The Office Quest,588,36,4.49,552
620220,Catmaze,356,59,9.99,297
837390,My zero trip,14,34,0.99,-20
808080,Ultimate Racing 2D,382,43,4.99,339
835040,美少女夏日欢乐!,37,9,1.99,28
838310,Bloodstained: Curse of the Moon,3359,190,9.99,3169
646500,Egypt: Old Kingdom,828,132,14.99,696
615400,Make It Rain: Love of Money,98,124,0.0,-26
860440,Goat Life,91,53,1.99,38
749800,PixelJunk™ Monsters 2,134,75,14.99,59
848150,Fury Fighter VR,0,7,9.99,-7
838220,Endersite,24,16,0.0,8
813700,Sakura Sadist,321,56,9.99,265
860650,Drizzlepath: Deja Vu,115,30,2.59,85
860190,Vietcong,9,33,0.0,-24
620190,Gunsmith,688,214,19.99,474
822830,Ouroboros,108,5,4.99,103
791400,From Village to Empire,19,9,7.99,10
446120,Bunker Punks,296,99,14.99,197
734980,Prosperity,73,15,9.99,58
496790,Nothin' But Net,5,2,4.99,3
614630,Tiny Rails,376,118,9.99,258
851050,Paper Dolls VR,49,36,15.99,13
577000,Witchcraft,6,0,4.99,6
586200,Street Fighter 30th Anniversary Collection,1348,595,29.99,753
431930,Kabounce,2319,220,14.99,2099
795160,Tsundere Idol,43,19,9.99,24
487720,Agony,1202,1304,14.99,-102
846820,Tell Me Everything,30,17,0.99,13
646010,Golem,20,11,14.99,9
863220,Anderson (Alpha),23,9,0.0,14
334940,Yoku's Island Express,3401,129,19.99,3272
827640,Trash Story,245,91,0.99,154
862110,Super Jigsaw Puzzle: Cities,64,1,0.74,63
606150,Moonlighter,11280,2241,4.79,9039
785890,Hexologic,658,26,1.04,632
613190,Unworthy,503,114,14.99,389
863980,ORIX!,66,47,0.99,19
742170,Dr. Frank's Build a Boyfriend,217,31,0.0,186
865190,HotFloor,26,11,0.99,15
556060,Detective Gallo,111,17,14.99,94
788260,Rules Of Survival,3148,1993,0.0,1155
861720,Trivia Vault: Food Trivia,35,33,9.99,2
820240,Save One More,101,58,4.99,43
711690,Cognizer,42,4,0.0,38
531510,Just Shapes & Beats,14532,326,19.99,14206
848310,Bitcoin Trading Master: Simulator,137,81,4.99,56
690620,Downward Spiral: Horus Station,98,27,19.99,71
834390,King's Heir: Rise to the Throne,115,37,14.99,78
718670,Cultist Simulator,6748,1863,19.99,4885
862690,"Kid,napper: Gosh, I'm Kidnapped by a Pupil",3579,422,0.0,3157
781820,Oik Memory 2,143,16,0.99,127
470090,Quantum Replica,57,49,7.99,8
841350,NALOGI 2,194,78,1.99,116
715210,The Pillage,48,7,2.99,41
828380,Death Mark Vol.1 - 死印之迷雾,34,9,9.99,25
792030,"Just, Bearly",439,28,0.0,411
678890,Airport Simulator 2019,38,96,5.99,-58
695100,Smoke and Sacrifice,284,79,3.99,205
642830,Milanoir,72,33,12.99,39
453910,Love is Dead,139,84,11.99,55
448850,Overload,1607,95,29.99,1512
860910,Hentai 3018,689,201,0.99,488
855010,270 | Two Seventy US Election,541,164,0.0,377
844920,Fortissimo FA,244,46,9.99,198
859090,Turbo Tunnel,131,17,0.0,114
574560,"Dude, Stop",1258,212,14.99,1046
857240,The Prison Experiment: Battle Royale,33,66,2.99,-33
864010,Space Force,14,10,0.51,4
375530,"Football, Tactics & Glory",2971,332,24.99,2639
848230,Let's Go Nuts!,26,3,0.0,23
742700,Empire Deluxe Combined Edition,95,12,19.99,83
757130,Paintball War,499,662,0.0,-163
856120,Next 4,107,7,0.99,100
861920,Rocket Valley Tycoon,107,66,0.0,41
859700,USA 2020,148,25,0.55,123
838900,Cereal Soup,318,386,0.0,-68
857130,Evolution,20,9,3.99,11
731720,DOOMED,70,51,6.99,19
427290,Vampyr,12934,4022,7.99,8912
653120,RockShot,174,202,0.0,-28
867700,The Wilting Amaranth,60,11,4.99,49
508410,SKIPCHASER,44,13,4.99,31
551700,Gunheart,243,70,14.99,173
836760,Sorcery Saga: Curse of the Great Curry God,78,23,19.99,55
849320,Tank Rush,9,68,0.99,-59
867480,Daddy,60,45,2.99,15
866520,Defense the Farm,34,22,0.99,12
869760,Stoneshard: Prologue,3045,439,0.0,2606
851180,Blood Harvest 3,148,37,19.99,111
856880,Fighting Fantasy Classics,164,46,0.0,118
823130,Totally Accurate Battlegrounds,63818,8831,0.0,54987
851790,AstronTycoon,22,8,0.0,14
865180,Reformers Intl Ver(变革者国际版),52,12,1.99,40
682570,SG/ZH: School Girl/Zombie Hunter,300,145,39.99,155
496040,Shaq Fu: A Legend Reborn,97,29,19.99,68
770810,"Good Pizza, Great Pizza - Cooking Simulator Game",944,87,14.99,857
858870,Queen of Seas 2,33,17,0.49,16
813820,Realm Royale,39622,12887,0.0,26735
853250,신기록 : A Compendium of Ghosts,79,6,0.0,73
527430,"Warhammer 40,000: Inquisitor - Martyr",11207,3721,49.99,7486
621020,Antigraviator,142,69,19.99,73
865880,天岚行 - Through the Mist and Sky,158,7,0.0,151
861240,Paper Valley,18,0,12.99,18
750360,Google Spotlight Stories: On Ice,36,2,0.0,34
813650,Runefall,103,9,9.99,94
750350,Google Spotlight Stories: Piggy,33,3,0.0,30
602910,One Wish,82,54,4.99,28
869840,Feather Of Praying 羽翼的祈愿,195,8,1.99,187
849800,Mermaid Mission: Titanic,30,3,0.0,27
866510,!AnyWay!,246,113,1.79,133
705280,Hakoniwa Explorer Plus,390,66,9.99,324
867140,WIN THE GAME: WTF!,127,33,0.99,94
752520,Football Nation VR Tournament 2018,16,12,14.99,4
524430,Skool Daze Reskooled,18,7,7.99,11
747360,Gray Dawn,546,102,19.99,444
846470,Moss,2499,133,19.49,2366
860860,Suicide Guy: Sleepin' Deeply,227,59,3.99,168
519080,Soda Girls,267,40,8.99,227
849680,TimeTekker,40,4,0.0,36
605740,"Flashing Lights - Police, Firefighting, Emergency Services Simulator",9682,1925,24.99,7757
648600,FINAL FANTASY XV WINDOWS EDITION MOD ORGANIZER,13,26,0.0,-13
868190,Sapper boom!,14,47,0.99,-33
679750,Catch & Release,290,31,19.99,259
775900,MotoGP™18,462,168,19.99,294
864300,qop 3,279,18,0.99,261
796860,Police Enforcement VR : 1-King-27,83,169,8.99,-86
817230,Acid Spy,131,14,5.99,117
837940,Mobile Forces,56,3,3.99,53
673560,IOSoccer,1382,309,0.0,1073
858060,Idle Heist,84,237,0.0,-153
813540,Scheming Through The Zombie Apocalypse: The Beginning,270,44,0.49,226
621880,Phoenix Dynasty 2,167,233,0.0,-66
823640,Gnomes Garden Lost King,37,33,4.99,4
785880,OVERWHELM,160,29,9.99,131
648350,Jurassic World Evolution,42476,6709,11.24,35767
673480,Timbertales,12,6,4.99,6
523650,Lust for Darkness,2354,1050,14.99,1304
702700,Super Bomberman R,270,234,39.99,36
801260,NOSTALGIC TRAIN,130,36,11.99,94
866420,TANKS,83,3,4.99,80
838510,Find & Destroy: Tank Strategy,72,45,0.0,27
692030,Tennis World Tour,251,400,29.99,-149
515180,Bus Simulator 18,8436,2045,24.99,6391
845210,Sim Racing Telemetry,38,14,0.0,24
710190,Puzzle Sisters Foer,52,15,0.99,37
874400,Dinosaur Hunt Puzzle,231,83,0.99,148
867250,Wars of Succession,21,4,29.99,17
837640,TapSonic World Champion VR,47,11,0.0,36
668350,Higurashi When They Cry Hou - Ch.6 Tsumihoroboshi,368,6,5.19,362
228380,Wreckfest,26775,3988,29.99,22787
400940,Budget Cuts,1293,320,29.99,973
718790,Warmonger,170,126,0.0,44
722190,EEP 14,12,11,0.0,1
862570,Ding Dong XL,634,18,0.99,616
818320,LEGO® The Incredibles,955,115,39.99,840
849940,Freefall Tournament,61,25,4.99,36
367240,Avenging Angel,21,34,17.99,-13
766280,A Light in the Dark,1476,96,14.99,1380
680860,Evil Labs,56,22,10.99,34
809440,Protolife,342,51,11.99,291
737710,Melody of Iris-虹色旋律-(Full Color ver.),103,9,29.99,94
586170,Mad Dojo,28,13,3.99,15
672710,Traffic Giant,72,26,2.99,46
884660,CRSED: F.O.A.D.,29567,7405,0.0,22162
567160,Katy and Bob: Safari Cafe,136,15,4.99,121
846700,The Legacy: Prisoner,46,5,6.99,41
489380,QuiVr,447,48,19.99,399
652660,ESport Manager,68,99,3.99,-31
574080,Fog of War,383,407,4.99,-24
823600,Battle Brawlers,110,81,0.0,29
820030,Picross Fairytale - nonogram: Red Riding Hood secret,308,92,4.99,216
873190,ЕСТЬ ДВА СТУЛА,1264,187,0.99,1077
780500,Suzy Cube,217,32,7.99,185
749780,DEAD DOZEN,235,347,0.0,-112
830490,Achievement Lurker: You are going to have to work hard for these nuts,34,15,1.99,19
547480,Carly and the Reaperman - Escape from the Underworld,159,12,19.99,147
717310,Aggelos,274,68,14.99,206
492180,Haimrik,189,39,9.99,150
842780,NavalArt,790,77,14.99,713
640850,AZORIAN KINGS,89,44,0.0,45
874830,School of Horror,12,42,1.99,-30
829420,Fun Hospital,274,173,0.0,101
878250,Super Jigsaw Puzzle: Monuments,36,2,0.74,34
509400,Lost in Harmony,27,4,6.99,23
880200,J15 Jet Fighter VR (歼15舰载机),20,20,9.99,0
873230,The King's Request: Physiology and Anatomy Revision Game,146,10,0.0,136
845070,The Awesome Adventures of Captain Spirit,11635,913,0.0,10722
617590,Affliction,27,21,2.99,6
690530,灵魂筹码 Soul at Stake,6263,1977,17.99,4286
873970,Virtual Families 2: Our Dream House,14,11,7.99,3
851670,LUMINES REMASTERED,372,23,14.99,349
640120,Youropa,444,71,7.99,373
871720,Ultimate Custom Night,40588,1848,0.0,38740
820910,Last Resort Island,133,15,8.99,118
704230,Pro Cycling Manager 2018,292,96,14.99,196
646910,The Crew™ 2,48965,11781,49.99,37184
868780,"I, Cyborg",24,5,5.99,19
667810,Next Up Hero,99,79,19.99,20
815320,Catify VR,28,14,4.99,14
878520,Sally's Salon: Kiss & Make-Up,66,27,12.99,39
783120,HELLO LADY!,736,34,29.99,702
798290,MXGP PRO,772,149,24.99,623
791990,MOBA GM,15,14,0.0,1
826230,CONCLUSE,296,93,0.0,203
867380,Up Left Out,330,22,1.99,308
825380,强军,88,410,0.0,-322
645330,Frontline Heroes VR,6,14,0.99,-8
731490,Crash Bandicoot™ N. Sane Trilogy,12221,940,39.99,11281
714800,Maitetsu,306,17,14.99,289
628730,Adolescent Santa Claus,962,182,0.0,780
871100,Animyst,111,26,0.0,85
886360,Casino Mega Collection,17,11,6.99,6
667040,Alicia Quatermain 2: The Stone of Fate,63,5,2.99,58
460060,Varenje,1073,154,0.0,919
857690,Lagoon Lounge : The Poisonous Fountain,453,29,13.99,424
887160,The Sunny Day 晴天,59,3,1.99,56
705740,Car Demolition Clicker,78,48,6.99,30
552110,Puzzle Pirates: Dark Seas,364,126,0.0,238
595770,AirMech Wastelands,230,91,14.99,139
698540,Dungeon Warfare 2,757,78,14.99,679
569720,TUNNEL DIVERS,117,17,0.0,100
846800,Diner Bros,561,72,9.99,489
872990,Stream Games,43,4,4.99,39
878580,GARAGE: Bad Trip,349,184,14.99,165
882960,Visitor 来访者,589,153,3.99,436
846880,The Chronicles of Quiver Dick,176,10,1.94,166
857510,Knife Flipping,12,8,0.99,4
879250,Dot to Dot Puzzles,123,30,0.0,93
891200,Bike Dash Excite!,20,18,0.0,2
809890,Shining Resonance Refrain,770,316,29.99,454
884640,Mines and Magic,41,14,7.99,27
867490,Remyadry,481,62,9.99,419
466860,上帝之城 I：监狱帝国 [City of God I - Prison Empire],1310,550,18.99,760
514830,Stifled - Echolocation Horror Mystery,71,23,19.99,48
375440,Hero-U: Rogue to Redemption,441,33,29.99,408
876470,Tentlan,57,61,0.0,-4
690610,MagiCats Builder (Crazy Dreamz),123,72,0.0,51
605920,VOLTED,115,23,4.99,92
666310,Space of Darkness,45,52,0.0,-7
875110,InfiniPicross 2.0,19,3,4.99,16
315460,Dig or Die,3521,362,11.99,3159
743090,Defiance 2050,1113,1178,0.0,-65
780100,ClearMem :: Free Up Your RAM,134,53,9.99,81
826160,ButcherBoy,53,40,0.99,13
845880,Touhou: Scarlet Curiosity,922,68,14.99,854
446850,Mindball Play,67,18,4.99,49
865850,Dehumanized,82,38,1.99,44
625740,Rifter,104,4,11.99,100
415590,Earthfall,1446,768,19.99,678
800240,Ghostly Matter,25,13,9.99,12
684200,Icons: Legacy Edition,417,581,0.0,-164
868080,Golf Galore,245,59,0.99,186
862480,The Spiral Scouts,440,91,9.99,349
489630,"Warhammer 40,000: Gladius - Relics of War",4912,1242,39.99,3670
859340,Seeking Dawn,521,238,29.99,283
795510,Koihime Enbu RyoRaiRai 恋姫†演武 ～遼来来～,114,9,11.99,105
728540,Islands of Nyne: Battle Royale,3480,3386,0.0,94
763250,The Spectrum Retreat,168,57,12.99,111
809000,Art of Murder - FBI Confidential,112,50,4.99,62
817720,Cricket Captain 2018,43,27,9.99,16
327090,Out of Reach,1730,1243,14.99,487
837590,Operation Thunderstorm,151,59,4.99,92
859440,Mars or Die!,32,35,19.99,-3
832540,Art of Murder - Hunt for the Puppeteer,84,30,4.99,54
857180,The Cooking Game VR,37,15,14.99,22
885640,Lynne,660,185,0.0,475
833360,Star Valor,873,78,14.99,795
861710,Geometry Rush,83,11,0.99,72
837090,Chronicles of Mystery - The Tree of Life,31,16,4.99,15
889770,UnHolY DisAsTeR,247,54,12.99,193
867120,Lilipalace,71,32,12.99,39
805940,RUSSIA BATTLEGROUNDS,2624,758,0.99,1866
836770,Art of Murder - Cards of Destiny,79,37,4.99,42
598700,The Vagrant,5912,601,3.99,5311
844040,RUSH,160,30,4.99,130
673190,All-Star Fruit Racing,137,56,2.99,81
886460,Outside the Lines,133,30,0.0,103
839630,Survisland / 实境求生,833,444,14.99,389
635390,Thief of Thieves,107,33,19.99,74
629910,Clicker Heroes 2,1524,1070,19.99,454
850230,Women's Soccer/Football Manager,65,31,0.0,34
744060,Groove Coaster,993,427,19.99,566
786450,Don't Bite Me Bro! +,193,56,0.99,137
846690,Lost Lands: Ice Spell,68,6,6.99,62
712180,Mugsters,58,25,1.94,33
728240,Adventure Time: Pirates of the Enchiridion,418,50,24.99,368
762490,Naked Sun,75,21,5.99,54
754340,Paper Dungeons Crawler,30,11,9.99,19
890570,Almost Alive,169,46,11.99,123
574090,MOTHERGUNSHIP,1095,305,24.99,790
428080,Racket: Nx,463,18,7.99,445
866260,EreaDrone 2018,17,32,0.0,-15
710690,The Path of Motus,14,2,14.99,12
290510,GNOG,720,61,9.99,659
688140,Tempest 4000,92,46,19.99,46
821670,Horse Farm,118,92,0.0,26
893730,Viki Spotter: Camping,193,7,0.0,186
576960,🧠 OUT OF THE BOX,110,26,14.99,84
537340,Guts and Glory,1758,444,14.99,1314
811270,Impulsion,201,22,12.99,179
869350,Because We're Here - Act I,82,4,5.99,78
810640,Radiis,68,7,14.99,61
837610,Mary Skelter: Nightmares,421,54,24.99,367
867050,Endless Fables 3: Dark Moor,118,22,14.99,96
522240,Pool Panic,242,65,14.99,177
828070,Treasure Hunter Claire,1717,188,19.99,1529
801040,Poly Universe,100,13,9.99,87
873240,Hentai Memory,948,104,0.59,844
851890,Gal*Gun 2,1109,146,29.99,963
847530,HyperBowl,40,2,0.99,38
893030,Music Racer,3102,393,1.99,2709
885440,Easy Audio Visualization,55,15,2.99,40
531180,AIRHEART - Tales of broken Wings,138,26,14.99,112
871570,Summer Memory of Bell,185,7,2.99,178
854870,Perseverance: Part 1,67,11,0.0,56
879650,Stick Arena,66,44,0.0,22
743890,Mega Man X Legacy Collection,1925,617,19.99,1308
859350,Aces of the Luftwaffe - Squadron,58,18,14.99,40
700160,Semblance,231,30,9.99,201
743900,Mega Man X Legacy Collection 2,1005,293,19.99,712
663300,Enlightenment,298,157,11.99,141
253250,Stonehearth,8503,2642,19.99,5861
813930,Revoke,17,7,19.99,10
587110,Ys: Memories of Celceta,563,38,24.99,525
836450,Heaven Will Be Mine,326,23,14.99,303
898340,Puzzles and Board Games Mega Collection,6,8,6.99,-2
630030,War Tech Fighters,236,66,19.99,170
889730,Downtown Mafia: Gang Wars,80,39,0.0,41
873980,Isle of Skye,85,39,6.99,46
897800,Arcane Golf,40,1,2.99,39
886070,Jewel Match Solitaire,88,7,9.99,81
858940,Flowers -Le volume sur ete-,884,1,19.99,883
419990,Ganbare! Super Strikers,53,8,9.99,45
890070,秋色的記憶(體驗版) / Fall...in Love (Demo),137,10,0.0,127
485460,The Banner Saga 3,1875,409,24.99,1466
466110,Shaolin vs Wutang,855,73,13.99,782
708820,Baby Hands,44,14,19.99,30
865930,BQM - BlockQuest Maker-,121,27,9.99,94
755670,Sleep Tight,43,10,4.99,33
885120,Werewolves: Haven Rising,69,8,5.99,61
899970,NEKOPARA Extra,3129,75,4.99,3054
825310,Dude Simulator 2,996,832,0.49,164
868580,Arkhangel: The House of the Seven Stars,39,12,4.99,27
848500,Sniper Strike: Special Ops,155,116,0.0,39
898160,Hotel Remorse,187,51,0.0,136
567150,Mosaics Galore,68,20,0.49,48
889240,Loot Box Simulator,59,18,0.0,41
892630,Mojo: Hanako,609,152,0.0,457
896380,Before Nightfall,51,33,0.99,18
835430,La-Mulana 2,651,108,24.99,543
896980,Whispered Secrets: Golden Silence Collector's Edition,3,1,9.99,2
312200,Chasm,1476,566,19.99,910
888040,Metal Fatigue,298,20,5.99,278
747350,Hellblade: Senua's Sacrifice VR Edition,1052,150,0.0,902
785740,This Is the Police 2,3727,1238,14.99,2489
668980,Forsaken Remastered,141,17,19.99,124
335620,Star Traders: Frontiers,2616,456,14.99,2160
545620,Anamorphine,25,17,8.99,8
760320,Gunman Tales,51,19,7.99,32
638970,Yakuza 0,48819,2533,19.99,46286
734570,Bitcoin Tycoon - Mining Simulation Game,55,37,9.99,18
759440,Learn Japanese To Survive! Kanji Combat,226,35,8.99,191
686720,SaGa SCARLET GRACE: AMBITIONS™,132,38,29.99,94
820040,Picross Fairytale: Legend of the Mermaid,37,25,4.99,12
661940,Regular Human Basketball,280,61,4.99,219
318100,AXYOS,1193,1102,4.99,91
856620,V-Katsu,472,59,0.0,413
809280,Grimmwood - They Come at Night,134,105,0.0,29
838180,MechCorp,52,12,8.99,40
905060,Turret Tech,25,13,5.99,12
893520,Creative Destruction,14769,4085,0.0,10684
896590,MilMo,433,108,0.0,325
719750,PUSS!,989,134,3.39,855
762610,Russian Subway Dogs,212,4,14.99,208
897690,Ding Dong VR,69,4,2.99,65
704640,Evolution of Ages: Settlements,239,39,8.99,200
886040,Hentai Temple,381,154,0.99,227
895600,Mojo,81,13,2.99,68
874240,MU Legend,1795,1848,0.0,-53
588650,Dead Cells,106495,3213,24.99,103282
905650,Dominus 2,30,15,0.0,15
899610,"So, uh... a spaceship crashed in my yard.",199,13,0.0,186
626660,Flipping Death,154,17,19.99,137
882790,Fate Seeker,10881,1027,21.09,9854
706560,Jimmy and the Pulsating Mass,367,27,14.99,340
876330,Revelation Online,357,407,0.0,-50
728880,Overcooked! 2,37048,3957,24.99,33091
691160,Electronauts - VR Music,412,31,19.99,381
336140,Unavowed,1629,64,14.99,1565
834740,Circle Empires,2745,325,7.99,2420
517210,Bad Pad,35,5,11.99,30
467820,Zero G Arena,661,76,9.99,585
779640,妄想症：Deliver Me,1639,211,1.99,1428
582010,Monster Hunter: World,306872,51885,29.99,254987
736220,Post Scriptum,14035,4288,29.99,9747
449100,City of the Shroud,19,5,0.0,14
892650,Play With Kizami,182,123,0.0,59
761700,Your Diary +,126,17,24.99,109
880400,Lingering Fragrance,493,43,3.99,450
320240,We Happy Few,8334,2619,59.99,5715
285920,TerraTech,16003,1692,24.99,14311
690140,Sword Legacy: Omen,401,201,17.99,200
821890,Steven Universe: Save the Light,900,86,24.99,814
356650,Death's Gambit: Afterlife,3355,764,19.99,2591
866800,The Walking Dead: The Final Season,13094,760,19.99,12334
888090,TREE,1874,111,0.0,1763
914620,Mist Survival,7404,1821,10.99,5583
16900,GROUND BRANCH,7942,823,29.99,7119
843260,The Bard's Tale Trilogy,1060,50,14.99,1010
559100,Phantom Doctrine,2889,971,39.99,1918
686260,Forged Battalion,605,420,3.99,185
859150,幻想三國誌5/Fantasia Sango 5,146,77,29.99,69
893050,Hasbro's BATTLESHIP,258,58,9.99,200
813450,Barbearian,64,11,14.99,53
837190,Tanglewood,77,3,17.99,74
437630,State of Mind,1446,370,1.99,1076
905690,魔物讨伐团,241,135,12.99,106
600460,Dustwind,240,79,24.99,161
599140,Graveyard Keeper,23716,3895,19.99,19821
779100,Daemonical,148,73,14.99,75
576500,Evergarden,565,88,9.99,477
876850,WhiteLily 1：丽丽公主,1144,63,2.99,1081
342560,Airships: Conquer the Skies,4006,167,24.99,3839
882710,東方幕華祭 TouHou Makuka Sai ~ Fantastic Danmaku Festival,1061,31,8.99,1030
741430,Titanic VR,178,40,19.99,138
886960,Dragon Spear,543,325,14.99,218
727720,Found Horror Game 11.exe,40,14,3.99,26
680750,Destination Primus Vita - Ep. 1,69,22,0.0,47
787040,Perfect Heist,287,104,4.99,183
878750,Hentai Girl,4662,450,0.99,4212
733790,Not Tonight,1504,268,19.99,1236
913010,Your Dry Delight,501,23,0.0,478
857940,Nature Calls,450,61,6.99,389
524250,Dad Quest,119,16,12.99,103
695970,Treadnauts,152,20,14.99,132
799870,Neko Dungeon | 喵酱迷城 | 喵醬迷城 | ねこダンジョン,27,20,7.99,7
528060,東周列萌志 Philosophic Love,688,63,0.0,625
907680,Wwbit,710,566,0.0,144
897330,Coloring Pixels,5053,186,0.0,4867
904990,21+,137,149,0.99,-12
889040,FPV Air 2,184,61,0.0,123
891350,JUST DASH,19,12,1.49,7
573370,Tyler: Model 005,41,23,9.99,18
658470,Mini Battlegrounds,367,205,0.0,162
846050,Silent Depth 3D Submarine Simulation,27,23,9.99,4
885380,Need a packet?,23,15,1.39,8
638650,Sword Art Online Re: Hollow Fragment,1350,330,19.99,1020
857320,SRPG Studio,140,27,59.99,113
895220,Leaflet Love Story,636,58,2.99,578
263720,Brawlout,562,194,19.99,368
801630,UNDER NIGHT IN-BIRTH Exe:Late[cl-r],2813,179,24.99,2634
758330,Shenmue I & II,2030,269,29.99,1761
783590,Age of Gladiators II: Rome,149,71,19.99,78
534550,Guacamelee! 2,2307,224,19.99,2083
896460,Lucah: Born of a Dream,347,16,14.99,331
765410,Bean Battles,7417,413,0.99,7004
616250,Crystalline,1249,63,19.99,1186
377260,Unearned Bounty,216,105,0.0,111
788700,ValeGuard,112,46,9.99,66
798830,The Commission: Organized Crime Grand Strategy,20,26,4.99,-6
812550,The King's Bird,322,132,19.99,190
867180,Tilesweeper,247,38,4.99,209
857450,ISLAND,1145,45,39.99,1100
792100,7 Billion Humans,1280,94,14.99,1186
709240,Ingnomia,152,51,0.0,101
783450,HYPERGUN,40,28,9.99,12
896030,Fortissimo FA INTL Ver,85,31,9.99,54
863430,One Person Story,19,1,4.99,18
883860,Cadria Item Shop,965,368,0.0,597
737800,F1 2018,11269,1410,0.0,9859
920520,Sexy Jigsaw | 性感拼图 | 섹시 퍼즐 | セクシーなパズル,182,32,3.99,150
622440,Pandemic: The Board Game,392,260,0.0,132
691320,Gun Club VR,450,113,19.99,337
312670,Strange Brigade,4732,859,49.99,3873
858590,Last Tide,738,416,24.99,322
565170,Blade Strangers,180,57,19.99,123
893390,Meridian 59,188,35,0.0,153
702670,Donut County,5756,629,12.99,5127
557520,Torn,125,64,5.99,61
695290,The Golf Club™ 2019 featuring PGA TOUR,1736,557,12.49,1179
490930,Need to Know,176,85,14.99,91
513710,SCUM,55204,18887,34.99,36317
401970,Hypatia,31,16,0.0,15
535930,Two Point Hospital,25802,2407,34.99,23395
919200,Special Warfare - 特战之王,49,27,1.99,22
770240,PRO EVOLUTION SOCCER 2019,3173,2732,0.0,441
914170,Duck Life: Battle,172,24,3.99,148
808290,Runes of Magic,694,366,0.0,328
885780,Legion's Crawl,33,9,4.99,24
912370,Mahjong Club,232,93,4.99,139
895420,Path of Sin: Greed,177,24,14.99,153
340840,The Corridor: On Behalf Of The Dead,23,8,14.99,15
923140,"Elven Magic: The Witch, The Elf & The Fairy",1,1,0.79,0
633230,NARUTO TO BORUTO: SHINOBI STRIKER,40108,6561,49.99,33547
912560,PROZE: Prologue,76,17,0.0,59
468920,Ultimate Fishing Simulator,4757,545,19.99,4212
917680,"one night, hot springs",2012,76,0.0,1936
772430,Hero of the Kingdom III,935,232,9.99,703
906810,Music Maker Steam Edition,298,293,0.0,5
783210,Aggressors: Ancient Rome,196,40,29.99,156
764790,The Messenger,7250,436,19.99,6814
661920,Claybook,171,69,9.99,102
909430,Travel Riddles: Mahjong,15,13,0.0,2
769950,Panzer Strategy,305,160,29.99,145
817680,Real Drift,49,55,1.99,-6
586920,Empyrean Frontier,12,5,11.99,7
675170,303 Squadron: Battle of Britain,213,143,19.99,70
537630,Tee Time Golf,128,27,9.99,101
585450,Shadows: Awakening,1626,509,29.99,1117
885030,Platform Builder,35,5,0.0,30
916040,SFD : Rogue TRPG,76,9,7.99,67
724390,Rigid Force Alpha,83,19,19.99,64
914690,Hentai Shooter 3D,419,123,0.49,296
575900,Mosaics Galore 2,60,8,4.99,52
900050,Amber's Airline - High Hopes,90,17,12.99,73
907520,ABC Paint,0,1,9.99,-1
844330,The Goatman,263,119,4.99,144
825500,Dead Ground:Arena,16,6,14.99,10
661790,Witch Hunt,1687,218,7.99,1469
648580,428: Shibuya Scramble,1013,64,49.99,949
650510,ZONE OF THE ENDERS THE 2nd RUNNER : M∀RS / アヌビス ゾーン・オブ・エンダーズ : マーズ,501,207,29.99,294
924650,Hifuu Nightmare Diary ~ Violet Detector.,201,67,10.99,134
485030,PLANET ALPHA,615,254,6.24,361
742120,DRAGON QUEST® XI: Echoes of an Elusive Age™ - Digital Edition of Light,7416,1191,0.0,6225
718560,Scythe: Digital Edition,2608,300,19.99,2308
925050,Crystal Path,4,0,6.99,4
630140,Sky Clash: Lords of Clans 3D,146,38,0.0,108
883100,360 No Scope Arena,596,69,0.99,527
790350,The Inner Friend,47,7,14.99,40
897030,Paratopic,1140,395,2.74,745
888630,Another Sight - Definitive Edition,123,35,5.99,88
510390,Unknown Fate,41,19,9.99,22
799960,Wizard101,3782,912,0.0,2870
753370,Regenesis Arcade,16,6,7.99,10
905450,NASCAR Heat 3,326,119,12.99,207
891510,Love's Sweet Garnish,638,34,12.99,604
687630,Epic Cards Battle 2 (TCG),67,45,0.0,22
465020,Sector Six,208,12,9.0,196
369440,Immortal: Unchained,491,230,10.99,261
889480,Virtual Virtual Reality,506,46,14.99,460
930480,Mushroom rain,10,3,24.99,7
931090,Slither Link,29,0,0.99,29
884260,Akane,1963,80,4.99,1883
878380,Touhou Big Big Battle,3027,706,0.0,2321
841370,NBA 2K19,8926,13908,0.0,-4982
686200,Door Kickers: Action Squad,7636,408,13.99,7228
889260,Bonkies,26,0,14.99,26
782570,无尽之路,348,115,9.99,233
658550,Zup! Zero 2,888,50,0.99,838
324510,Boundless,1864,771,39.99,1093
611180,Super Street: The Game,147,164,24.99,-17
886730,EPHEMERAL -FANTASY ON DARK-,54,9,39.99,45
588560,VRobot: VR Giant Robot Destruction Simulator,51,36,14.99,15
932420,Russpuppy Kid Games,19,0,4.99,19
790710,World of Warplanes,2277,759,0.0,1518
640210,Just One Line,79,32,0.0,47
618760,IronBorn,23,8,0.49,15
795610,Gift of Parthax,34,40,6.99,-6
787740,Construction Simulator 2 US - Pocket Edition,377,135,11.99,242
858040,Sudoku Jigsaw / 拼图数独,130,12,1.99,118
675240,Shining Song Starnova,275,18,29.99,257
371650,COLINA: Legacy,140,32,4.99,108
891860,Riddles of the Owls Kingdom,98,35,0.0,63
714080,BLACK CLOVER: QUARTET KNIGHTS,538,149,49.99,389
410340,Liftoff: FPV Drone Racing,5357,393,19.99,4964
398030,Old School Musical,635,60,12.99,575
766370,Dying Light: Bad Blood,2519,1075,0.0,1444
761460,Lamplight City,500,55,14.99,445
600480,Megaquarium,2340,138,24.99,2202
918670,Jewel Match Twilight Solitaire,84,6,9.99,78
445020,Frozen Synapse 2,153,75,29.99,78
890031,Shadow of the Tomb Raider: Definitive Edition,12551,4648,0.0,7903
849166,Shadow of the Tomb Raider: Definitive Edition,11068,4489,0.0,6579
849179,Shadow of the Tomb Raider: Definitive Edition,11059,4481,0.0,6578
849168,Shadow of the Tomb Raider: Definitive Edition,10702,4361,0.0,6341
885140,七人杀阵 - Seven Sacrifices,695,151,6.99,544
630610,Disneyland Adventures,401,42,19.99,359
905320,Shadow of the Tomb Raider: Definitive Edition,13045,4827,0.0,8218
849186,Shadow of the Tomb Raider: Definitive Edition,12558,4646,0.0,7912
849176,Shadow of the Tomb Raider: Definitive Edition,11036,4467,0.0,6569
849178,Shadow of the Tomb Raider: Definitive Edition,13036,4825,0.0,8211
849165,Shadow of the Tomb Raider: Definitive Edition,10646,4341,0.0,6305
806950,Victory At Sea Pacific,341,217,39.99,124
888070,Railroad Tracks,24,17,0.0,7
797430,HD Poker: Texas Hold'em,2797,550,0.0,2247
849200,Shadow of the Tomb Raider: Definitive Edition,12657,4677,0.0,7980
849160,Shadow of the Tomb Raider: Definitive Edition,12888,4777,0.0,8111
849162,Shadow of the Tomb Raider: Definitive Edition,10636,4336,0.0,6300
537450,ReCore: Definitive Edition,680,413,19.99,267
849161,Shadow of the Tomb Raider: Definitive Edition,12577,4653,0.0,7924
849167,Shadow of the Tomb Raider: Definitive Edition,12741,4710,0.0,8031
579490,RUSH: A Disney • PIXAR Adventure,141,52,19.99,89
931630,Viki Spotter: Zoo,36,5,3.99,31
890030,Shadow of the Tomb Raider: Definitive Edition,12819,4747,0.0,8072
849164,Shadow of the Tomb Raider: Definitive Edition,12612,4661,0.0,7951
750920,Shadow of the Tomb Raider: Definitive Edition,51870,10026,0.0,41844
890032,Shadow of the Tomb Raider: Definitive Edition,12888,4776,0.0,8112
849177,Shadow of the Tomb Raider: Definitive Edition,12734,4710,0.0,8024
847360,Super Lucky's Tale,442,69,29.99,373
613880,Zoo Tycoon: Ultimate Animal Collection,909,538,19.99,371
370350,LOTUS-Simulator,305,273,49.99,32
849163,Shadow of the Tomb Raider: Definitive Edition,10785,4398,0.0,6387
926070,Fear for Sale: City of the Past Collector's Edition,5,0,9.99,5
648050,Super Pilot,103,10,12.99,93
811870,Verlet Swing,505,57,14.99,448
823550,Booty Calls,255,294,0.0,-39
834280,Fishing Sim World®: Pro Tour,680,196,19.99,484
738650,Seers Isle,143,8,12.99,135
646270,60 Parsecs!,2101,333,4.99,1768
459830,Final Days,76,8,4.99,68
468670,Speed Brawl,117,20,19.99,97
925550,Cross Racing Championship Extreme,52,6,9.99,46
233610,Distance,6026,464,24.99,5562
647570,Transference™,268,106,4.99,162
406860,Blind,75,33,24.99,42
910320,Three Kingdoms 2019 阿达三国志2019 横版,242,75,0.0,167
566090,The Bard's Tale IV: Barrows Deep,986,481,0.0,505
566540,Labyrinth of Refrain: Coven of Dusk,649,179,49.99,470
600990,The Gardens Between,1927,123,19.99,1804
331360,Heavy Metal Machines,2928,985,0.0,1943
792930,Age of Viking Conquest,24,14,4.99,10
932570,阿比斯的宝藏 - Treasure of abyss,110,17,6.99,93
625860,God Awe-full Clicker,235,117,0.0,118
853770,Maximum Action,2717,297,14.99,2420
573320,Underhero,869,113,14.99,756
922320,Sniper 3D Assassin: Free to Play,808,496,0.0,312
773530,Magic Nations - Card Game,89,35,14.99,54
368340,CrossCode,11740,708,19.99,11032
838350,太吾绘卷 The Scroll Of Taiwu,30715,9379,19.99,21336
881690,The Slater,553,190,1.99,363
646680,Roman Adventures: Britons. Season 1,25,2,5.99,23
880940,Pummel Party,34324,4108,14.99,30216
909080,Cube Escape: Paradox,6654,176,0.0,6478
271260,Star Control®: Origins,1683,636,29.99,1047
488550,Dream Car Builder,819,65,9.99,754
587220,Jet Island,1411,62,19.99,1349
929670,Orion Sandbox Enhanced,285,26,1.99,259
935560,Hentai Strip Shot,26,0,1.19,26
880950,Maitetsu:Pure Station,2933,93,9.74,2840
907770,STONE,58,22,9.99,36
855640,My Brother Rabbit,1282,44,14.99,1238
779130,Virtual Fighting Championship (VFC),118,41,19.99,77
894630,Final Theory,255,60,3.59,195
930320,Oops!!! I Slept With Your Mom,25,7,1.99,18
925940,Myst IV: Revelation,120,44,14.99,76
692360,Tales of Wedding Rings VR,59,16,19.99,43
738530,New Gundam Breaker,885,1121,9.99,-236
939620,Pleasure Puzzle:Portrait 趣拼拼：肖像画,1507,141,0.99,1366
925930,Myst III: Exile,274,17,14.99,257
790820,Valkyria Chronicles 4 Complete Edition,4616,655,49.99,3961
822470,属性与生活,20,13,0.99,7
948420,EXAPUNKS: TEC Redshift Player,21,2,0.0,19
368620,Timespinner,1843,291,19.99,1552
767390,Dakar 18,607,286,29.99,321
921780,The Dark Occult,639,284,14.99,355
804490,Creed: Rise to Glory™,1267,329,29.99,938
889080,Deity Empires,245,30,24.99,215
640820,Pathfinder: Kingmaker - Enhanced Plus Edition,21824,6001,8.99,15823
658700,V-Rally 4,421,230,29.99,191
794600,LET IT DIE,3531,1274,0.0,2257
938240,Cthulhu Mythos RPG -The Sleeping Girl of the Miasma Sea-,19,2,6.99,17
339090,Pig Eat Ball,69,2,14.99,67
332950,Dark Deception,11057,1241,0.0,9816
770410,Path to Mnemosyne,133,44,0.99,89
532210,Life is Strange 2,23240,4158,0.0,19082
698640,Deep Sky Derelicts,1670,545,2.99,1125
351100,Niffelheim,1525,578,19.99,947
523640,The Works of Mercy,84,130,6.99,-46
530320,Wandersong,2606,119,19.99,2487
783170,INSOMNIA: The Ark,693,444,29.99,249
636320,Depth of Extinction,138,48,2.99,90
826600,I am not a Monster: First Contact,896,241,10.99,655
630720,Mana Spark,441,112,11.99,329
906050,Hentai Case Opening,54,29,0.99,25
591680,Taphouse VR,190,15,0.0,175
913590,Dimension Drifter,44,9,12.99,35
818070,Draoi,0,1,19.99,-1
859680,Deep Space Waifu: FANTASY,815,28,3.99,787
596740,Origin Space,14,14,0.99,0
883130,New Star Manager,311,42,19.99,269
737890,Catastronauts,128,50,15.99,78
926170,Achromatic,36,11,4.99,25
809020,ZeroRanger,1099,46,11.99,1053
936700,Ms. Squeaker's Home for the Sick,24,0,3.99,24
736190,Chinese Parents,20658,1832,9.99,18826
904960,Cine Tracer,253,116,89.99,137
932330,Alchemia,33,10,0.59,23
879510,Lucy Got Problems,683,67,7.99,616
774541,"Species: Artificial Life, Real Evolution",564,215,19.99,349
882670,Nono's magic general shop,36,22,7.99,14
933300,Wuxia Master,248,223,10.0,25
927310,巴伦西亚传说：索菲亚的重生 Valencia Saga:Sophia's rebirth,186,44,6.99,142
868410,DAISENRYAKU PERFECT 4.0,29,63,59.99,-34
562430,Alien Hostage,79,50,2.99,29
644370,Howard Phillips Lovecar,30,6,1.99,24
770110,Twilight Path,117,22,14.99,95
742300,Mega Man 11,3110,292,29.99,2818
819790,Laplace：拉普拉斯的神子,60,40,0.0,20
521090,Industry Giant,35,12,2.99,23
605450,In Death,800,139,29.99,661
585190,A Gummy's Life,144,32,7.99,112
767930,Assault Spy,541,47,19.99,494
785850,Valthirian Arc: Hero School Story,172,111,14.99,61
918740,Flat Trip,20,1,0.0,19
929320,RHEM II SE: The Cave,31,1,9.99,30
943170,Blast the Past,112,17,0.0,95
545600,Vigilantes,220,49,5.99,171
943640,Sacred Saga Online,8,28,0.0,-20
874460,Achtung! Cthulhu Tactics,131,57,24.99,74
572010,No Way Out,40,62,0.99,-22
705380,Galactic Shipwright,21,3,5.99,18
812140,Assassin's Creed® Odyssey,110863,13470,59.99,97393
894460,Crimson Gray: Dusk and Dawn,88,7,4.99,81
880380,Franchise Hockey Manager 5,91,65,19.99,26
598960,Mashinky,2022,306,24.99,1716
841460,The Great C,194,24,5.99,170
773090,Lucid Dream Adventure,163,35,5.99,128
817130,WWE 2K19,2766,963,0.0,1803
943810,Chaos Sector 混沌宙域,57,14,1.99,43
727570,After the Collapse,83,19,14.99,64
346750,Merchant,374,101,0.0,273
930310,Puzzle Plunder,118,18,0.0,100
492230,Space Hulk: Tactics,488,248,14.99,240
651500,My Memory of Us,619,48,3.59,571
752470,CINERIS SOMNIA,126,32,14.99,94
745560,Overclocked,290,22,0.0,268
860950,Mark of the Ninja: Remastered,4122,157,19.99,3965
594050,Red Alliance,167,46,5.99,121
952250,SEPTEMBER 1999,1584,250,0.0,1334
949790,Rogue Bit,89,8,4.99,81
885150,Capcom Beat 'Em Up Bundle,811,118,19.99,693
747620,Joggernauts,77,12,14.99,65
842910,The MISSING: J.J. Macfield and the Island of Memories,948,110,29.99,838
681330,Helium Rain,180,42,14.99,138
865090,AHEGAL,662,96,1.99,566
887530,President Yukino,498,131,14.99,367
673950,Farm Together,16575,1030,19.99,15545
948630,Hentai MineSweeper,545,87,0.99,458
851800,G2 Fighter / 基因特工,2454,495,15.99,1959
481870,Mini Thief,292,115,1.75,177
943380,Timberman VS,2808,236,1.99,2572
947300,Grim Nights,1117,127,2.99,990
835860,Dreadnought,3874,1963,0.0,1911
935070,Sakura MMO,234,37,9.99,197
815210,Tiny-Tasy Town,116,77,1.99,39
907270,eSports Legend,716,423,9.99,293
726590,NBA 2K Playgrounds 2,1374,336,29.99,1038
792660,The Operational Art of War IV,191,43,39.99,148
841770,Siralim 3,894,52,14.99,842
528460,Rogalia,336,143,0.0,193
933070,Cold Blooded Cube,43,28,1.99,15
831560,WARRIORS OROCHI 4,4038,612,59.99,3426
944120,Abalyte,127,64,0.0,63
621940,Unleash,48,13,0.0,35
829110,LEGO® DC Super-Villains,3633,366,39.99,3267
899760,Her 她,67,7,3.99,60
772530,Crayola Scoot,38,8,19.99,30
510420,The Hex,2315,143,9.99,2172
946010,Tasty Planet Forever,176,27,12.99,149
753930,God's Basement,779,268,14.99,511
774461,The Jackbox Party Pack 5,1930,140,29.99,1790
946090,Hentai Neighbors,228,29,0.99,199
294100,RimWorld,133389,2318,34.99,131071
935270,Great Hero's Beard,993,150,0.0,843
596200,Blood 'n Bikinis,26,9,9.99,17
611860,Aborigenus,63,21,3.99,42
645730,RESONANCE OF FATE™/END OF ETERNITY™ 4K/HD EDITION,567,133,34.99,434
800270,Terraforming Mars,3408,1161,19.99,2247
692100,Infliction,484,95,19.99,389
816340,Kingdom Rush Origins - Tower Defense,4343,193,14.99,4150
934920,SparkChess,1,2,18.99,-1
653530,Return of the Obra Dinn,16580,547,19.99,16033
601540,Veil of Crows,255,200,14.99,55
871990,BattleRush 2,408,211,7.49,197
897820,Reigns: Game of Thrones,698,203,3.99,495
904310,Initial 2 : New Stage,289,132,24.99,157
916160,Dreamwalker: Never Fall Asleep,139,33,14.99,106
544750,SOULCALIBUR VI,8625,1918,13.49,6707
943410,Istanbul: Digital Edition,186,12,11.99,174
510500,Executive Assault 2,768,148,24.99,620
954270,LOGistICAL 2,55,23,0.0,32
844950,Eternal Fantasy,32,10,9.99,22
922700,Hidden Animals: Photo Hunt. Seek and Find Objects Game,70,4,2.99,66
927270,Accounting+,614,171,11.99,443
452410,Damsel,60,15,6.99,45
861270,Sudoku Killer / 杀手数独,113,12,1.99,101
674020,World War 3,19201,10749,14.99,8452
940790,Gnomes Garden: Halloween,29,6,14.99,23
928970,Lost Frontier,23,0,4.99,23
924900,One Gun: Cat,68,20,10.99,48
955060,The Watson-Scott Test,430,214,4.99,216
917690,VANILLA - GARDEN OF JUDGEMENT,27,1,14.99,26
716490,EXAPUNKS,1326,69,19.99,1257
691280,SINNER: Sacrifice for Redemption,479,244,18.99,235
778080,40 Winks,21,10,12.99,11
774511,Megadimension Neptunia VIIR,611,211,10.49,400
803600,Disgaea 5 Complete,2472,340,39.99,2132
965810,Kara no Shojo,61,3,17.49,58
941030,Spirits of Mystery: Chains of Promise Collector's Edition,4,0,9.99,4
615020,King of the World,91,20,0.0,71
698260,Star Shelter,311,80,19.99,231
765710,Light Bearers,964,112,0.0,852
918820,Headliner: NoviNews,590,64,13.99,526
658850,Do Not Feed the Monkeys,6490,456,11.99,6034
758730,Paw Patrol: On A Roll!,247,41,29.99,206
681660,Bless Online,3783,6299,0.0,-2516
926520,Love Letter,360,62,6.99,298
553310,Lethal League Blaze,4976,168,19.99,4808
860500,SpellFront,27,14,8.99,13
700570,Beyond the Void,70,50,0.0,20
677340,The Colonists,776,120,24.99,656
856370,One-Way Ticket  / 单程票,230,149,4.99,81
921060,Modern Combat 5,2864,2429,0.0,435
878320,SIMULACRA: Pipe Dreams,552,117,0.0,435
828050,The Mirror Lied,545,64,0.0,481
572430,Party Hard 2,1569,372,19.99,1197
834440,NAMELESS,8,0,6.99,8
800200,Witching Tower VR,89,25,19.99,64
748360,MY HERO ONE'S JUSTICE,1467,485,8.99,982
931500,Touhou Genso Wanderer -Reloaded-,1545,94,34.99,1451
946610,Pocket Rogues,222,16,7.99,206
949050,Virtual Villagers Origins 2,105,125,0.0,-20
802870,The Ditzy Demons Are in Love With Me,1345,47,14.99,1298
950530,Mojo 2: Mia,651,150,0.0,501
951700,Super Jigsaw Puzzle: Space,22,3,4.99,19
944220,Gachi Heroes,1691,96,0.99,1595
536960,No Way Out - A Dead Realm Tale,17,6,19.99,11
888790,Sabbat of the Witch,1865,31,29.99,1834
607820,Infinite Adventures®,90,8,14.99,82
961230,"Backgammon, Chess & Checkers",2,2,9.99,0
399810,Call of Cthulhu®,7139,1951,19.99,5188
778390,Corpse Party: Book of Shadows,293,34,14.99,259
415180,Fort Zombie,74,15,3.99,59
885810,The Witch's House MV,1962,61,14.99,1901
729220,Save me Mr Tako: Tasukete Tako-San,15,11,0.0,4
809500,Brazilian Root®,55,5,9.99,50
868360,Project Hospital,5043,715,24.99,4328
740810,Pleasure Puzzle:Workshop 趣拼拼：拼图工坊,174,19,0.99,155
942050,2048,82,16,4.99,66
951050,Another Hardcore Game,19,3,1.99,16
530830,Sophie's Guardian,44,16,0.0,28
905640,Combat Arms: Reloaded,1426,1125,0.0,301
922460,Cheeky Chooks,2131,146,0.0,1985
766040,Gloom: Digital Edition,57,100,6.99,-43
674370,CoffeeBiz Tycoon,38,20,14.99,18
822040,Super Volley Blast,83,5,9.99,78
793170,Seeking Dawn: Free to Play Edition,16,15,0.0,1
961510,MarisaLand Legacy,105,26,17.99,79
920490,Driver Booster for Steam,4380,680,0.0,3700
806740,Fei Duanmu VS Kobayashi 端木斐 VS 小林正雪,162,13,5.99,149
892760,Seed of Evil,323,80,12.99,243
964350,At Home Alone,1509,269,0.0,1240
964130,My Colony,106,13,4.99,93
955400,Bonds,88,3,5.99,85
406350,KartKraft™,1969,445,39.99,1524
940810,Lost Artifacts: Time Machine,18,5,1.49,13
886380,Ruya,19,0,3.99,19
872820,Football Manager 2019 Touch,315,70,0.0,245
937940,Sea Dogs: City of Abandoned Ships,112,35,7.99,77
872790,Football Manager 2019,10690,1665,0.0,9025
935580,True Fear: Forsaken Souls Part 2,413,32,9.99,381
945460,Zombie Builder Defense,250,52,1.99,198
899190,A Piece of Wish upon the Stars,157,7,8.99,150
458330,Vilmonic,55,18,14.99,37
963710,Lost in Vivo,2273,132,11.99,2141
924810,Idle Kingdom Builder,36,54,0.0,-18
967250,DOKA 2 KISHKI EDITION,2616,460,0.99,2156
963690,Hentai Girl Hime,1705,134,0.99,1571
898650,The Shapeshifting Detective,959,261,4.28,698
835950,Transpose,208,22,2.99,186
396900,GRIP: Combat Racing,3331,581,29.99,2750
703880,Swords and Soldiers 2 Shawarmageddon,165,71,9.99,94
898780,Escape Game,114,20,0.99,94
949970,Reborn In Wild City 迷城重生,189,116,2.99,73
393190,TSIOQUE,1374,62,13.99,1312
619700,Steel Rats™,681,445,9.99,236
777880,Fluffy Horde,217,136,9.99,81
765870,Leisure Suit Larry - Wet Dreams Don't Dry,1035,169,29.99,866
830590,Holy Potatoes! A Spy Story?!,87,42,0.99,45
860620,KURSK,184,207,9.99,-23
632250,DERU - The Art of Cooperation,40,6,14.99,34
834450,Roarr! The Adventures of Rampage Rex,43,72,2.99,-29
803890,Police Helicopter Simulator,38,38,19.99,0
742500,Nonogram - Master's Legacy,255,50,0.0,205
595690,One Hour One Life,2508,659,14.99,1849
870200,SimpleRockets 2,1492,126,14.99,1366
758870,Kynseed,1241,193,15.99,1048
886250,PokerStars VR,2017,323,0.0,1694
788330,Varion,19,0,4.99,19
321160,Timber Tennis: Versus,43,18,1.99,25
735580,11-11 Memories Retold,1209,204,4.49,1005
699920,Despotism 3k,658,130,7.99,528
658690,Rage in Peace,245,30,12.99,215
877200,Zero Caliber VR,2997,805,24.99,2192
912930,Insurgence - Chains of Renegade,38,2,4.99,36
966530,You have a drunk friend,191,111,0.99,80
779730,Foosball VR,13,0,16.99,13
704850,Thief Simulator,14879,2263,19.99,12616
733300,My Big Sister,442,32,2.99,410
973760,Thronebreaker: The Witcher Tales,11893,1550,19.99,10343
951740,Nice Shot! The Gun Golfing Game,53,8,6.99,45
946040,Supply Chain Idle,254,65,0.0,189
966680,Red Matter,665,61,24.99,604
881490,Tower Keepers,71,57,0.0,14
751640,Dead Dungeon,205,16,4.99,189
836640,寄居隅怪奇事件簿 Hermitage Strange Case Files,1441,289,9.99,1152
683970,Entwined: The Perfect Murder,15,9,5.99,6
840720,Sword Art Online: Lost Song,1290,314,19.99,976
819650,Bitcoin,52,82,0.99,-30
863550,HITMAN™ 2,61972,5945,0.0,56027
809310,Sipho,121,18,13.99,103
743390,DISTRAINT 2,2810,106,8.99,2704
953950,Kubble,25,1,0.99,24
456750,The Room Three,8071,291,5.99,7780
882110,Google Spotlight Stories: Age of Sail,413,6,0.0,407
952860,河洛群俠傳 (Ho Tu Lo Shu ： The Books of Dragon),6414,1511,17.99,4903
938270,LoveKami -Healing Harem-,146,31,12.99,115
963210,Another Sight - Hodge's Journey,55,30,0.0,25
818860,Beyond the Sky,19,2,12.99,17
892420,懒人修仙传,753,489,3.99,264
972740,KOBOLD: Chapter I,204,48,5.99,156
965480,Campfire Pro,211,79,0.0,132
590950,Toaster Jam,113,2,1.99,111
893570,Short Life,93,37,0.0,56
617670,Zup! S,10075,249,0.99,9826
673880,"Warhammer 40,000: Mechanicus",9369,799,29.99,8570
531640,Eternal Card Game,4994,1403,0.0,3591
458580,Windlands 2,290,67,29.99,223
939520,HELLGATE: London,1087,817,12.99,270
769970,Bad Dream: Fever,631,157,9.99,474
692840,Underworld Ascendant,339,645,29.99,-306
882140,Reentry - An Orbital Simulator,437,18,29.99,419
868520,killer7,1865,75,19.99,1790
907210,Phantom Thief Celianna,174,90,12.99,84
865820,Psychedelica of the Black Butterfly,416,73,29.99,343
904540,Indiana Jones® and the Infernal Machine™,227,37,5.99,190
847370,Sunset Overdrive,7781,824,19.99,6957
559070,Zak McKracken and the Alien Mindbenders,80,8,5.99,72
730830,Escape from Monkey Island™,233,161,6.99,72
559620,Outlaws + A Handful of Missions,407,27,5.99,380
808910,STAR WARS™ Episode I Racer,1351,190,9.99,1161
955320,Dark Fantasy: Jigsaw Puzzle,276,28,1.79,248
864060,Marble It Up!,512,33,19.99,479
355170,Sam & Max Hit the Road,470,16,5.99,454
688420,Bad North: Jotunn Edition,6205,526,14.99,5679
560430,Indiana Jones® and the Emperor's Tomb™,564,46,5.99,518
955360,Stronghold: A Hero's Fate,10,5,5.99,5
945360,Among Us,577656,51069,3.99,526587
861350,Gym Simulator,159,235,1.99,-76
787860,Farming Simulator 19,58964,3780,19.99,55184
967130,XWidget,275,82,3.99,193
946560,Don't Forget Our Esports Dream,76,6,0.0,70
948510,Monster Clicker : Idle Halloween Strategy,29,33,0.0,-4
962400,Granny,1271,141,4.99,1130
724490,Protocol,182,70,14.99,112
922400,DX-Ball 2: 20th Anniversary Edition,343,10,6.99,333
880470,Pro Basketball Manager 2019,32,36,0.0,-4
603850,Age of History II,21932,3206,4.99,18726
915540,Aim Master,30,16,2.99,14
976780,NeonCode,167,43,0.99,124
977570,The Experiment: Escape Room,136,94,2.39,42
954410,Color by Numbers - Animals,2,1,4.99,1
911260,Dawn of the Breakers,42,52,0.0,-10
963000,"The Haunted Island, a Frog Detective Game",2818,229,4.99,2589
825300,To Trust an Incubus,43,5,19.99,38
853550,Equilinox,2432,190,9.99,2242
971680,Montaro RE,1067,40,0.99,1027
814590,Caveman Stories,11,5,3.99,6
252250,Maia,463,570,24.99,-107
940780,Royal Roads,16,6,0.49,10
604330,The Crown of Leaves,1485,43,3.74,1442
600120,Life Forge - Reborn ORPG,240,117,0.0,123
970510,蓝宝石般的被害妄想少女/Damsel with persecutory delusion,634,74,4.99,560
941920,Classic Card Games 3D,41,19,12.99,22
490510,Pixel Puzzles 2: Christmas,37,4,4.99,33
979010,Ultimate Desktop Character Engine,49,43,2.99,6
606280,Darksiders III,9305,2970,59.99,6335
946660,Loria,178,39,0.0,139
873910,Rail World,34,66,0.0,-32
887060,Asterix & Obelix XXL 2,506,133,29.99,373
583950,Artifact,11562,13245,0.0,-1683
928390,R-Type Dimensions EX,208,29,14.99,179
977840,EMERGENCY 2,29,5,9.99,24
897440,Leviathan ~A Survival RPG~,154,51,9.99,103
972890,RideOp - VR Thrill Ride Experience,42,20,0.0,22
686600,Rapture Rejects,695,1053,0.0,-358
425450,GoatPunks,20,10,9.99,10
453090,Parkitect,5561,312,29.99,5249
802450,NAIRI: Tower of Shirin,369,57,4.99,312
936530,Close Combat: Last Stand Arnhem,77,16,39.99,61
757480,Broken Reality,1151,64,14.99,1087
878350,TAVERN GUARDIANS: BANQUET,53,21,3.99,32
794180,PRO FISHING SIMULATOR,17,21,9.99,-4
789900,My Little Riding Champion,21,24,8.99,-3
871200,FIGHTING EX LAYER,470,92,39.99,378
789890,City Patrol: Police,12,20,4.99,-8
429540,Prime World: Defenders 2,1506,389,0.0,1117
759740,RIDE 3,3652,776,39.99,2876
392160,X4: Foundations,10638,3375,49.99,7263
432350,Epic Battle Fantasy 5,4185,52,19.99,4133
962380,HOT FIT!,28,7,0.0,21
792990,Identity,394,1624,29.99,-1230
855860,Superfighters Deluxe,2078,231,9.99,1847
932850,Simmiland,780,89,4.99,691
974950,DAMNOSAUR,269,21,0.0,248
798420,Professional Fishing,2155,682,0.0,1473
670930,Escape Doodland,122,27,9.99,95
671690,[MARS] Total Warfare,66,26,0.0,40
709440,Override: Mech City Brawl,609,161,19.99,448
936180,Atelier Totori ~The Adventurer of Arland~ DX,196,44,39.99,152
628720,GODS Remastered,132,31,0.0,101
884350,The Unfolding Engine: Paint a Game,18,4,0.0,14
936190,Atelier Meruru ~The Apprentice of Arland~ DX,199,9,39.99,190
956240,Simson Tuningwerkstatt 3D,154,1,29.99,153
424030,War of Rights,7254,1163,29.99,6091
936160,Atelier Rorona ~The Alchemist of Arland~ DX,425,33,39.99,392
794550,Grapple Force Rena,113,7,14.99,106
925900,Monica e a Guarda dos Coelhos,43,5,14.99,38
517630,Just Cause 4 Reloaded,14189,8983,0.0,5206
923900,Lightning Angel Litona Liliche 섬광천사 리토나 리리셰,33,2,11.99,31
760060,Mutant Year Zero: Road to Eden,16130,1661,13.99,14469
952040,MUSYNX,3711,527,3.99,3184
761620,Beholder 2,4473,607,14.99,3866
890970,Oakwood,202,41,4.99,161
968790,DYNASTY WARRIORS 7: Xtreme Legends Definitive Edition,862,129,19.99,733
736340,VR Mini Bowling,19,5,4.99,14
893610,Skautfold: Into the Fray,66,6,4.99,60
586110,Sansar,311,280,0.0,31
603930,Battle Princess Madelyn,101,36,19.99,65
606140,Survived By,771,481,0.0,290
975860,拖拉机,5,0,3.99,5
975020,The Spirit Master of Retarnia -Conqueror of the Labyrinth-,22,7,14.99,15
893680,Project Warlock,3502,489,12.0,3013
854860,Cows VS Vikings,370,53,8.99,317
463170,Jagged Alliance: Rage!,214,204,19.99,10
972170,ECHO OF SOUL,328,131,0.0,197
748300,Treasure Hunter Simulator,695,455,16.99,240
233860,Kenshi,54375,2824,29.99,51551
848350,Katamari Damacy REROLL,3672,280,29.99,3392
953580,Tourist Bus Simulator,1728,899,29.99,829
983820,RainWidget,15,37,3.99,-22
957720,Strategic Command WWII: World at War,342,62,39.99,280
896160,Evil Bank Manager,1248,369,11.99,879
927890,Hentai Girl Linda,1476,90,0.99,1386
984720,Hentai Summer,117,12,0.99,105
869620,Katy and Bob: Cake Café,44,8,14.99,36
743130,MewnBase,944,54,9.99,890
907470,Iris.Fall,2255,289,14.99,1966
986710,Nusantara: Legend of The Winged Ones,37,1,4.99,36
963330,Nya Nya Nya Girls (ʻʻʻ)_(=^･ω･^=)_(ʻʻʻ),209,52,0.51,157
943010,Rapid Fire,23,1,0.0,22
935930,Reignfall,308,37,0.49,271
519860,DUSK,15633,334,19.99,15299
602770,Clatter,412,81,0.0,331
436470,Gamma Bros,118,14,0.0,104
734730,Ancient Frontier: Steel Shadows,26,10,14.99,16
975700,KóterGame,49,8,0.0,41
951240,Open Sewer,42,21,11.99,21
844050,Desert Child,149,117,11.99,32
741820,Prey: Typhon Hunter,222,475,39.99,-253
629730,Blade and Sorcery,31863,1156,19.99,30707
701160,Kingdom Two Crowns,6244,819,19.99,5425
960190,Maytroid. I swear it's a nice game too,134,32,1.99,102
822240,Animal Jam,1744,1312,0.0,432
964230,FUTURE GPX CYBER FORMULA SIN VIER,69,22,29.99,47
962970,My 1/6 Lover,433,93,1.99,340
984560,HEARTBEAT,589,101,14.99,488
916900,Paperbark,250,33,8.99,217
581320,Insurgency: Sandstorm,82246,14439,14.99,67807
978270,Sam & Dan: Floaty Flatmates,549,41,0.0,508
604150,Bomb Royale,60,42,4.99,18
987820,CHRONO,87,27,0.0,60
950100,PRO EVOLUTION SOCCER 2019 LITE,1612,1010,0.0,602
513290,Lucius III,472,424,19.99,48
221100,DayZ,221274,89537,44.99,131737
449960,Book of Demons,9111,2260,24.99,6851
683320,GRIS,54199,1923,4.24,52276
893010,Slave's Sword,447,153,14.99,294
648890,DMT: Dynamic Music Tesseract,158,17,3.99,141
977640,Happy toys,98,50,0.79,48
994280,古剑奇谭三(Gujian3),35959,5706,29.99,30253
982700,Space Battle VR,59,27,2.99,32
963930,Contractors,2009,409,19.99,1600
473770,BallisticNG,2225,153,7.99,2072
985040,NPCs,31,6,0.0,25
980730,Underlight,61,35,0.0,26
958480,Seed of the Dead,281,55,14.99,226
250680,BELOW,755,322,24.99,433
952420,Shan Gui II: Sweet Osmanthus II,458,21,4.99,437
951260,Shieldwall Chronicles: Swords of the North,120,35,14.99,85
960090,Bloons TD 6,193859,4932,9.99,188927
985680,闯关杀II,26,13,0.0,13
927250,Bladed fury,2611,410,9.99,2201
746940,Nippon Marathon,249,22,14.99,227
691190,Desktop Audio Visualizer,28,20,2.09,8
411980,TY the Tasmanian Tiger 3,136,16,14.99,120
945440,Tiny Bird Garden Deluxe,121,8,9.99,113
842150,Wild West Saga: Idle Tycoon Clicker,478,225,0.0,253
299740,Miscreated,21087,10542,29.99,10545
937850,Hidden Paws Mystery,192,8,2.24,184
611230,Heathen - The sons of the law,70,13,17.99,57
840010,Garden Paws,1924,174,19.99,1750
868980,DEEP SPACE WAIFU: NEKOMIMI,362,6,3.99,356
569530,Sky Noon,477,87,14.99,390
818030,Alicia Quatermain 3: The Mystery of the Flaming Gold,30,7,2.99,23
552620,ATOM RPG: Post-apocalyptic indie game,7508,1399,14.99,6109
890400,Uncharted Waters Online,217,81,0.0,136
994930,Soccer Manager 2019,554,168,0.0,386
915580,Dungeon Hunter Champions,315,212,0.0,103
975980,Mahjong Fest: Winterland,1,0,9.99,1
824460,HELLFRONT: HONEYMOON,57,8,0.99,49
852910,sweet pool,204,26,19.99,178
966630,qop 4,171,5,0.99,166
921630,音灵 INVAXION,3418,2754,0.0,664
936720,Wrench,830,75,29.99,755
739720,Penkura,37,3,9.99,34
465000,Event Horizon,106,27,5.99,79
514920,Crash Wheels,884,140,4.99,744
760920,ElectricVLab,40,7,11.99,33
862390,FlyInside Flight Simulator,98,43,34.99,55
944770,sheepChat,106,31,9.99,75
979080,Rebel Forces,1267,283,0.0,984
958320,A Front Too Far: Normandy,116,64,4.99,52
906110,Minotaur Arcade Volume 1,49,0,6.99,49
948100,AREA 4643,73,1,10.99,72
993780,Jewel Match Solitaire Winterscapes,54,4,9.99,50
719890,Beasts of Bermuda,4107,1521,19.99,2586
630640,SEQUENCE STORM,122,3,0.0,119
913850,103,133,43,4.99,90
906120,POLYBIUS,182,13,6.99,169
834910,ATLAS,19204,21291,29.99,-2087
986830,The Legacy: The Tree of Might,56,4,6.99,52
567380,Heartbound,1325,36,9.99,1289
853200,Shred! 2 - ft Sam Pilgrim,137,18,9.99,119
971500,Bubble Burst,22,1,2.99,21
338330,Super Treasure Arena,40,19,0.95,21
994020,Tempest of the Heavens and Earth,259,25,13.99,234
703060,connect - Virtual Home (3D or VR),26,25,0.0,1
964040,Snood,135,44,0.0,91
995460,Miracle Snack Shop,2076,54,9.99,2022
938310,12 Labours of Hercules VIII: How I Met Megara,127,4,2.99,123
839200,SpedV,474,126,0.0,348
854570,Pamali: Indonesian Folklore Horror,461,81,4.99,380
993680,东方驾考模拟器|Chinese Driving License Test,54,32,0.99,22
991500,Make A Jigsaw Puzzle,3,1,1.99,2
937740,Anime Babes: Solitaire,3,1,3.99,2
434300,Wormhole City,12,25,0.0,-13
997870,City Defense,4,7,3.99,-3
992120,Inch by Inch,48,2,2.99,46
934850,Cyberdrome,196,24,0.0,172
575850,Hartacon Tactics,18,22,3.99,-4
986020,Kunoichi Botan,326,72,14.99,254
499660,Medieval Kingdom Wars,1914,550,19.99,1364
997720,Let's Learn Japanese! Hiragana,62,6,1.59,56
990390,Riddles of the Owls' Kingdom. Magic Wings,4,0,5.99,4
999350,Uzak Diyar Destanları 1: Remastered,77,12,2.99,65
963450,The Eternal Castle [REMASTERED],527,74,9.99,453
880510,Girl and Goblin,947,98,1.99,849
855630,Zeliria Sanctuary,597,78,9.99,519
965670,Niplheim's Hunter - Branded Azel,644,56,19.99,588
553520,Trainz Railroad Simulator 2019,1086,399,39.99,687
998220,The Dungeon of Lulu Farea,161,18,12.99,143
688770,TETRUX: Online,92,13,2.99,79
838010,Double Cross,81,19,19.99,62
834060,Goblin Walker,389,255,0.0,134
939330,Tailor Tales,560,30,0.0,530
893180,Catherine Classic,6312,861,19.99,5451
492760,Aftercharge,167,54,0.0,113
688060,Odd Realm,606,65,14.99,541
500980,Endangered,5,8,0.0,-3
939990,Boxing School,303,42,9.99,261
738540,Tales of Vesperia: Definitive Edition,2729,560,49.99,2169
989250,Fight For Love,3,3,0.99,0
866440,What Never Was,4258,212,0.0,4046
787840,Blacksmith,64,26,9.99,38
445800,Love Language Japanese,131,27,19.99,104
1003320,Nya Nya Nya Girls 2 (ʻʻʻ)_(=^･ω･^=)_(ʻʻʻ),5,2,0.51,3
967490,Microsoft Maquette,74,6,0.0,68
761600,Onimusha: Warlords,1539,112,19.99,1427
959080,Unsung Warriors - Prologue,1266,70,0.0,1196
1006880,Chocolate makes you happy: Valentine's Day,14,12,0.51,2
666140,My Time At Portia,35027,2751,7.49,32276
512220,Trickster VR: Co-op Dungeon Crawler,390,64,12.99,326
979060,Bloons Adventure Time TD,2209,315,0.0,1894
671510,DESOLATE,4816,2290,24.99,2526
999830,Becalm,278,51,0.0,227
748040,State of War : Warmonger / 蓝色警戒 (Classic 2000),362,45,9.99,317
1007350,Mirror Maker,622,152,1.99,470
658590,She and the Light Bearer,196,23,9.99,173
962390,S.A.I.A.'s Awakening: A Robothorium Visual Novel,15,9,0.0,6
699670,Feudal Alloy,438,185,1.69,253
459080,YIIK: A Postmodern RPG,273,154,19.99,119
949800,Skyland: Heart of the Mountain,96,23,14.99,73
619150,while True: learn(),5491,477,12.99,5014
991780,Notes of Soul,16089,4583,29.99,11506
973090,Toilet Simulator 2020,318,150,0.99,168
906200,Tunche: Arena,292,41,0.0,251
882410,Age of Fear: The Free World,301,55,0.0,246
603010,Chill,135,35,0.99,100
1006850,XDeskClock,29,11,2.99,18
968440,Artist Idle,274,135,0.0,139
995890,Echoes of the Past: The Citadels of Time Collector's Edition,2,1,9.99,1
390090,Shot Online,63,39,0.0,24
741510,The Hong Kong Massacre,575,167,4.99,408
984110,SYNTHETIK: Arena,1930,194,0.0,1736
1002360,バグダス - デバッガー検定 -,60,12,0.99,48
894270,Beware of Trains,49,14,10.99,35
889510,SENRAN KAGURA Burst Re:Newal,1480,110,29.99,1370
965310,The Settlers® : Rise of an Empire - History Edition,304,86,11.99,218
965320,The Settlers® 7 : History Edition,345,221,14.99,124
965300,The Settlers® : Heritage of Kings - History Edition,404,72,11.99,332
970570,CHAOS;CHILD,1807,120,34.99,1687
419700,AT SUNDOWN: Shots in the Dark,28,15,14.99,13
559330,A Fisherman's Tale,901,62,14.99,839
925470,Endless Jade Sea -Midori no Umi-,271,55,1.99,216
638000,When Ski Lifts Go Wrong,614,86,2.99,528
646570,Slay the Spire,112452,2428,24.99,110024
1010170,Discord Bot - Controls,113,75,1.99,38
780350,Unruly Heroes,616,185,19.99,431
241000,Jon Shafer's At the Gates,204,265,29.99,-61
992070,Idle Wizard,928,144,0.0,784
977950,A Dance of Fire and Ice,39971,2671,5.99,37300
940850,Taptiles,4,0,9.99,4
992050,Oik 5,98,10,0.99,88
883710,Resident Evil 2,107493,3175,39.99,104318
1003480,Fireboy & Watergirl: Elements,427,47,0.99,380
992490,iVRy Driver for SteamVR,143,53,0.0,90
959890,Sister Travel,437,41,14.99,396
572890,Pikuniku,5454,234,12.99,5220
969700,NekoMiko,140,4,9.99,136
573100,Battlefleet Gothic: Armada 2,5743,1563,19.99,4180
994190,Sound Slide,379,125,0.0,254
957080,EEP 15,18,16,7.99,2
650940,Rogue Empire: Dungeon Crawler RPG,295,38,14.99,257
852340,King Rabbit - Puzzle,296,25,0.0,271
530860,The Wanderer,19,12,0.99,7
831660,Monobeno-HAPPY END- Deluxe,314,18,29.99,296
588030,Derail Valley,2403,160,19.99,2243
968950,Sakura MMO 2,126,18,9.99,108
942930,枕边少女 MOE Hypnotist - share dreams with you,608,50,6.99,558
777150,Adventure Land - The Code MMORPG,99,15,14.99,84
965410,Desolate City: The Bloody Dawn Enhanced Edition,10,2,5.99,8
968820,Stormhill Mystery: Family Shadows,81,20,6.99,61
979560,RainWallpaper,337,200,3.99,137
951440,Volcanoids,4096,676,19.99,3420
660920,The Warhorn,171,119,9.99,52
621060,PC Building Simulator,41563,2558,19.99,39005
899160,小林正雪復仇之密室重制版 Cheney Wood The Ultimate Revenge,259,29,12.99,230
771810,The spy who shot me™,199,45,10.99,154
998990,Psyvariar Delta,37,3,29.99,34
773590,Azusa RP Online,80,52,0.0,28
910450,Warhammer Quest 2: The End Times,158,103,19.99,55
270610,Mage's Initiation: Reign of the Elements,111,14,14.99,97
1010240,Changeling,121,7,19.99,114
1008710,Wet Girl,4609,670,0.99,3939
1004270,My Island,992,431,14.99,561
866010,Beat Stickman: Infinity Clones,75,25,2.39,50
740550,Record of Agarest War Mariage,87,47,14.99,40
761910,Worbital,332,33,12.99,299
782140,Re-Legion,160,114,9.99,46
975680,METAL SLUG XX,361,360,19.99,1
980850,Pixel Battle Royale,365,250,0.0,115
502500,ACE COMBAT™ 7: SKIES UNKNOWN,23399,3697,39.99,19702
871310,Arc Savior,20,5,14.99,15
1010970,Dead Wishes,60,5,9.99,55
596970,Sunless Skies: Sovereign Edition,2365,418,24.99,1947
982150,h3,184,15,0.0,169
992330,Nightmare (Incubo),156,39,6.99,117
657090,Robothorium,249,100,14.99,149
908070,Mystic Vale,277,26,12.99,251
976390,9-nine-:Episode 1,854,43,19.99,811
871420,Lovecraft's Untold Stories,574,165,14.99,409
982270,Dealer's Life,927,69,7.49,858
1013180,Funbag Fantasy,21,0,44.99,21
881560,How To Date A Magical Girl!,328,68,8.99,260
973700,Disassembly VR,78,52,20.99,26
941650,The Island: Into The Mist,147,67,9.99,80
772290,Rainswept,189,24,11.99,165
607050,Wargroove,3715,673,19.99,3042
1008280,Fairy Picturebook of Hero and Sorceress / 勇者と魔法使いとおとぎの絵本,33,1,12.99,32
778840,Armored Evolution,51,12,9.99,39
1015480,DrumBeats VR,89,41,9.99,48
252390,DwarfCorp,99,68,13.99,31
1010860,Hide and Seek,444,275,0.74,169
579840,Bloody Trapland 2: Curiosity,556,112,9.99,444
690830,Foundation,10045,1463,29.99,8582
926310,咕啾！文鸟恋爱物语 Love Story of Sparrow,242,27,0.99,215
822990,Spinnortality | cyberpunk management sim,214,56,9.99,158
856060,蝶生梦影-Butterfly dream shadow,25,1,2.99,24
950240,Rise of the Pirates,55,23,0.0,32
953300,ART SQOOL,111,53,0.0,58
1011130,Life is Pointless,75,12,0.99,63
361420,ASTRONEER,86586,8142,29.99,78444
738550,Spike Volleyball,158,140,19.99,18
1010950,SmartyTale 2D,60,5,2.99,55
933540,Idle Space Raider,153,52,0.0,101
983980,Euclidean Skies,34,15,4.99,19
880850,War Rock,490,363,0.0,127
819500,Fear The Wolves,1576,1692,4.99,-116
1001140,Angry Birds VR: Isle of Pigs,256,27,14.99,229
1011510,Wizard And Minion Idle,539,57,0.0,482
1020470,Evoland Legendary Edition,1450,313,19.99,1137
899440,GOD EATER 3,5942,1369,59.99,4573
828900,The Stillness of the Wind,756,275,12.99,481
966720,Pumped BMX Pro,73,22,2.99,51
321400,Supraball,2516,726,0.0,1790
1022840,The Adventures of Jason and the Argonauts,20,4,4.99,16
991070,Destroy The World,44,14,0.99,30
872470,Necro Mutex,37,5,1.99,32
906740,Voidship: The Long Journey,105,32,10.99,73
882020,Monster Energy Supercross - The Official Videogame 2,455,87,24.99,368
995920,Myths of the World: Black Rose Collector's Edition,4,0,9.99,4
978970,God Hand,28,7,0.0,21
1021860,Unravel Cyndy,2,0,0.0,2
1022230,Magic Borderless,88,43,2.99,45
981420,Game Soup,97,4,1.79,93
428180,Islet Online,368,99,16.99,269
1017440,Vacation Adventures: Cruise Director,3,0,6.99,3
910630,Arcade Spirits,395,9,19.99,386
982220,Globesweeper,215,21,2.99,194
556050,Hyper Jam,374,28,2.59,346
469800,Evolution Board Game,293,49,14.99,244
342310,RIOT: Civil Unrest,969,436,16.99,533
1025580,Vainglory,2724,1453,0.0,1271
803980,Plane Mechanic Simulator,857,484,11.99,373
573110,AWAY: Journey to the Unexpected,79,74,16.99,5
992740,祈風 Inorikaze,318,0,10.99,318
588630,Draw Rider 2,61,20,2.99,41
715560,Eastshade,3825,449,24.99,3376
841660,The Treehouse Man,100,16,9.99,84
820610,Ages of Mages: The last keeper,141,36,11.99,105
809880,Degrees of Separation,616,90,2.99,526
940680,The Textorcist: The Story of Ray Bibbia,827,177,14.99,650
1009700,Jewel Match Solitaire L'Amour,45,5,9.99,40
1013540,Evospace,210,45,14.99,165
916050,Clocker,189,27,11.99,162
977460,Steam Prison,250,30,34.99,220
966330,Flower,2556,550,6.99,2006
887370,Element Space,154,109,12.49,45
816020,JUMP FORCE,16610,5934,0.0,10676
939960,Far Cry® New Dawn,17722,5315,39.99,12407
844660,Heart of the Woods,623,22,14.99,601
896960,DreamWorks Dragons: Dawn of New Riders,90,19,29.99,71
1014560,Creepy Vision,36,7,5.99,29
981290,CGENcore,50,43,0.0,7
1002290,某1种青春,334,13,0.0,321
345460,War of Omens Card Game,529,91,0.0,438
719180,Revulsion,59,15,2.99,44
958740,Heretic Operative,67,14,19.99,53
951940,Almost There: The Platformer,247,134,9.99,113
819030,STEINS;GATE ELITE,987,88,0.0,899
988480,Warhammer Age of Sigmar: Champions,216,125,0.0,91
975430,Dick Wilde 2,32,11,19.99,21
930910,STEINS;GATE: Linear Bounded Phenogram,489,11,0.0,478
834530,Yakuza Kiwami,12383,877,19.99,11506
879160,Battlerite Royale,5891,2070,0.0,3821
949000,Marble Combat,119,37,0.0,82
891790,Devil Engine,98,12,19.99,86
1010670,Dungeon Dreams,179,12,11.99,167
1014140,Snakebird Primer,139,12,7.99,127
814300,Pigeons Attack,148,12,4.99,136
782670,Battle Tanks: Legends of World War II,582,328,0.0,254
699740,BANNERMEN,154,131,29.99,23
794580,SNK HEROINES Tag Team Frenzy,414,160,49.99,254
628710,Hell Warders,80,52,14.99,28
893020,Slave's Sword 2,231,100,14.99,131
1005000,Argonauts Agency: Golden Fleece,32,2,5.99,30
594040,SERIES MAKERS TYCOON,328,130,4.99,198
1026560,LOGistICAL 2: USA - Nevada,6,0,9.99,6
967050,Pacify,28890,4098,4.99,24792
1019250,WWII TCG - World War 2: The Card Game,253,109,0.0,144
598980,The Coin Game,3749,140,13.99,3609
1001070,Koi,108,19,0.99,89
851100,Touhou Luna Nights,11236,247,17.99,10989
576390,365 Days,11,21,9.99,-10
690790,DiRT Rally 2.0,24496,4056,4.99,20440
914320,Swarm Simulator: Evolution,344,94,0.0,250
938380,Townsmen - A Kingdom Rebuilt,540,285,19.99,255
793150,Moe! Ninja Girls,204,72,0.0,132
345430,The Cursed Forest,609,71,13.99,538
340210,Predestination,39,38,29.99,1
544390,NITE Team 4 - Military Hacking Division,993,76,34.99,917
1004150,Madorica Real Estate,49,3,8.49,46
881320,The LEGO Movie 2 Videogame,606,232,29.99,374
641080,Trials® Rising,1429,772,19.99,657
781480,Tech Support: Error Unknown,358,117,9.99,241
903040,The Castles of Burgundy,113,35,14.99,78
1002560,Tiny Snow,3024,135,3.99,2889
755800,Hades' Star,1537,374,0.0,1163
935880,Glass Masquerade 2: Illusions,2201,180,4.99,2021
923810,If My Heart Had Wings -Flight Diary-,404,23,14.99,381
1020820,KumaKuma Manga Editor,588,135,5.99,453
929060,Road to Eden,250,110,19.99,140
516110,ToeJam & Earl: Back in the Groove!,814,84,14.99,730
1028750,Ultimate Logic Puzzle Collection,58,14,0.0,44
722960,CASE 2: Animatronics Survival,1642,346,7.99,1296
447150,APE OUT,2243,127,14.99,2116
1004860,The Secret Order 7: Shadow Breach,116,16,14.99,100
244850,Space Engineers,100660,13648,19.99,87012
688130,Pogostuck: Rage With Your Friends,3729,693,6.99,3036
771690,Fimbul,21,12,9.99,9
906300,Under One Wing,100,7,29.99,93
961620,Flashback,287,75,9.99,212
838380,DEAD OR ALIVE 6,5403,1986,59.99,3417
920690,CardLife: Creative Survival,1494,875,14.99,619
518150,Intruder,4260,468,19.99,3792
950990,Business Magnate,121,68,12.99,53
824070,Objects in Space,281,250,24.99,31
858810,Dawn of Man,12273,1848,24.99,10425
1012730,九劫曲:诅咒之地 NineTrials Test Server,148,127,0.0,21
1021950,When the Darkness comes,7172,595,0.0,6577
485440,Call Of The Mighty Warriors,133,92,0.99,41
996380,Smartphone Tycoon,774,640,6.99,134
665370,Mutilate-a-Doll 2,1238,85,9.0,1153
765880,The Occupation,178,108,29.99,70
1026400,TAMASHII,239,8,4.99,231
760510,Cat Burglar: A Tail of Purrsuit,309,24,0.0,285
781030,DK Online,230,323,0.0,-93
714370,LEFT ALIVE™,200,525,59.99,-325
714250,Eternity: The Last Unicorn,64,117,3.99,-53
749250,7th Sector,431,133,12.99,298
997700,瓶中精灵 - Fairy in a Jar,173,9,1.99,164
1035930,Nyasha,278,60,0.51,218
1034160,Extreme Racing on Highway,69,19,10.99,50
1003360,ШХД: ЗИМА / IT'S WINTER,509,171,9.99,338
1005870,HYPERFIGHT,728,81,0.0,647
1034250,The far Kingdoms: Winter Solitaire,23,8,4.99,15
987230,Shadow Legend VR,363,104,24.99,259
591370,Production Line : Car factory simulation,2540,494,24.99,2046
601150,Devil May Cry 5,77418,4134,29.99,73284
870690,Galaxy Trucker: Extended Edition,145,12,9.99,133
1013870,Leanna's Slice of Life,527,107,14.99,420
1029130,Sordwin: The Evertree Saga,23,0,4.99,23
976010,I hate this game,1270,92,1.99,1178
790740,Tick Tock: A Tale for Two,7187,909,5.99,6278
973060,Evil Maze 2 | 惡魔迷宮 2,65,24,9.99,41
397160,Aurora Dusk: Steam Age,237,45,9.99,192
1025250,Shadow Corridor,1234,127,7.99,1107
450850,Cube Land Arena,132,77,0.99,55
640800,Skyfront VR,109,39,9.99,70
487000,Quest Hunter,1495,329,19.99,1166
707680,Slapshot,2191,405,0.0,1786
604240,Shotgun Farmers,8324,624,9.99,7700
734330,Ultimate Coaster X,136,17,0.0,119
837040,Redneck Kentucky and the Next Generation Chickens,61,3,4.99,58
611760,Don't Escape: 4 Days to Survive,1497,27,14.99,1470
439340,Tavern Tycoon - Dragon's Hangover,540,235,12.99,305
1038620,House of 1000 Doors: Evil Inside,65,25,6.99,40
451600,CounterAttack,225,23,14.99,202
504620,"Grid Legion, Storm",20,7,0.0,13
844590,Hypnospace Outlaw,2670,67,19.99,2603
840800,Outlaws of the Old West,3621,2144,19.99,1477
921590,DISSIDIA FINAL FANTASY NT Free Edition,1367,1784,0.0,-417
1029630,Power & Revolution 2019 Edition,717,459,49.99,258
757300,Truberbrook / Trüberbrook,999,400,3.59,599
669320,NationWar:Chronicles | 国战:列国志传,306,134,10.99,172
889600,The Caligula Effect: Overdose,320,102,49.99,218
839450,7'scarlet,399,117,29.99,282
576650,Fovos VR,65,39,0.0,26
793490,Exocraft,166,139,0.0,27
968300,Super Chains,23,3,4.99,20
1028570,Lofi Ping Pong,706,102,4.99,604
736260,Baba Is You,15787,298,14.99,15489
1039200,Poggers,70,3,2.99,67
994200,天际起源 The Ark of Horizon,352,319,0.0,33
1035750,文字獄,257,24,0.0,233
755500,ONE PIECE World Seeker,1842,521,8.99,1321
1014460,Nothing!,42,20,0.99,22
998930,Seek Girl,3293,816,0.99,2477
656700,RICO,275,124,4.99,151
977300,Fenimore Fillmore: 3 Skulls of the Toltecs,55,10,9.99,45
1003520,Hentai Crush,1335,197,1.99,1138
578420,Mars Underground,32,1,1.99,31
784150,Workers & Resources: Soviet Republic,10272,1070,34.99,9202
983150,Sakura no Mori † Dreamers 2,346,11,24.99,335
887820,Double,151,30,0.59,121
490920,Wolfpack,1312,122,34.99,1190
978870,Lilycle Rainbow Stage!!!,102,6,24.99,96
992730,Project Downfall,203,35,15.99,168
378360,Ymir,708,242,34.99,466
1031480,TouHou Makuka Sai ~ Fantastic Danmaku Festival Part II,1892,42,12.99,1850
960330,Dark Gnome,53,44,0.0,9
1038240,RainDesktop,39,33,2.79,6
1011700,"Walden, a game",65,7,9.99,58
1031440,TOKYO CHRONOS,240,33,29.99,207
690510,Immortal Soul: Black Survival,3781,987,0.0,2794
622220,Fate/EXTELLA LINK,3374,248,49.99,3126
1044640,Mundus - Impossible Universe,19,10,3.74,9
736850,We. The Revolution,1276,344,19.99,932
814380,Sekiro™: Shadows Die Twice - GOTY Edition,179498,9339,59.99,170159
666820,Skirmish Line,288,35,9.99,253
948830,寄甡  Symbiotic Love,1037,39,6.99,998
998790,Piczle Lines DX+α,28,5,9.99,23
812960,Guilds Of Delenar,32,10,14.99,22
954870,Astrox Imperium,661,61,14.99,600
893790,Newfound Courage,261,12,8.99,249
831980,Out of the Park Baseball 20,998,83,0.0,915
1030170,Fear for Sale: Endless Voyage Collector's Edition,6,0,9.99,6
954350,NOLO HOME,20,26,0.0,-6
1015660,Hentai Shooter 2: World Tour,50,13,0.99,37
1043500,Tree Simulator 2020,422,18,0.99,404
886820,Nelke & the Legendary Alchemists ~Ateliers of the New World~,166,50,59.99,116
1044450,Hentai Waifu,36,3,0.49,33
877850,TribeXR DJ School,155,11,22.49,144
1032240,Line Loops - Logic Puzzles,5,1,4.99,4
813300,CODE CRACKER 代码破译者,134,11,8.99,123
859180,Monster Castle,66,40,0.0,26
968250,King of Retail,2232,193,12.59,2039
899390,Xenon Racer,377,198,2.99,179
858100,Grimshade,101,34,19.99,67
1037480,Classic Racers,339,43,0.0,296
704270,Generation Zero®,18096,8554,24.99,9542
363950,Windscape,202,104,2.39,98
1046230,Soccer Player Simulator,168,37,0.99,131
1032430,Blood Trail,1875,540,24.99,1335
858210,Nova Drift,7836,263,14.99,7573
938500,Willowbrooke Post,36,91,0.0,-55
899200,Windstorm: An Unexpected Arrival,41,22,14.99,19
612930,Fight of Gods,663,117,14.99,546
942970,Unheard,24009,843,6.99,23166
755470,The World Next Door,203,43,2.99,160
290470,Onigiri,601,241,0.0,360
235520,The White Laboratory,236,67,9.99,169
1037190,Shipped,537,14,5.99,523
985430,Terrible Laboratory,256,60,10.99,196
777770,WAR PARTY,298,124,9.99,174
1031140,Horus Heresy: Legions,1266,495,0.0,771
547860,Rend,840,730,0.0,110
951000,Trap Shrine,1400,85,9.99,1315
938220,TAPSONIC BOLD,869,296,19.99,573
911400,Assassin's Creed® III Remastered,3703,3031,39.99,672
492720,Tropico 6,18516,2785,39.99,15731
986280,Lingua Fleur: Lily,181,3,4.99,178
1029500,中华三国志 the Three Kingdoms of China,1044,179,0.0,865
1043180,Lovers of Aether,1335,97,0.0,1238
949060,Love Thyself - A Horatio Story,478,37,0.0,441
937570,Danmaku Amanojaku ~ Impossible Spell Card.,132,2,10.99,130
929200,吞食孔明传 Tunshi Kongming Legends,680,252,9.99,428
937580,Touhou Kanjuden ~ Legacy of Lunatic Kingdom.,876,15,14.99,861
1044340,The 7th Guest: 25th Anniversary Edition,109,29,9.99,80
1046820,I'm on Observation Duty,878,53,1.99,825
729040,Borderlands Game of the Year Enhanced,13788,2222,29.99,11566
1028860,Star Chef: Cooking & Restaurant Game,165,129,0.0,36
1059710,New Yankee 6: In Pharaoh's Court,7,0,6.99,7
1036950,Super Jigsaw Puzzle: Generations,633,32,0.0,601
1046030,ISLANDERS,13433,681,4.99,12752
834760,Robot Wants It All,97,10,19.99,87
1045080,Curious Cases,238,75,6.99,163
980830,Spirit Hunter: Death Mark,216,41,49.99,175
682530,MarZ: Tactical Base Defense,576,156,21.99,420
1020270,Demon Hunter 5: Ascendance,136,19,14.99,117
798510,SUPER DRAGON BALL HEROES WORLD MISSION,1089,184,59.99,905
941850,Vanguard: Normandy 1944,96,67,14.99,29
1006400,Fantasia of the Wind 2 风之幻想曲 第二部,80,9,6.99,71
1035800,Mistress of Maids: First Castle,75,11,0.0,64
694720,Not My Car – Battle Royale,618,737,0.0,-119
545040,Feather,446,99,2.99,347
976920,Dance of Death: Du Lac & Fey,108,21,18.99,87
813630,Supraland,9320,436,19.99,8884
936780,Warplanes: WW2 Dogfight,1000,186,0.0,814
1032520,JermaSlots,482,28,0.0,454
1054750,Magic Farm 2: Fairy Lands (Premium Edition),22,5,3.99,17
819020,Zanki Zero: Last Beginning,430,117,59.99,313
921390,武林志（Wushu Chronicles）,1517,847,12.99,670
926810,Dark Places,64,55,4.99,9
726830,Vacation Simulator,703,66,29.99,637
1037000,Where are My Pipes?,3,0,4.99,3
787480,Phoenix Wright: Ace Attorney Trilogy,15202,355,29.99,14847
950370,Tactics & Strategy Master 2:Princess of Holy Light（圣光战姬）,97,60,3.19,37
698870,Metaverse Keeper / 元能失控,608,143,14.99,465
848010,Find your way,209,103,4.99,106
1035610,Hentai Mosaique Vip Room,296,21,0.99,275
778400,Corpse Party: Sweet Sachiko's Hysteric Birthday Bash,121,10,19.99,111
1015710,Holy Road,134,64,19.99,70
836850,Tiny Tanks,86,39,9.99,47
622720,Weedcraft Inc,1032,230,19.99,802
405710,Staxel,3414,846,19.99,2568
454140,First Person Tennis - The Real Tennis Simulator,269,35,24.99,234
928480,Darkness and Flame: The Dark Side,38,2,6.99,36
546430,Pathway,1394,450,15.99,944
905660,纸境英雄 Papercraft,255,42,17.99,213
1026820,Coloring Game,3301,256,0.0,3045
1048830,Horse Riding Tales,238,157,0.0,81
915460,ULTIMATE HARDBASS DEFENCE,1892,160,1.99,1732
1023310,Logical Now!,3,0,4.99,3
933940,假如我是人工智能 Big Brother Is Shaping You,682,118,3.99,564
1004240,Hentai Girl Karen,522,19,0.99,503
1041710,Sim Empire,76,94,29.99,-18
1043340,No Time,1021,34,10.99,987
890280,Myha: Return to the Lost Island,38,8,17.99,30
923710,uFactory,44,12,24.99,32
602320,Train Valley 2,1849,187,14.99,1662
1023280,Solitaire Bliss Collection,6,0,24.99,6
1051500,Digital Diamond Baseball V8,20,1,4.99,19
980300,One Finger Death Punch 2,3780,130,7.99,3650
1057430,Geometry May. I swear it's a nice free game,440,109,0.0,331
1040430,Adventure Climb VR,166,65,0.0,101
774201,Heaven's Vault,1393,172,24.99,1221
658780,Bomb Chicken,217,17,14.99,200
1053680,Granny Simulator,3232,300,4.99,2932
673800,Zup! XS,942,139,0.99,803
631570,Whispers of a Machine,1300,88,14.99,1212
887800,Snooker 19,356,150,34.99,206
1003400,The Lord of the Rings: Journeys in Middle-earth,504,56,0.0,448
1055090,Embark,235,124,24.99,111
1055430,Swords and Sandals Classic Collection,1379,107,9.99,1272
1029860,Amber's Airline - 7 Wonders,63,6,12.99,57
751780,Forager,28196,2807,19.99,25389
488730,God's Trigger,581,199,14.99,382
1023690,Nurse Love Syndrome,151,4,39.99,147
1035770,Jewel Match Solitaire 2 Collector's Edition,29,5,12.99,24
965010,Trinoline All Ages Version,86,7,34.99,79
460950,Katana ZERO,47643,846,14.99,46797
718650,Driftland: The Magic Revival,1120,390,2.99,730
1018000,Anniversary Collection Arcade Classics,155,88,19.99,67
1037100,You Died but a Necromancer revived you,37,3,8.99,34
1052070,Burning Daylight,2534,321,0.0,2213
985760,3D Custom Lady Maker,177,77,4.99,100
1051310,Paper Dolls: Original / 纸人,2987,473,8.49,2514
1025070,Hello Lady! -New Division-,289,11,14.99,278
1053160,Witch Ring Meister,29,9,6.99,20
922920,Knights of Tartarus,29,5,9.99,24
963280,Talk to Strangers,215,11,3.99,204
1058000,Rain's love memory-雨的恋记,525,19,0.0,506
1019940,Race for Tuning,301,127,4.99,174
1022780,Animal Fight Club,220,48,3.99,172
485900,Hardware Engineers,243,43,14.99,200
348910,Faerie Solitaire Harvest,146,27,14.99,119
756560,Robot Warriors,30,36,9.99,-6
885570,Nova-Life: Amboise,348,114,9.99,234
664830,Zombotron,1795,219,14.99,1576
956870,Starship Zvezda,5,4,0.0,1
746930,OrbusVR: Reborn,919,272,19.99,647
676830,Xenomarine,44,7,9.99,37
1049660,stein.world,492,252,0.0,240
1048000,Monster Girl Fantasy,27,7,7.99,20
976310,Mortal Kombat 11,57184,8816,49.99,48368
992310,Backbone: Prologue,4018,104,0.0,3914
988100,Super Phantom Cat,170,32,4.99,138
1019920,Gensokyo Defenders,96,5,5.99,91
995050,Havocado: Ragdoll Fighter,408,78,19.99,330
1039970,Grisaia Phantom Trigger Vol.6,84,3,14.99,81
735660,Steamcraft,116,50,0.0,66
1056390,Ultra Savage,336,80,0.0,256
893500,Reign of the Succubus,78,57,9.99,21
1031920,Симулятор Сидения у Подъезда,391,57,0.99,334
859580,Imperator: Rome,12791,9161,39.99,3630
706990,BLOCKPOST,11253,3861,0.0,7392
959050,Bound Up & Squirming!,30,2,4.99,28
718590,Dark Devotion,1518,464,19.99,1054
684580,Shoppe Keep 2,1175,868,9.99,307
1039960,Grisaia Phantom Trigger Vol.5.5,57,2,14.99,55
865250,Phase Shift,82,33,0.0,49
597760,Yuppie Psycho: Executive Edition,4575,228,6.66,4347
924250,PROZE: Enlightenment,81,32,19.99,49
1027130,NEKO-NIN exHeart 2 Love +PLUS,96,7,4.99,89
1023740,7 Sexy Sins,173,23,1.99,150
931690,Himno,4852,450,0.0,4402
593960,Lorelai,932,110,10.99,822
1057640,Onirism,224,25,17.99,199
1072180,Grim Facade: Hidden Sins Collector's Edition,6,0,9.99,6
1053170,Idle Cooking Emperor,57,34,0.0,23
1034410,Strike Solitaire,5,2,4.99,3
828740,Tales of the Neon Sea,2250,345,16.99,1905
629760,MORDHAU,82439,19109,29.99,63330
1042980,Zen Chess: Mate in Two,58,12,0.99,46
494840,UBOAT,10727,2576,29.99,8151
699170,Fell Seal: Arbiter's Mark,4358,500,29.99,3858
844870,KurtzPel,21560,12954,0.0,8606
1042170,Summon of Asmodeus,96,54,6.99,42
706020,Fade to Silence,724,420,29.99,304
1057680,人间 The Lost We Lost,1995,92,3.99,1903
899770,Last Epoch,11069,1720,34.99,9349
950050,Starlink: Battle for Atlas,140,47,59.99,93
1043000,Zen Chess: Mate in Four,33,16,0.99,17
1065020,Micro Mages,288,14,9.99,274
1057780,Jump Off The Bridge,176,20,7.99,156
794270,Landinar: Into the Void,128,89,19.99,39
1058020,"STAR WARS™ Battlefront (Classic, 2004)",3098,114,9.99,2984
792040,Detective Di: The Silk Rose Murders,850,87,10.99,763
951670,Precipice,230,51,7.99,179
922290,Flappy Flappy VR,25,2,2.99,23
1060670,Taboos: Cracks,1246,321,0.99,925
872750,Guard Duty,194,21,9.99,173
978960,Starters Orders 7 Horse Racing,78,28,34.99,50
1029240,Hentai Survive Island,100,45,0.99,55
671440,Rise of Industry,2746,884,29.99,1862
1064860,约拍女神 Private Model,85,72,4.99,13
711810,Never Split the Party,3139,961,0.0,2178
1056580,Family Hidden Secret - Hidden Objects Puzzle Adventure,27,38,0.0,-11
856210,bit Dungeon III,129,43,9.99,86
1061090,Jump King,7635,809,12.99,6826
1064610,Neon Beats,5751,220,0.0,5531
1014920,Favor Chess,24,11,0.0,13
504050,Planet Nomads,1292,644,19.99,648
1020840,豆腐脑模拟器 Tofu Pudding Simulator,39,27,1.99,12
1008800,Shards of Infinity,105,14,7.99,91
1013750,Legal Dungeon,304,86,6.99,218
698610,Through Blocks,11,24,0.49,-13
971620,Puyo Puyo Champions,534,129,9.99,405
681280,Descenders,10941,677,24.99,10264
1007630,Wraithslayer,67,4,4.99,63
1047380,MMA Arena,55,24,1.04,31
1054660,Factory Balls,87,1,3.99,86
983050,Sticky Apps :: Monitor Ping,30,5,3.99,25
1071890,New Yankee in King Arthur's Court 5,4,0,6.99,4
742520,Astrologaster,338,14,9.99,324
430070,Never Again,523,116,13.99,407
1072390,BirdGut,3668,184,0.0,3484
1061640,How To Be A Real Dude,29,36,4.99,-7
929010,Swag and Sorcery,1459,1255,12.99,204
973220,SiNKR 2,173,5,3.99,168
1010750,Blood: Fresh Supply™,4819,223,9.99,4596
927380,Yakuza Kiwami 2,9759,457,29.99,9302
1055760,Prince Maker美少年梦工厂3：重生,233,8,0.0,225
1072590,Game Of Puzzles: Dragons,53,5,0.99,48
985400,Marle: The Labyrinth of the Black Sea,98,40,12.99,58
1073860,Idle Guardians,24,25,0.0,-1
585710,Blazing Beaks,1550,265,14.99,1285
1012560,Snakeybus,1716,135,9.99,1581
1078000,Gamecraft,652,211,0.0,441
750050,Diesel Brothers: Truck Building Simulator,768,424,2.99,344
1067900,HOME,2989,325,0.0,2664
1073220,Teeth Brushing Simulator,132,25,0.99,107
1059320,Hocus Potions,2,4,0.0,-2
1065460,ReThink | Evolved 3,22,1,9.99,21
728740,Sniper Elite V2 Remastered,1379,509,9.99,870
606230,Thea 2: The Shattering,1466,414,24.99,1052
1066290,猎魔者战纪,76,15,2.99,61
548570,RAGE 2,8952,5603,39.99,3349
539330,Light Fairytale Episode 1,170,36,9.99,134
1061820,XMusicVisualizer,30,47,3.99,-17
752590,A Plague Tale: Innocence,41552,2758,7.99,38794
763430,Front Defense: Heroes,88,40,9.99,48
1079310,Elemental Girls,211,40,0.51,171
1010270,Nether: The Untold Chapter,153,110,14.99,43
790850,Undead Horde,983,134,16.99,849
954650,Druidstone: The Secret of the Menhir Forest,1015,193,24.99,822
850980,GUILTY GEAR,263,41,9.99,222
1076480,Dream Flash,32,0,6.99,32
931280,Iron Marines,1025,240,14.99,785
1014730,Cyndy,16,6,7.99,10
990050,Death end re;Quest,863,225,29.99,638
1079210,Spark the Electric Jester 2,296,33,14.99,263
1018010,Castlevania Anniversary Collection,834,183,19.99,651
1035050,Alt-Frequencies,98,16,7.99,82
955170,铁道物语：陆王（Railway Saga:Land King）,369,81,9.99,288
1063790,Citizen of Rome - Dynasty Ascendant,144,32,9.99,112
1058560,Deathbloom: Chapter 1,69,10,9.99,59
896750,Koral,258,44,2.99,214
1033170,Talisman: Origins,116,45,5.99,71
789090,Rainbow Reactor,87,8,2.99,79
866190,Irony Curtain: From Matryoshka with Love,265,34,19.99,231
1014810,Happy Words,48,55,4.99,-7
858860,Tabletop Gods,85,10,19.99,75
793690,Final Assault,397,27,9.99,370
1067600,The Defender: Farm and Castle,908,105,0.0,803
1072150,Hedon Bloodrite,1268,97,16.99,1171
370870,Dark Future: Blood Red States,254,146,24.99,108
1070330,Russian Life Simulator,4606,545,0.49,4061
345330,Eden Rising,893,474,0.0,419
1065710,ClassiCube,72,11,3.99,61
1063770,Pew Dew Redemption,1415,268,0.0,1147
748370,STAND OUT : VR Battle Royale,1004,369,24.99,635
1073490,Monster X Monster,132,29,2.99,103
1077430,There's a Butcher Around,303,46,0.99,257
987400,Disney's Hercules,268,33,5.99,235
1079970,Mundus - Impossible Universe 2,38,2,4.99,36
1045620,Atelier Lulua ~The Scion of Arland~,421,40,59.99,381
1087940,Incredible Dracula 3: Family Secret,19,0,6.99,19
1014130,Jitsumi's Game Booster,80,32,5.99,48
1057850,Neon Boost,2205,238,0.0,1967
1026110,Racing Classics: Drag Race Simulator,395,126,0.0,269
937170,Otaku's Adventure,5071,318,6.99,4753
595790,Hell is Other Demons,262,18,9.99,244
1024400,Marenian Tavern Story: Patty and the Hungry God,39,10,19.99,29
1041940,Fort Sumter: The Secession Crisis,59,9,7.99,50
620980,Beat Saber,61280,2549,29.99,58731
934780,American Fugitive,1571,546,3.99,1025
793680,Fission Superstar X,116,18,14.99,98
1037590,Neptunia Shooter,609,71,4.99,538
641960,BOXVR,1243,322,29.99,921
774151,YOOMURJAK'S RING,32,6,9.99,26
1049800,BLOCKADE,7339,2460,0.0,4879
785260,Team Sonic Racing™,1904,742,39.99,1162
1034390,Alice's Jigsaw. Wonderland Chronicles 2,4,0,4.99,4
871930,GLADIABOTS - AI Combat Arena,720,69,14.99,651
763030,Nelly Cootalot: Spoonbeaks Ahoy! HD,121,14,0.99,107
617850,Jaws Of Extinction™,190,119,19.99,71
505230,Pathologic 2,6567,539,34.99,6028
1090390,House of 1000 Doors: Serpent Flame,58,10,6.99,48
1078800,U-BOOT The Board Game,41,20,0.0,21
1080250,Fool!,18,2,6.99,16
942580,An Adventurer's Tale,16,18,11.99,-2
774861,Project Winter,14695,2883,19.99,11812
1051290,ZIC – Zombies in City,25,7,4.99,18
1077340,Downtown Drift,70,21,0.0,49
944010,S.W.I.N.E. HD Remaster,792,72,2.99,720
779340,Total War: THREE KINGDOMS,64497,26725,59.99,37772
1015720,Alternate DiMansion Diary,308,41,9.99,267
489940,BATTALION 1944,9649,6256,19.99,3393
880580,YORG.io,367,44,3.99,323
1041680,Wave Circles: Rhythm Dance Music,44,27,0.0,17
930780,Blood Card,523,121,4.49,402
573490,Interstellar Transport Company,264,105,24.99,159
950740,China: Mao's legacy,613,42,6.99,571
677620,Splitgate,94853,8727,0.0,86126
280850,Dollhouse,80,57,19.99,23
1047410,Steambirds Alliance Beta,239,33,0.0,206
489520,Minion Masters,53364,5068,0.0,48296
1015080,Vampire & Monsters: Mystery Hidden Object Games - Puzzle,49,17,3.99,32
898800,Constructor Plus,274,31,19.99,243
990030,Deep Diving Simulator,56,27,19.99,29
1015830,DreamEater 噬梦者,362,101,0.0,261
565180,Dogurai,58,3,4.99,55
603320,Age of Defense,397,114,9.99,283
994730,Banner of the Maid,5554,641,16.99,4913
817540,SpellForce 3: Soul Harvest,1652,288,19.99,1364
857980,Void Bastards,3891,605,29.99,3286
1029890,Layers of Fear 2,1512,583,19.99,929
727130,Between the Stars,1348,337,19.49,1011
809720,Rescue HQ - The Tycoon,587,137,19.99,450
904380,Vambrace: Cold Soul,449,243,4.99,206
925460,Vectronom,229,5,9.99,224
732690,FIVE NIGHTS AT FREDDY'S: HELP WANTED,8152,270,29.99,7882
793370,KIDS,1287,260,2.99,1027
693960,Just Ride：Apparent Horizon 狂飙：极限视界,128,49,19.99,79
805550,Assetto Corsa Competizione,19796,1962,13.59,17834
989690,Conan Unconquered,1116,500,7.99,616
697550,It Lurks Below,1023,162,19.99,861
770390,Draugen,1216,393,19.99,823
1079870,Otiiz's adventure 2,0,1,6.99,-1
336440,Super Cane Magic ZERO - Legend of the Cane Cane,373,31,19.99,342
1076210,Who wants to strip this babe? Streamer Girl,89,15,0.99,74
995230,FREEDIVER: Triton Down,229,39,8.99,190
1076640,Cricket Captain 2019,52,30,9.99,22
812810,missed messages.,12719,508,0.0,12211
905490,Deck Hunter,220,78,9.99,142
851950,Heroine of the Sniper,283,14,9.99,269
775940,Rise of Liberty,1440,226,3.99,1214
1048950,Desert Skies,257,90,19.99,167
905370,Conqueror's Blade,19057,6192,0.0,12865
588440,False Front,205,60,0.0,145
916730,Gato Roboto,2900,156,7.99,2744
1076920,Generals & Rulers,252,135,11.99,117
1085260,Ports of Call Classic,41,6,4.99,35
593600,PixARK,7191,2840,39.99,4351
804010,SteamWorld Quest: Hand of Gilgamech,1203,165,24.99,1038
1018850,Smile For Me,1808,55,12.99,1753
774241,Warhammer: Chaosbane,2733,2236,29.99,497
1048540,Kao the Kangaroo: Round 2 (2003 re-release),6753,454,1.99,6299
1009450,Sankaku Renai: Love Triangle Trouble,200,9,29.99,191
1041320,Lords Mobile,2913,1363,0.0,1550
950400,Blame Him,59,70,14.99,-11
1044200,Wasteland Survival,3185,2236,0.0,949
789760,DEAD OR SCHOOL,2173,363,24.99,1810
1065970,狼と香辛料VR/Spice&WolfVR,950,68,24.99,882
431450,Alchemist's Awakening,355,112,9.99,243
900270,Reventure,6955,374,7.99,6581
1051200,Trover Saves the Universe,2449,207,29.99,2242
1073820,"Love, Sam",199,11,2.99,188
1010260,The Coroner Saga,3,8,4.99,-5
1005130,Delicious - Emily's Road Trip,85,19,12.99,66
704880,Trident's Wake,43,55,14.99,-12
954280,3dSen VR,137,9,19.99,128
923910,Eve of Souls: Static Pod,384,18,2.99,366
1015550,Asdivine Dios,4,0,12.99,4
1068540,Aurora Hex - Pattern Puzzles,4,1,4.99,3
1089860,Blautopf VR - Geheimnis der Lau,39,9,0.0,30
602960,Barotrauma,28384,2336,29.99,26048
1084020,TheoTown,1079,80,7.99,999
1091650,XMagicMouse,48,34,2.99,14
814740,Armored Battle Crew [World War 1] - Tank Warfare and Crew Management Simulator,233,290,19.99,-57
543910,"World of DASM, DASM Spell Quest",8,0,0.99,8
934930,RDS - The Official Drift Videogame,868,218,17.99,650
1089130,Quake II RTX,3199,446,0.0,2753
1088870,奇幻与砍杀 Fantasy & Blade,172,52,3.99,120
825730,Tzar: The Burden of the Crown,299,21,4.99,278
650330,Sanator: Scarlet Scarf,339,33,3.99,306
759260,Go All Out,23,8,12.99,15
984780,MotoGP™19,1287,165,24.99,1122
1015800,Ordeal of Princess Eris,105,43,14.99,62
641320,Cooking Simulator,11695,2262,8.99,9433
985080,食用系少女 Food Girls,384,19,19.99,365
1087820,Bad Mojos,4,3,0.0,1
895200,SWORDS of GARGANTUA,191,86,24.99,105
1070190,Spellsword Cards: Origins,48,20,9.99,28
865940,SNK 40th ANNIVERSARY COLLECTION,139,33,29.99,106
1091960,Drowning Cross,153,15,0.0,138
1040820,Rumble Arena,132,66,0.0,66
1064130,Sakura MMO 3,138,9,9.99,129
1058320,Toki,306,44,19.99,262
921570,OCTOPATH TRAVELER™,9336,1469,59.99,7867
858630,Aquaculture Land: Fish Farming Simulation,123,28,9.99,95
884090,Idle Dungeons,66,152,0.0,-86
1078640,Eggoria,43,18,19.99,25
1066260,Devolver Bootleg,929,106,4.99,823
1084570,The Lar,843,39,0.0,804
1071120,Mushroom Cats,1305,46,0.0,1259
1087080,Critical Compendium,53,4,0.0,49
314650,SpaceEngine,6116,249,24.99,5867
1057720,Shattered Lights,319,37,0.0,282
1018020,Contra Anniversary Collection,507,158,19.99,349
832770,Age of Fear: The Undead King GOLD,73,2,14.99,71
685340,Delivery from the Pain:Survival / 末日方舟:生存,710,175,7.99,535
1096540,XMagicTyping,14,13,2.99,1
1081840,ANONYMOUS || AGONY,45,8,0.0,37
1058140,Yumeutsutsu Re:Master,246,19,64.99,227
1096010,Hentai Sudoku,28,18,0.99,10
1072170,Order Up VR,58,18,0.0,40
1072920,HomeWork Is Crazy / 作业疯了,328,783,7.99,-455
311310,Naval Action,6025,3964,19.99,2061
732400,PlataGO! Super Platform Game Maker,82,19,19.99,63
1038810,GOD WARS The Complete Legend,131,38,6.59,93
1055310,The Myth Seekers 2: The Sunken City,64,21,14.99,43
877080,Seeds of Resilience,233,95,13.99,138
1011940,Ideology in Friction,1253,147,24.99,1106
960590,Courage for a Kiss,44,4,19.99,40
1034900,Blaster Master Zero,627,43,9.99,584
1063960,Ritual: Sorcerer Angel,22,2,9.99,20
754850,The Spy Who Shrunk Me,71,23,9.99,48
602700,Chippy,779,73,14.99,706
440310,Project Arrhythmia,1532,54,11.99,1478
1089810,下一层的封魔塔 Forever War,87,38,4.99,49
973000,Die Young: Prologue,267,80,0.0,187
965820,沉睡的法则 Things as They Are,854,19,5.99,835
746510,Duck Season PC,627,54,9.99,573
1098840,ZACH-LIKE,123,2,0.0,121
1092780,Depixtion,46,3,7.99,43
1065100,Golden Treasure: The Great Green,385,16,19.99,369
1010600,"The Princess, the Stray Cat, and Matters of the Heart",204,24,19.99,180
1067350,Sophie's Dice,95,2,4.99,93
943980,The logic of the miniature garden,363,51,9.99,312
692850,Bloodstained: Ritual of the Night,30194,1671,39.99,28523
1037940,Dead Monarchy,44,8,9.99,36
1043240,Touhou Kishinjou ~ Double Dealing Character.,247,0,14.99,247
1043230,Touhou Shinreibyou ~ Ten Desires.,241,8,14.99,233
644930,They Are Billions,33548,5903,29.99,27645
1076550,SAMURAI SHODOWN V SPECIAL / サムライスピリッツ零スペシャル,388,30,9.99,358
1019590,Lovely Planet 2: April Skies,125,8,9.99,117
695720,Matchville - Match 3 Puzzle,44,58,0.0,-14
1040730,ZUSI 3 - Aerosoft Edition,296,32,69.99,264
599590,Volleyball Fever,57,5,14.99,52
783770,Ironsight,12443,4743,0.0,7700
774171,Muse Dash,66332,4419,2.99,61913
919640,Steel Division 2,4953,1338,39.99,3615
1097620,Fast and Low,376,90,20.99,286
1064730,Fantasy Girl,4723,227,0.99,4496
1094060,Escape First 2,141,103,5.99,38
1046930,Dota Underlords,73491,15523,0.0,57968
1086010,198X,1273,417,9.99,856
1090560,Boy VS Genius 贫穷少年与校园名人的生死对决,69,18,0.99,51
673130,AMID EVIL,4681,205,19.99,4476
1016960,Super Neptunia RPG,735,184,29.99,551
402940,Dungeons of Betrayal,26,5,0.54,21
1069740,Seen,6805,521,2.99,6284
896230,Picross Bonbon - Nonogram,42,21,4.99,21
989550,Million Arthur: Arcana Blood,185,53,39.99,132
557340,My Friend Pedro,23426,967,19.99,22459
978190,Steel Sword Story,55,21,4.99,34
950700,VICCP,96,38,3.99,58
1091010,Dark Swords,168,85,0.0,83
731650,Summer Islands,49,17,14.99,32
1068640,Village Feud,224,88,3.99,136
1044490,The Expression Amrilato,527,15,24.99,512
755790,Ring of Elysium,74490,25643,0.0,48847
1094930,Ninja Girl and the Mysterious Army of Urban Legend Monsters! ~Hunt of the Headless Horseman~,44,6,15.99,38
1098340,Zup! 9,1308,55,0.99,1253
1029900,Rummy 3D Premium,35,13,14.99,22
1000080,Zengeon,1009,439,19.99,570
981770,SENRAN KAGURA Reflexions,326,45,9.99,281
1067800,Spider-Man: Far From Home Virtual Reality,1310,485,0.0,825
1051260,Forklift: Simulator,15,11,2.99,4
262370,A.N.N.E,21,11,69.99,10
868020,Aperture Hand Lab,966,111,0.0,855
824280,Monster Jam Steel Titans,210,100,19.99,110
746580,HARDCORE MECHA,1969,404,19.99,1565
550650,Black Squad,60278,18642,0.0,41636
1022480,KAMIKO,122,17,4.99,105
1093760,Shogun's Empire: Hex Commander,38,13,9.99,25
1056490,The World is Your Weapon,495,15,9.99,480
976800,九劫曲：诅咒之地 NINE TRIALS,1993,1324,0.0,669
936140,Pro Cycling Manager 2019,543,125,9.99,418
1096720,CATGIRL LOVER,683,199,1.99,484
589040,Fujii,86,4,14.99,82
1083210,符文女孩/Rune Girl,1049,473,0.99,576
1008510,Who Is This Man,138,80,9.99,58
862800,Storm Chasers,1228,169,12.99,1059
1019820,Galaxicus,2,1,29.99,1
1068820,OVR Toolkit,1704,211,11.99,1493
1100970,Dancing Girl,697,348,2.99,349
1057700,Battle Grounds III,2606,466,0.0,2140
966090,Canasta 3D Premium,32,12,14.99,20
1103630,Event Horizon - Frontier,6,18,4.99,-12
1097800,Stranger Things 3: The Game,492,67,0.0,425
621000,异常 | Exception,1636,40,3.99,1596
742460,Marble Skies,236,35,9.99,201
1094000,Survive on Raft,435,255,9.99,180
1032670,FOCUS on YOU,462,46,39.99,416
1101940,Victorian Mysteries: Woman in White,23,15,4.99,8
1102580,Traffix,36,12,4.99,24
1070020,我的纸片人女友/Make butter together!,571,43,6.99,528
1103210,We Become What We Behold [Fan-Made Port],2763,96,0.0,2667
1036440,Kingdom Wars 2: Definitive Edition,258,102,9.99,156
602490,Blood Bowl: Death Zone,35,111,0.0,-76
1089290,Truefish,2,2,6.99,0
1094390,Waltz of the Wizard: Natural Magic,180,22,19.99,158
823610,Dungeon Of Dragon Knight,222,56,11.99,166
834800,SolSeraph,51,40,14.99,11
981020,Clea,339,6,13.99,333
681110,Eagle Island Twist,163,40,12.99,123
555000,GOAT OF DUTY,3050,470,9.99,2580
1058640,RED HOT VENGEANCE,2626,105,0.0,2521
1102100,TINY METAL: FULL METAL RUMBLE,113,22,14.99,91
1007040,EARTH DEFENSE FORCE 5,6244,351,59.99,5893
1069610,Exile of the Gods,10,2,6.99,8
1081510,She Sees Red - Interactive Movie,2077,569,2.39,1508
609110,Blazing Chrome,1140,137,16.99,1003
1011390,Field of Glory: Empires,590,120,39.99,470
512900,Streets of Rogue,15326,556,19.99,14770
688660,Her Majesty's Ship,53,55,9.99,-2
1088590,love love love,171,60,0.99,111
1069030,EarthX,500,52,14.99,448
1099400,唤境引擎 Evkworld,29,13,0.0,16
744900,Dead Frontier 2,14316,5811,0.0,8505
739540,Break the Game,449,145,9.99,304
921710,Galaxy Squad,296,97,9.99,199
979920,Supremacy 1914: World War 1,1372,480,0.0,892
1032170,Robo Instructus,51,10,12.99,41
967330,Starfighter: Infinity,97,9,19.99,88
908050,Summer Catchers,144,32,11.99,112
1073840,Nocked! True Tales of Robin Hood,58,4,19.99,54
372320,LOST ORBIT: Terminal Velocity,23,2,9.99,21
1115640,英雄群侠传II,1557,151,19.99,1406
1077440,卡片地下城Card Monsters: Dungeon,304,95,2.33,209
680380,Night Call,340,126,19.99,214
764920,Fear the Night - 恐惧之夜,484,373,14.99,111
1078970,局外人 L'Etranger,270,58,0.0,212
940580,FIA European Truck Racing Championship,164,79,29.99,85
1043430,Tidal Tribe,65,10,14.99,55
629090,Horace,468,108,14.99,360
920680,Fate Hunters,612,163,14.99,449
420020,Eye of the Owl - Bosch VR,69,6,0.0,63
578620,GORN,7192,438,19.99,6754
1089660,Queen's Quest 5: Symphony of Death,77,21,14.99,56
812160,Etherborn,244,96,16.99,148
1087460,Super Life (RPG),402,41,9.99,361
1120800,Alex Hunter: Lord of the Mind,36,4,6.99,32
1012030,Detective Girl of the Steam City,1287,111,14.99,1176
1034940,Higurashi When They Cry Hou - Ch.7 Minagoroshi,290,10,5.19,280
916100,Telefrag VR,48,28,16.99,20
1057180,Border Officer,547,400,9.99,147
1010890,Touhou Fantasia / 东方梦想曲,1315,54,0.0,1261
681730,Nowhere Prophet,672,236,24.99,436
659500,A Mining Game,101,56,0.0,45
679900,Swords & Souls: Neverseen,3099,227,14.99,2872
1063310,Vane,239,185,19.99,54
944020,Dream Ending,2153,56,3.99,2097
1096200,The Orville - Interactive Fan Experience,785,76,0.0,709
1047440,DATE A LIVE: Rio Reincarnation,2355,151,39.99,2204
984800,Automachef,498,196,14.99,302
512890,Elsinore,224,9,9.99,215
827050,Rising Kingdoms,134,13,4.99,121
1118200,People Playground,127114,1429,9.99,125685
549040,Biotope,90,109,19.99,-19
1064310,A Place for the Unwilling,45,16,14.99,29
390560,Fantasy Strike,1186,627,0.0,559
1040740,Legend of the Tetrarchs,20,6,14.99,14
926990,WolfQuest: Anniversary Edition,4284,147,19.99,4137
832320,Mighty Switch Force! Collection,57,5,19.99,52
1009750,Flappatron,123,3,0.99,120
1111210,The Backrooms Game FREE Edition,2477,431,0.0,2046
909820,Songbird Symphony,352,27,16.99,325
984680,Interstellar Space: Genesis,466,97,9.89,369
1101270,Anime Artist,111,26,1.99,85
690200,Capsular,66,8,0.0,58
922500,KILL la KILL -IF,876,377,19.99,499
1110030,Heroes of Myth,46,10,6.99,36
769560,月圆之夜 (Night of Full Moon),5845,785,0.0,5060
869060,Resort Boss: Golf,57,85,12.99,-28
909970,Tech Corp.,84,161,19.99,-77
939600,LOVE³ -Love Cube-,2192,121,9.99,2071
1012880,60 Seconds! Reatomized,7637,492,9.99,7145
1056960,Wolfenstein: Youngblood,4874,5694,19.99,-820
677480,Outpost Zero,405,382,19.99,23
1056970,Wolfenstein: Cyberpilot,109,133,19.99,-24
868150,Takelings House Party,195,63,19.99,132
449610,Monster Boy and the Cursed Kingdom,1642,151,29.99,1491
1113310,Post Soviet Zombies,70,11,4.99,59
1069230,Tsukikage no Simulacre:Kaihou no Hane,2200,43,6.23,2157
330580,Shark Attack Deathmatch 2,1414,450,2.49,964
922710,Knightin'+,183,28,2.99,155
1119940,Storm Tale,39,3,9.99,36
972160,The Witch's Love Diary,75,6,29.99,69
1070550,Don't Escape Trilogy,208,1,4.99,207
1099960,Mini Tone - Minimalist Puzzle,40,14,0.99,26
1109360,Hentai Mosaique Fix-IT Shoppe,281,11,1.99,270
1119060,The Designer's Curse,590,67,0.0,523
947890,VirtualCast,68,18,0.0,50
1067850,Kindergarten 2,2721,60,14.99,2661
599080,The Blackout Club,2036,483,29.99,1553
1050000,Bear With Me: The Lost Robots,84,13,1.24,71
948960,Morphies Law: Remorphed,78,14,9.99,64
980480,Towertale,58,2,3.99,56
457140,Oxygen Not Included,82902,3014,24.99,79888
965600,Raiders of the North Sea,157,17,14.99,140
1042800,"Warhammer 40,000: Inquisitor - Prophecy",1636,403,24.99,1233
1028630,Cricket 19,2306,229,29.99,2077
1054800,变量 Variables,830,125,10.99,705
1097580,CUSTOM ORDER MAID 3D2 It's a Night Magic,1071,186,40.0,885
1055540,A Short Hike,10937,81,7.99,10856
1071940,Streamer's Life,102,32,9.99,70
1111540,Room 40,67,19,0.0,48
447700,Crystal Crisis,81,23,19.99,58
774651,MIGHTY GUNVOLT BURST,121,20,3.99,101
627350,London Detective Mysteria,94,12,29.99,82
1065200,Visitor2 / 来访者2,132,41,6.99,91
307110,We Need To Go Deeper,4145,639,15.99,3506
1015770,Tina: Swordswoman of the Scarlet Prison,319,60,14.99,259
617640,Forged of Blood,77,38,29.99,39
1074610,COLLAPSED,130,50,14.99,80
1081870,WarForwards,36,8,9.99,28
873890,Legends of Amberland: The Forgotten Crown,164,13,19.99,151
885950,Airranger,120,6,10.99,114
878090,The Dragons' Twilight II,21,1,9.99,20
999730,Secret Neighbor Beta,2430,482,0.0,1948
1069090,PureDesktop,19,25,0.0,-6
339830,The Church in the Darkness ™,68,43,19.99,25
1116960,UNDEFEATED,4757,574,0.0,4183
1100170,Double Spoiler,47,1,10.99,46
1077970,Dry Drowning,312,58,19.99,254
889700,Muv-Luv photonflowers*,154,10,24.99,144
1100180,Yousei Daisensou ~ Touhou Sangetsusei,69,2,10.99,67
1122750,异化之恶〇Abnormal Treatment,2631,59,0.0,2572
989450,时之回廊/Corridor of time,337,189,10.99,148
856570,Lost Flame,34,0,13.99,34
914260,HALF DEAD 2,1770,321,2.49,1449
1108740,Stick Em Up,79,44,9.99,35
1084520,雀姬/姫麻雀,1298,902,0.0,396
1114420,PLAY'A VR  Video Player,81,61,0.0,20
984730,Battles For Spain,20,5,29.99,15
1108090,Climb With Wheelbarrow,154,23,0.99,131
975470,Silver Chains,420,147,24.99,273
1120370,場外人生,248,32,4.99,216
718850,Age of Wonders: Planetfall,4341,1058,49.99,3283
809140,Cliff Empire,3221,462,14.99,2759
1046600,勇者有点太嚣张。™G(No Hero Allowed: No Puzzle Either!),34,25,2.99,9
820630,Metal Wolf Chaos XD,476,93,24.99,383
952290,Zueirama,805,39,4.99,766
995700,Jewel Puzzle Click,18,9,4.99,9
1105110,OXXO,187,9,1.99,178
1102410,LOST:SMILE memories,25,1,44.99,24
1048100,Peekaboo,2509,651,1.49,1858
908790,Subdivision Infinity DX,74,20,14.99,54
1054550,Phantom Rose,564,173,14.99,391
914020,Gibbous -  A Cthulhu Adventure,1494,163,19.99,1331
1004610,Roombo: First Blood,249,26,4.99,223
1097670,Keeper of the Sun and Moon,27,6,3.99,21
1125130,Area 51,7,3,0.99,4
960980,Apsulov: End of Gods,1011,135,19.99,876
1112240,Wonder Boy Returns Remix,54,17,12.99,37
603390,Stone Story RPG,563,54,19.99,509
1075980,NinNinDays,406,24,12.99,382
844860,Tank Operations: European Campaign,70,9,11.99,61
1128480,Nice Jumper,253,38,0.0,215
1113940,Electronic Super Joy 2,587,79,0.0,508
623320,Button Button Up!,163,7,11.99,156
1120360,At Home Alone II,167,18,1.99,149
1005340,Myths and Legends - Card Game,303,187,0.0,116
1073390,Aircar,1745,95,0.0,1650
1120980,bit Dungeon,96,11,0.99,85
577710,Pirates of Everseas,55,34,0.0,21
702050,The Song of Saya,3353,250,14.99,3103
846030,ΔV: Rings of Saturn,862,42,9.99,820
755540,LIV,614,70,0.0,544
877810,Anodyne 2: Return to Dust,489,32,19.99,457
716500,Eliza,1204,114,14.99,1090
1114430,Ballex,345,41,3.99,304
609420,Never Give Up,95,11,14.99,84
1085630,VASARA Collection,99,18,9.99,81
861540,Dicey Dungeons,7524,816,14.99,6708
1002930,War of Tanks: Blitzkrieg,93,66,0.0,27
1101450,Miss Neko,2817,297,0.99,2520
1084480,Wanna Survive,218,16,11.99,202
1016930,The Great Perhaps,427,113,0.99,314
1038740,Fluffy Store,2585,74,1.99,2511
1026160,Misadventures of Laura Silver,205,29,7.99,176
1113730,Cubico,124,32,0.0,92
1074080,SENRAN KAGURA Peach Ball,461,57,29.99,404
994040,Lichtspeer: Double Speer Edition,35,7,9.99,28
915130,东方龙隐談 ~ Touhou Chaos of Black Loong,128,20,9.9,108
1131960,云聚：失落的魔法 Magic Ganglia,90,36,13.99,54
562860,Ion Fury,5736,571,24.99,5165
812040,Shortest Trip to Earth,973,282,24.99,691
773740,Overpass,93,8,14.99,85
1064200,Brewer,43,12,3.99,31
1043390,FlowScape,1027,160,14.99,867
907760,ARIDA: Backland's Awakening,448,62,6.99,386
433550,DARQ: Complete Edition,3067,195,19.99,2872
1113680,Hentai Girl Division,507,84,1.99,423
1132190,Coloring Game: Little City,882,54,0.0,828
834580,東方逆妙乱 ~ Ephemeral Unnatural Balance,65,4,9.99,61
671610,Warfork,1370,164,0.0,1206
655780,Project 5: Sightseer,310,135,0.0,175
1074520,A Sceptic's Guide to Magic,47,2,1.24,45
1109130,逝去的回忆3：四叶草之梦,544,17,9.99,527
1033420,9-nine-:Episode 2,817,14,19.99,803
1118920,TrenchesWIP,952,344,0.0,608
622870,Within the blade,288,40,10.99,248
1103780,Top Speed 2: Racing Legends,78,55,0.0,23
1117310,Sandwich Sudoku,134,2,4.99,132
617290,Remnant: From the Ashes,35174,6275,39.99,28899
1128830,1001 Jigsaw World Tour: Europe,5,1,4.99,4
1114860,Hobs,1095,175,0.0,920
1017900,Age of Empires: Definitive Edition,8087,1564,19.99,6523
722560,RAD,606,198,4.99,408
1133320,Westworld Awakening,259,49,29.99,210
950300,REDO!,118,15,9.99,103
1122880,Stones of Solace,114,9,0.0,105
1065880,Dungeon Scavenger,95,5,7.99,90
829660,No Time to Relax,1059,75,13.99,984
594130,Winds of Change,437,13,10.99,424
1137910,Perdition,112,14,0.0,98
919370,Overdungeon,2183,594,14.99,1589
1124060,Touhou Shoujo Tale of Beautiful Memories / 東方少女綺想譚,150,10,29.99,140
987720,ONINAKI,263,129,49.99,134
814530,Death Crown,348,38,9.99,310
1067310,Gravitas,5625,119,0.0,5506
1129610,Book Seeker,3,1,0.99,2
762830,Telling Lies,614,305,19.99,309
1086640,Dude Simulator 3,1211,575,4.99,636
568070,Mable & The Wood,40,35,14.99,5
322770,Vanishing Realms™,2309,238,19.99,2071
1067810,First Day,24,18,0.0,6
992640,Pagan: Absent Gods,1415,1361,19.99,54
592480,Knights And Bikes,383,25,19.99,358
1049880,My Free Farm,26,17,0.0,9
1018160,MXGP 2019 - The Official Motocross Videogame,865,90,29.99,775
940910,Minoria,1501,320,19.99,1181
981750,Crystar,752,171,59.99,581
1132730,巅峰骑士团,1024,98,8.99,926
1091980,The Bard's Tale IV: Director's Cut,738,224,34.99,514
594650,Hunt: Showdown,111202,22833,19.99,88369
1041400,Fight Angel/格斗天使,58,3,0.0,55
1033810,New Age,59,39,0.0,20
1004510,DownStream: VR Whitewater Kayaking,41,4,7.59,37
808770,Headspun,17,12,5.49,5
911550,Din's Legacy,115,33,19.99,82
605100,Renzo Racer,30,30,4.99,0
559260,Wayward Souls,129,37,6.74,92
1140070,Tractor Cargo Driving Simulator,38,5,1.99,33
977500,克苏鲁异闻录,152,72,12.99,80
1120950,Chameleon Run Deluxe Edition,64,3,5.99,61
1094870,Acron: Attack of the Squirrels!,117,8,19.99,109
1111450,Youth Feather,607,58,2.99,549
1106080,Princess Project,317,74,14.99,243
939850,The Dark Pictures Anthology: Man of Medan,6002,2140,29.99,3862
839870,Wilmot's Warehouse,319,11,14.99,308
905340,Heave Ho,1701,156,9.99,1545
801480,Agent A: A puzzle in disguise,2774,114,19.99,2660
1045120,Brunch Club,39,15,11.99,24
1113780,Uncharted Tides: Port Royal,115,23,14.99,92
1102880,Kawaii Deathu Desu,108,42,3.99,66
41060,Serious Sam Classic: The Second Encounter,1427,58,5.99,1369
227780,Serious Sam Classics: Revolution,2669,257,9.99,2412
41050,Serious Sam Classic: The First Encounter,2395,99,5.99,2296
1147220,Grim Tales: Guest From The Future Collector's Edition,6,0,9.99,6
1092660,Blair Witch,4068,1161,29.99,2907
1012610,Buoyancy,462,143,12.99,319
931270,MicroTown,366,15,9.99,351
1077530,SUPER BUILD,197,32,14.99,165
823950,Re:Legend,942,613,19.99,329
1136770,Maze,2,2,9.99,0
865830,Psychedelica of the Ashen Hawk,342,54,29.99,288
657730,Wolflord - Werewolf Online,145,22,4.99,123
1110650,别以为你是开发者我就不敢打你,20,14,1.99,6
1128420,Solitaire Jack Frost Winter Adventures,3,0,4.99,3
851930,Battle Royale Tycoon,335,135,9.99,200
1116430,Mostly Intense Monster Defense,52,4,4.99,48
1127310,HelixVision,83,44,4.99,39
1056510,Root Letter Last Answer,107,20,2.99,87
959130,Dandy & Randy,30,2,0.0,28
1026680,FINAL FANTASY VIII - REMASTERED,1891,933,19.99,958
1128910,Magic Quest: TCG,29,16,0.0,13
330020,Children of Morta,12232,1259,7.47,10973
996580,Spyro™ Reignited Trilogy,14546,782,39.99,13764
1144030,Pesterquest,1020,106,11.99,914
1120960,Crafting Block World,13,20,0.0,-7
1106770,Shepherd of Light,681,35,0.0,646
994670,ThreatGEN: Red vs. Blue,40,4,14.99,36
1049320,River City Girls,1945,347,29.99,1598
827000,Celtic Kings: Rage of War,95,9,4.99,86
815370,Green Hell,41669,6187,24.99,35482
1151630,House of 1000 Doors: Family Secrets,77,6,6.99,71
948900,macdows 95,438,30,4.99,408
783340,FRACTER,28,4,6.99,24
1025440,Fantasy General II,818,165,39.99,653
919220,Destiny or Fate,252,183,4.99,69
1140570,A Street Cat's Tale,177,8,4.99,169
1114340,Mortadelo y Filemón: Operación Moscú,1,5,11.99,-4
666730,This Merchant Life,118,37,10.99,81
1015090,Last Day of Rome,95,88,11.99,7
1089350,NBA 2K20,30450,30445,0.0,5
852300,Creature in the Well,229,64,14.99,165
1092260,Come on Baby!,53,10,14.99,43
623700,Rec Center Tycoon - Management Simulator,200,34,9.59,166
1147960,[Chilla's Art] Okaeri | おかえり,332,163,2.99,169
1142180,SE VR World Demo,44,9,0.0,35
606880,GreedFall,12218,3404,34.99,8814
1039880,Hellsplit: Arena,2014,356,24.99,1658
1128430,Solitaire Match 2 Cards. Valentine's Day,3,1,0.49,2
946860,Stamp Boy / 跳跳小子,85,6,1.99,79
1097840,Gears 5,13092,6065,39.99,7027
1079160,Touhou Kikeijuu ~ Wily Beast and Weakest Creature.,883,23,14.99,860
814400,Battlewake,76,30,29.99,46
1017100,Territory Idle,1140,252,0.0,888
774361,Blasphemous,21561,2329,24.99,19232
996470,eFootball  PES 2020,18629,7646,0.0,10983
520660,Wrack: Exoverse,29,12,14.99,17
1058130,Queen's Wish: The Conqueror,261,50,19.99,211
1133730,Second Galaxy,558,523,0.0,35
1087330,Royal Merchant,29,16,9.99,13
1147950,Shio And Mysterious Forest,45,7,7.99,38
1071490,Miss Lisette's Assassin Maid,90,31,9.99,59
861050,DemonsAreCrazy,283,360,0.0,-77
1135240,Men of War: Assault Squad 2 - Cold War,231,729,24.99,-498
524010,Siege of Centauri,246,134,14.99,112
433170,Die Young,1289,323,19.99,966
1070710,Kind Words (lo fi chill beats to write to),7477,127,4.99,7350
957570,The Qaedon Wars - The Story Begins,18,4,4.99,14
1127980,NASCAR Heat 4,1258,300,14.99,958
391460,WARMODE,10444,6474,0.0,3970
956680,M.A.S.S. Builder,2718,303,24.99,2415
1147490,Frontline: Western Front,35,6,5.99,29
993690,Transport Services,40,33,9.99,7
931650,Braveland Heroes,226,190,0.0,36
572480,Orbiz,4,1,14.99,3
922100,Nauticrawl,251,15,14.99,236
1063580,Aeon's End,241,48,14.99,193
861650,Session: Skate Sim,6605,1105,24.99,5500
887720,Devil's Hunt,328,490,14.99,-162
1087500,Groundhog Day: Like Father Like Son,65,18,14.99,47
321980,Hardland,404,158,24.99,246
948740,AI: The Somnium Files,4835,396,39.99,4439
970960,Rebel Cops,924,290,9.99,634
842100,Daymare: 1998,1763,668,10.49,1095
1142500,Fun with Ragdolls: The Game,3115,426,14.99,2689
585420,Trailmakers,11670,1019,24.99,10651
714120,Little Misfortune,5233,586,19.99,4647
966320,Later Alligator,1530,44,17.99,1486
873940,Crying Suns,2886,445,24.99,2441
876190,Football Drama,49,23,11.99,26
355680,Overland,303,115,19.99,188
837510,Pixel Game Maker MV,312,128,16.99,184
382560,Hot Lava,4353,304,19.99,4049
1124660,STORM AREA 51: AYY LMAO EDITION,581,143,0.99,438
319870,Jenny LeClue - Detectivu,808,110,19.99,698
693800,Loco Parentis / 孤女咒怨,249,203,14.99,46
798460,Ni no Kuni Wrath of the White Witch™ Remastered,2388,375,49.99,2013
1149930,Tale's Casino Escape,28,4,0.0,24
1087810,Forgetful Dictator,51,5,9.99,46
539470,Police Stories,4835,820,14.99,4015
1080750,Mutazione,637,22,9.99,615
1127010,Ebullition LBVR,2,0,24.99,2
740080,Deadly Days,840,127,2.99,713
987350,PlanetSide Arena,872,1063,0.0,-191
1107370,Demoniaca: Everlasting Night,145,57,14.99,88
1136240,Crowd Control,30,9,0.0,21
1013960,Open Wheel Manager,26,8,9.99,18
928440,Azure Reflections,119,15,12.49,104
764050,Maelstrom,1994,414,0.0,1580
762650,Depraved,670,388,19.99,282
1130620,[Chilla's Art] Aka Manto | 赤マント,528,52,4.99,476
1153990,Hacker Evolution - 2019 HD remaster,2,2,0.59,0
1155590,Warplanes: WW1 Sky Aces,401,92,0.0,309
644830,The Surge 2,4793,1368,29.99,3425
1017410,Tetra Project - 原石计划,525,26,9.99,499
1110100,Power Rangers: Battle for the Grid,1035,159,10.99,876
669290,Espire 1: VR Operative,260,217,29.99,43
1095860,Mystery Solitaire Grimm's tales 2,4,0,4.99,4
1098940,Home Sweet Home EP2,643,207,18.99,436
914710,Cat Quest II,3136,118,14.99,3018
1020540,CONTRA: ROGUE CORPS,73,104,39.99,-31
1121910,"I Love You, Colonel Sanders! A Finger Lickin’ Good Dating Simulator",10480,892,0.0,9588
1141930,Mondly: Learn Languages in VR,23,21,9.99,2
1085160,Palmyra Orphanage,508,60,5.99,448
1017180,The Long Drive,10644,976,11.99,9668
1058430,A Legionary's Life,1485,236,7.99,1249
1093910,Tales of the Black Forest,6963,120,3.99,6843
1157890,The Binding of YOU,18,22,0.99,-4
1085180,Gunvolt Chronicles: Luminous Avenger iX,541,56,7.49,485
739130,The Executioner,245,111,9.99,134
1138190,Poker Championship,953,200,0.0,753
1025540,Rebels & Redcoats,4,1,9.99,3
1005950,大老爷,59,127,0.0,-68
1013320,Firestone Idle RPG,3437,874,0.0,2563
821250,Flotsam,1680,546,24.99,1134
1158320,Hentai: Memory leak,44,8,0.49,36
1092590,沙雕之路,851,28,10.0,823
1005530,Club Soccer Director PRO 2020,8,16,24.99,-8
1006710,Decent Icons 2,44,12,2.99,32
1127400,Mindustry,11084,405,5.99,10679
1127820,Repressed,14,5,9.99,9
1045840,Intruders: Hide and Seek,174,65,19.99,109
779290,Stygian: Reign of the Old Ones,1397,676,19.99,721
1079620,Infinity: Battlescape,411,92,34.99,319
809730,FISHERY,238,23,9.99,215
678960,CODE VEIN,36503,5570,15.99,30933
1051410,Wanderlust: Travel Stories,78,7,2.99,71
751450,Nanairo Reincarnation,129,4,29.99,125
954080,Memorrha,77,44,14.99,33
1044620,Aokana - Four Rhythms Across the Blue,3125,54,34.99,3071
837430,Flying Aces - Navy Pilot Simulator,19,24,19.99,-5
939510,Pandemic Express - Zombie Escape,2561,1781,0.0,780
1105410,Shine's Adventures 2 (Zombie Attack),106,8,2.99,98
1157340,Hentai Killer,1105,313,0.99,792
1137700,AAW Wrestle Lab,26,9,0.0,17
839850,Lenin - The Lion,90,3,11.99,87
945160,Angelo and Deemon: One Hell of a Quest,91,32,8.99,59
1101180,EverStopped,374,12,2.99,362
1128900,live Desktop Beauty,132,72,8.99,60
1122040,Kaede the Eliminator / Eliminator 小枫,276,33,24.99,243
1131900,3rd eye,238,30,14.99,208
1149660,Seek Girl Ⅱ,1911,426,0.99,1485
1124830,Touhou Blooming Chaos,311,33,5.99,278
1154470,三国时代2,26,2,3.99,24
1126290,Lost,5877,1352,1.99,4525
1128000,Cube World,6678,11133,19.99,-4455
1021070,Spaceland: Sci-Fi Indie Tactics,270,83,14.99,187
1038280,Nobodies: Murder Cleaner,213,20,6.99,193
1131750,Alien Squatter,56,4,0.0,52
1077290,SuperSmash: Physics Battle,643,45,4.99,598
1085660,Destiny 2,403109,77006,0.0,326103
1112570,Crime Cities,17,12,3.99,5
777430,Virtual Boxing League,24,14,19.99,10
912450,YU-NO: A girl who chants love at the bound of this world,157,35,49.99,122
1098370,Akash: Path of the Five,95,7,14.99,88
1005060,Fabulous - New York to LA,27,5,12.99,22
1063530,Cartoon Network Journeys VR,101,8,0.0,93
1147690,NGU IDLE,8577,332,0.0,8245
1026420,WARSAW,589,212,23.99,377
811880,Close Combat: The Bloody First,200,188,39.99,12
915490,Frontline Zed,155,109,11.99,46
1129030,Endless Fables 4: Shadow Within,82,13,14.99,69
1162560,"Ciconia When They Cry - Phase 1: For You, the Replaceable Ones",308,22,39.99,286
1154210,Convenience Store,16,7,14.99,9
526160,The Wild Eight,4664,1942,24.99,2722
1123300,Castle Woodwarf,123,22,0.0,101
1042020,Trapped on Monster Island,75,45,9.99,30
794540,Neo Cab,1460,277,14.99,1183
1125480,School Years,1160,229,11.99,931
725330,Zelle,275,16,8.99,259
773951,Freeman: Guerrilla Warfare,8299,2648,24.99,5651
1113060,Magic Farm 3: The Ice Danger,8,6,19.99,2
695050,Rain of Reflections: Set Free,238,62,9.99,176
1123400,The Land of Exile,78,13,8.99,65
1049280,Pilgrims,2199,89,4.99,2110
655500,MX Bikes,6948,453,34.99,6495
846870,Yooka-Laylee and the Impossible Lair,755,128,7.49,627
986680,PAGUI打鬼,499,99,19.99,400
849740,Love Esquire - RPG/Dating Sim/Visual Novel,865,82,24.99,783
421170,Indivisible,2074,781,39.99,1293
1022450,War Selection,13324,1971,0.0,11353
421790,The Bradwell Conspiracy,46,24,19.99,22
690640,Trine 4: The Nightmare Prince,8851,909,7.49,7942
699540,Argonus and the Gods of Stone,96,10,19.99,86
895670,Armajet,531,82,0.0,449
1062040,Dragon Star Varnir,356,74,39.99,282
1108350,Boet Fighter,99,13,14.99,86
1158260,Heroes of Hellas Origins: Part One,38,1,6.99,37
1117980,Asdivine Kamura,5,0,14.99,5
887090,Blocks!: Richard III,59,17,24.99,42
1161360,Shisensho Solitaire,57,0,0.99,57
600130,Valfaris,1397,231,24.99,1166
669950,BDSM: Big Drunk Satanic Massacre,899,114,19.99,785
1100430,Spirit Hunter: NG,161,9,49.99,152
428660,Deliver Us The Moon,4483,563,24.99,3920
1151080,Legend of Keepers: Prologue,2186,167,0.0,2019
1042780,Pine,1194,394,24.99,800
770490,Death in the Water,65,30,2.99,35
1092700,Hello Neighbor Pre-Alpha,758,75,0.0,683
1156250,The Exorcist: Legion VR (Deluxe Edition),98,27,24.99,71
703860,GRID,3679,1806,19.99,1873
1098720,Court of Ashes,25,3,0.0,22
1122490,Battleheart Legacy,25,2,4.99,23
871530,Radio Commander,1070,348,19.99,722
824830,Corpse Party: Blood Drive,197,31,19.99,166
758250,Taste of Power,44,21,14.99,23
1141100,Lilitales,421,44,19.99,377
965230,DORAEMON  STORY OF SEASONS,1564,331,14.99,1233
865360,We Were Here Together,8253,1392,12.99,6861
572220,MageQuit,637,26,14.99,611
1106940,How to Raise a Wolf Girl,292,19,19.99,273
864540,Fallback,278,41,9.99,237
1087270,Franchise Hockey Manager 6,256,72,19.99,184
848330,Pride Run,27,8,14.99,19
1078510,Alluris,153,14,9.99,139
965200,Walking Zombie 2,8255,1133,0.0,7122
663670,Killer Queen Black,480,37,9.99,443
1092710,Hello Neighbor Alpha 1,1385,121,0.0,1264
844850,Tower Hunter: Erza's Trial,1140,349,4.31,791
1081650,Celaria,90,12,11.99,78
1134480,YORG.io 3,123,57,6.99,66
1122050,Gensokyo Night Festival,3526,556,12.99,2970
1162350,Drill Down,38,9,4.99,29
328080,Rise to Ruins,6124,762,14.99,5362
623340,Stars End,601,310,14.99,291
1092720,Hello Neighbor Alpha 2,1707,94,0.0,1613
1112380,Wer weiß denn sowas? - Das 2. Spiel,15,8,29.99,7
1039890,EARTH DEFENSE FORCE: IRON RAIN,604,417,59.99,187
995430,Zombieland: Double Tap - Road Trip,14,13,39.99,1
632470,Disco Elysium - The Final Cut,55250,3244,39.99,52006
1158450,GALAXIUM,57,137,5.99,-80
1083310,OUTBUDDIES DX,154,56,3.59,98
1093880,XWallpaper,72,71,2.79,1
1051420,Jey's Empire,35,1,9.09,34
1156590,Morels: The Hunt,129,19,19.99,110
1034860,GRANDIA HD Remaster,888,82,19.99,806
1005300,The Jackbox Party Pack 6,2228,110,29.99,2118
1175150,Incredible Dracula: Vargosi Returns,7,0,6.99,7
618740,Beat Hazard 2,1715,244,18.99,1471
967240,MONKEY KING: HERO IS BACK,206,238,34.99,-32
1078960,The Saga of Nino's Transmigration (尼諾的異世界物語 ~ 光與影與各自的信仰 ~),168,12,0.0,156
1172170,Krystopia: A Puzzle Journey,49,4,4.99,45
1083810,War Solution - Casual Math Game,32,4,2.99,28
724300,Roof Rage,495,55,14.99,440
1157750,CATGIRL LOVER 2,266,95,1.99,171
1164390,Haunted Gas Station,830,260,0.0,570
1087720,Your Island -KIMI NO SIMA-,77,18,11.99,59
943260,Stranded Sails - Explorers of the Cursed Islands,484,168,24.99,316
983350,Sea Salt,437,103,14.99,334
1072480,The Fisherman - Fishing Planet,619,362,29.99,257
826180,EONIA,32,7,4.99,25
792300,The Beast Inside,5196,1012,24.99,4184
1055990,Erannorth Reborn,297,47,19.99,250
1042550,Digimon Story Cyber Sleuth: Complete Edition,6252,565,14.99,5687
1092730,Hello Neighbor Alpha 3,595,129,0.0,466
574720,Little Big Workshop,2296,389,19.99,1907
919410,Felix The Reaper,263,92,1.19,171
1147660,ArcheAge: Unchained,2022,1529,0.0,493
961490,Travis Strikes Again: No More Heroes Complete Edition,298,43,39.99,255
1083190,Disc Creatures,132,19,14.99,113
881420,Six Ages: Ride Like the Wind,290,64,19.99,226
979120,Autonauts,3487,416,9.99,3071
1140440,OMON Simulator,1795,643,0.44,1152
935400,Alchemy Garden,339,94,8.99,245
1129250,NEKO-NIN exHeart 3,182,10,9.99,172
977390,Tokyo Warfare Turbo,319,62,14.99,257
898580,Premium Bowling,288,15,12.99,273
722660,Startup Freak,37,16,11.99,21
751060,Ice Age Scrat's Nutty Adventure,76,26,29.99,50
805520,The Dwarves of Glistenveld,7,0,13.99,7
1077600,Song Beater: Quite My Tempo!,65,6,19.99,59
1096710,Hello Neighbor Alpha 4,2045,284,0.0,1761
1032830,Eldervale,97,9,14.99,88
1015500,WWE 2K20,2520,3386,0.0,-866
588210,HELLION,2251,1857,0.0,394
573410,AI War 2,1146,145,19.99,1001
991260,Borderlands 2 VR,630,492,49.99,138
783840,Lakeview Valley,494,84,14.99,410
1138410,Demons Never Lie,388,30,9.99,358
1058830,Spin Rhythm XD,2385,77,19.99,2308
1012840,Moons of Madness,1646,443,12.49,1203
551860,Abandon Ship,775,266,12.49,509
359510,Tangle Tower,2061,100,19.99,1961
1032790,Journey of Greed,1125,114,6.99,1011
940310,Corpse Party 2: Dead Patient,221,65,9.99,156
1126990,PBA Pro Bowling,117,36,14.99,81
867290,Crossroads Inn Anniversary Edition,2013,1524,24.99,489
711540,Lonely Mountains: Downhill,1502,122,9.99,1380
1112930,Dredgers,374,34,11.99,340
960900,Lornsword Winter Chronicle,23,8,19.99,15
911220,Dusk Diver 酉閃町,555,86,34.99,469
1164850,Sinking Simulator,2596,460,0.0,2136
1104660,MO:Astray,3841,319,14.99,3522
1053830,Ninja Legends,47,3,19.99,44
1162520,Richman10,6309,5771,13.99,538
494150,The Thrill of the Fight - VR Boxing,2936,144,9.99,2792
1147510,Hentai Asmodeus,988,224,1.99,764
1025550,Great Battles of the American Civil War,4,1,9.99,3
1026070,12 Labours of Hercules IX: A Hero's Moonwalk,26,1,11.99,25
826540,Audio Trip,195,20,19.99,175
859570,Secret Neighbor: Hello Neighbor Multiplayer,12333,1748,19.99,10585
1006220,Type Knight,99,8,3.99,91
1107620,Mystery Island - Hidden Object Games,116,56,3.99,60
1157640,Sakura Fox Adventure,139,16,9.99,123
991810,Strategic Mind: The Pacific,433,125,29.99,308
1136160,Internet Cafe Simulator,5616,2049,9.99,3567
1162680,[Chilla's Art] Stigmatized Property | 事故物件,631,142,2.99,489
1146510,Deep Sleep Trilogy,228,2,4.99,226
1116210,Our world has not decayed,279,43,1.99,236
1173830,Coloring Game: Pixel,140,5,1.99,135
1138580,Farmington County: The Ultimate Farming Tycoon Simulator,83,17,14.99,66
1172530,Daylife in Japan - Pixel Art Jigsaw Puzzle,67,8,1.99,59
1138260,Figure Simulator War,77,13,9.99,64
1094780,Fisher Online,2230,301,14.99,1929
1148540,Griddlers Victorian Picnic,3,4,4.99,-1
1121560,Atelier Ryza: Ever Darkness & the Secret Hideout,5244,786,59.99,4458
464260,Xeno Crisis,96,11,19.99,85
845690,"Rats, Bats, and Bones",55,5,9.99,50
1126190,Disney Classic Games: Aladdin and The Lion King,132,38,19.99,94
1059430,PAGAN PEAK VR,130,27,3.99,103
1157250,Anomaly Zone,299,302,0.0,-3
966670,The Wanderer: Frankenstein’s Creature,123,21,15.99,102
1170880,Grimm's Hollow,9905,147,0.0,9758
883080,Ludo Online: Classic Multiplayer Dice Board Game,231,50,0.99,181
885000,Synth Riders,1066,79,24.99,987
747690,Sinister Halloween,79,15,4.99,64
1096570,SONG OF HORROR COMPLETE EDITION,992,215,29.99,777
1036260,Journey For Elysium,69,9,9.99,60
1089840,Armored Brigade,228,23,39.99,205
1056180,Cathedral,229,61,14.99,168
1176110,AudioTheory Guitars,41,5,6.99,36
1172760,Twilight's Last Gleaming,2,2,9.99,0
1142130,They Can't Stop All Of Us,1257,404,0.0,853
1173350,HENTAI CLIMBER,102,50,0.99,52
1089820,Reanimation Inc.,71,16,9.99,55
1101140,Fishing Adventure,983,159,4.99,824
1150890,The Bunker 69,119,20,3.99,99
1168660,Barro 2020,852,171,0.49,681
1142220,Beat Aim - Rhythm FPS Shooter,128,15,14.99,113
1114030,The Room Syndrome,274,10,0.0,264
1100930,LEGIONCRAFT,963,231,12.99,732
487120,Citadel: Forged with Fire,3862,1773,39.99,2089
1172140,Monster Battles - Portals,31,13,0.0,18
837400,Fated Kingdom,232,69,2.99,163
1170640,When The Past Was Around - Prologue,571,31,0.0,540
973300,Super Lolicon Puzzle Simulator 2019,34,6,0.99,28
1007800,Single Diary: Fresh Graduate,120,45,6.99,75
977230,Mars Power Industries Deluxe,437,23,3.99,414
1020340,AUDICA: Rhythm Shooter,467,81,29.99,386
906510,Conception PLUS: Maidens of the Twelve Stars,87,27,59.99,60
1151680,Galactic Rangers VR,49,9,12.99,40
703080,Planet Zoo,52931,5735,44.99,47196
1141220,DemonCrawl,803,174,14.99,629
1129220,"BEARS, VODKA, BALALAIKA! 🐻",1630,162,0.99,1468
1151670,EEP  16 Expert Eisenbahn Aufbau- und Steuerungssimulation,17,7,34.99,10
1085510,Garfield Kart - Furious Racing,8645,1146,1.49,7499
857540,Soviet Bear Uni Adventure,37,7,9.99,30
909100,Epic Fun,50,25,0.0,25
1170970,Marbles on Stream,1145,195,0.0,950
1015730,Apostle,268,41,19.99,227
1126470,Jewel Match Atlantis Solitaire - Collector's Edition,51,10,3.24,41
797410,Headsnatchers,798,733,14.99,65
909670,Skybolt Zack,86,5,15.99,81
1158470,Voxelgram,317,7,5.99,310
1148450,Detective Jackie - Mystic Case,101,4,12.99,97
1079800,Pistol Whip,2962,201,29.99,2761
1116230,The Story of Henry Bishop,373,71,4.99,302
896950,JUMANJI: The Video Game,30,25,29.99,5
1094030,Lurk in the Dark : Prologue,1497,176,0.0,1321
1108560,罪業狂襲FrenzyRetribution,1066,329,0.0,737
1184700,Whispered Secrets: Dreadful Beauty Collector's Edition,4,0,9.99,4
418620,The TakeOver,660,110,19.99,550
340150,Basement,1467,605,19.99,862
933860,Discolored,288,61,3.99,227
952540,Romancing SaGa 3™,280,68,28.99,212
1109460,There is No GreenDam,1467,52,0.0,1415
1160490,Master Of Pottery,2144,42,3.59,2102
926390,Infected Shelter,263,36,9.99,227
1141290,Tactical Nexus,60,5,17.99,55
1148650,The Legend of Bum-Bo,4396,993,14.99,3403
1029730,VR Ping Pong Pro,30,26,24.99,4
1075400,Doctor Who: The Edge Of Time,141,62,24.99,79
979400,Last Labyrinth（ラストラビリンス）,66,17,29.99,49
809230,Unity of Command II,1097,239,29.99,858
839080,DRAW CHILLY,128,23,4.99,105
1177130,NABOKI,246,18,1.99,228
1184570,Last Neighbor,73,26,2.99,47
1003730,Soko Loco Deluxe,42,2,9.99,40
1151390,Putin Life,231,27,0.49,204
1187830,Incredible Dracula: Witches' Curse,20,0,6.99,20
813780,Age of Empires II: Definitive Edition,99112,5684,19.99,93428
1156730,Holy Knight Luviria,181,44,19.99,137
1158840,记忆重现/Rememory,58,25,0.0,33
1166840,Breach: The Archangel Job,62,4,6.99,58
1003890,Blacksad: Under the Skin,3096,569,39.99,2527
1159500,Ghost Files 2: Memory of a Crime,100,25,14.99,75
954740,Terminator: Resistance,8814,673,39.99,8141
1076160,Command: Modern Operations,728,134,79.99,594
970940,The Unicorn Princess,19,14,5.99,5
1172380,STAR WARS Jedi: Fallen Order™,87943,9721,14.99,78222
285380,On The Road - Truck Simulator,478,495,29.99,-17
756530,TOKYO GHOUL:re [CALL to EXIST],723,320,59.99,403
657240,Tracks - The Train Set Game,987,65,19.99,922
1166090,EnviroGolf,15,8,0.0,7
1099500,The Curious Tale of the Stolen Pets,192,18,9.99,174
943140,Sparklite,274,77,24.99,197
1105420,Game of Thrones Winter is Coming,1074,699,0.0,375
1137400,The War for the West,42,8,6.99,34
405530,Veer,37,2,4.99,35
504690,Woven,127,28,19.99,99
1158500,Between Two Castles - Digital Edition,160,213,12.99,-53
1094530,ALIA’s CARNIVAL！,431,16,29.99,415
913550,I wanna be the Creator,1885,65,5.99,1820
1024010,Ultimate Fishing Simulator VR,396,76,29.99,320
1121530,Globesweeper: Hex Puzzler,82,9,2.71,73
959520,Fantasy Blacksmith,736,738,2.49,-2
1182370,Mr. Hopp's Playhouse,1014,70,0.0,944
1172060,Rest In Pieces,30,17,13.99,13
1040550,Spring Falls,498,16,6.99,482
427950,The Withering,183,173,9.99,10
1185870,Skyland 1976,30,11,3.99,19
1058200,Pixel Puzzles Traditional Jigsaws,234,79,0.0,155
1157090,Eidolon,13,0,0.0,13
797400,Railroad Corporation,722,244,34.99,478
1160360,Miscreation: Evolve Your Creature!,112,77,9.99,35
1186740,Kyle is Famous: Complete Edition,1126,93,14.99,1033
1132210,Kingdom Under Fire 2,1412,933,0.0,479
1144170,Warhammer: Chaos And Conquest,509,422,0.0,87
523750,The 4th Coming,26,18,0.0,8
1168290,TD Heroes,21,9,6.99,12
1150850,战场英雄物语,29,23,0.0,6
616920,BatMUD,116,22,4.99,94
914110,Narcos: Rise of the Cartels,270,266,5.99,4
1100620,Football Manager 2020 Touch,866,125,0.0,741
1070580,Drift86,3327,300,1.99,3027
1100600,Football Manager 2020,28120,3435,0.0,24685
1168880,MOLEK-SYNTEZ,482,55,9.99,427
1185160,[Chilla's Art] Inunaki Tunnel | 犬鳴トンネル,264,70,2.99,194
1144110,Open World Game: the Open World Game,2097,159,0.0,1938
1118880,Rituals in the Dark,67,7,6.99,60
1063490,Still There,868,109,14.99,759
1155120,The Magician's Research,137,89,0.0,48
1185520,Love Rhythm,172,55,1.99,117
702890,BlazBlue: Cross Tag Battle,3023,763,19.99,2260
1112790,Automation Empire,1573,764,29.99,809
1133930,Forgotten Hill Disillusion,113,10,4.99,103
1172510,Unlock The King,235,10,0.99,225
1147500,A Gay's Life,288,15,2.99,273
1188280,Coffee Rush,2,0,4.99,2
1178120,XP Girls,138,37,0.0,101
751820,Black Future '88,439,142,19.99,297
1082710,Bug Fables: The Everlasting Sapling,3453,68,19.99,3385
1183740,散歩するキーボード使い,32,5,0.0,27
754500,Plutocracy,635,187,24.99,448
1165380,To Be Headed Or Not To Be,88,52,0.0,36
1025140,LAMUNATION! -international-,507,29,12.99,478
1109690,Asterix & Obelix XXL 3  - The Crystal Menhir,158,97,29.99,61
678900,Farmer's Dynasty,2351,762,8.99,1589
716640,Sigma Theory: Global Cold War,926,284,17.99,642
1184770,The Political Process,1269,61,14.99,1208
1000410,WRATH: Aeon of Ruin,1184,284,24.99,900
563840,LOST EMBER,3536,434,29.99,3102
1196390,Fairy Godmother Stories: Cinderella Collector's Edition,7,1,9.99,6
1184420,天降锦鲤 ~ My Lucky Koi,277,18,4.99,259
973580,Sniper Ghost Warrior Contracts,6850,2451,11.99,4399
1163910,Brass Brigade,384,36,9.99,348
1190640,Memory Match Saga,1,1,1.99,0
1110690,Banter Schooldays!!三〇一室无一人,635,68,3.99,567
802200,Hellbound: Survival Mode,1699,246,0.0,1453
1188250,GLOWCOMA: chapter 1,162,28,0.99,134
1182760,Starlight,144,94,0.99,50
1168360,Detective Solitaire Inspector Magic,4,0,4.99,4
1060810,The Sphere of Abyss,28,6,14.99,22
1188330,Classic Sudoku,315,26,4.99,289
1189490,觅长生,8895,864,11.99,8031
1191680,境界 Dice&Fighter,67,27,3.99,40
1167900,Friday 星期五部门,26,0,0.0,26
1177660,Escape the Ayuwoki,490,131,9.99,359
1186270,Nosferatu Lilinor,25,4,11.9,21
728530,SD GUNDAM G GENERATION CROSS RAYS,5544,890,59.99,4654
865160,Takenoko,40,29,9.99,11
1056570,TAISHO x ALICE episode 1,588,66,9.99,522
1193550,Ruthless Conquest,56,13,0.0,43
350300,Gang of Four,100,97,0.0,3
1156670,Balls!🤬🍆,20,2,1.99,18
1171820,Creme de la Creme,73,5,6.99,68
1187510,Rock Simulator,725,41,1.99,684
848060,Story of a Gladiator,133,29,4.39,104
1180380,Stay Out,7782,6369,0.0,1413
1196400,Mystery Case Files: Black Crown Collector's Edition,28,5,9.99,23
989770,Biker Garage: Mechanic Simulator,289,113,24.99,176
1175390,Ultimate Live Wallpaper,66,100,3.99,-34
1130990,Roman Adventures: Britons. Season 2,21,0,5.99,21
1138970,Dandy Dungeon - Legend of Brave Yamada -,51,5,18.99,46
1109840,Réussir : Code de la Route - Nouvelle Édition (French Highway Code),222,26,1.99,196
1174720,SwarmZ,172,91,4.99,81
987330,Street Outlaws: The List,27,29,19.99,-2
1097420,No-brainer Heroes 挂机吧！勇者,1198,316,9.99,882
990900,Neon Noodles - Cyberpunk Kitchen Automation,33,1,14.99,32
1168430,Dairy Princess,69,6,6.99,63
1034910,Blaster Master Zero 2,312,34,9.99,278
1159540,Fear the Dark Unknown,79,28,29.99,51
1186580,New York Mysteries: The Outbreak,44,6,6.99,38
399720,XO,75,10,19.99,65
351290,SURVIVAL: Postapocalypse Now,5069,3918,14.99,1151
1171310,Valakas Story,1056,230,3.99,826
1038450,Nancy Drew®: Midnight in Salem,509,406,21.99,103
254940,Free Running,52,8,5.99,44
976730,Halo: The Master Chief Collection,177554,13841,39.99,163713
1025600,Battle Realms: Zen Edition,1852,246,9.99,1606
1103800,World War Zero,64,11,4.99,53
1004490,Tools Up!,610,199,19.99,411
915670,Everreach: Project Eden,174,204,2.49,-30
1161270,Freud Gate,300,81,0.0,219
1088090,Day of Dragons,2628,1182,19.99,1446
792220,Paunch,8949,1017,0.0,7932
959000,Edna & Harvey: The Breakout - Anniversary Edition,348,26,3.99,322
1189230,Door in the Woods,167,46,9.99,121
1197700,Hermes: War of the Gods,19,0,6.99,19
1113880,Best in the West,56,44,0.0,12
982040,"Don't Die, Minerva!",54,9,12.99,45
760810,Retimed,249,46,14.99,203
936490,Counter Terrorist Agency,212,216,19.99,-4
1176020,Rampage Miami,142,21,0.99,121
1065950,Cage of the Succubi,81,44,12.99,37
1096930,Strategic Command: World War I,259,18,39.99,241
298610,Ylands,3987,2656,0.0,1331
710920,Darksiders Genesis,8056,1593,29.99,6463
1186160,All Day Dying: Redux Edition,41,8,9.99,33
1191210,Seek Girl Ⅲ,2229,412,0.99,1817
840260,Endless World Idle RPG,3206,860,0.0,2346
1171140,Countersnipe,229,104,0.0,125
1016770,Interrogation: You will be deceived,201,34,12.99,167
1174180,Red Dead Redemption 2,251841,32592,29.99,219249
349270,Mosaic,242,98,19.99,144
872680,Z Dawn,162,54,9.99,108
578990,Two Worlds II HD - Shattered Embrace,5,12,19.99,-7
1197370,Suite 776,465,48,3.99,417
1161190,Natsu no Iro no Nostalgia,336,29,29.99,307
522940,GUN GODZ,487,71,0.0,416
1158690,Uncharted Ocean,369,131,4.99,238
802050,Rag Doll Joe,137,30,0.0,107
1197990,"Shoot, push, portals",39,3,0.99,36
649950,Ashen,1784,769,39.99,1015
1047220,Frog Detective 2: The Case of the Invisible Wizard,1073,54,4.99,1019
1195460,Last Year,4516,3070,0.0,1446
1061730,Super Monkey Ball: Banana Blitz HD,180,132,29.99,48
1116770,Shovel Knight Showdown,65,5,9.99,60
960420,Hello Neighbor: Hide and Seek,333,62,29.99,271
1183030,Layers of Fear VR,137,48,11.99,89
589500,Shovel Knight: Shovel of Hope,487,29,14.99,458
1116780,Shovel Knight: King of Cards,129,13,9.99,116
986800,AVICII Invector,2406,71,19.99,2335
970560,STEINS;GATE: My Darling's Embrace,738,17,29.99,721
1072420,DRAGON QUEST BUILDERS™ 2,4879,447,49.99,4432
897120,Moko's Advice,120,7,0.0,113
1163600,Omega Labyrinth Life,164,67,59.99,97
891040,Pool 2D - Poolians,4820,705,0.0,4115
1170980,A Planet of Mine,29,9,8.99,20
823500,BONEWORKS,27514,2418,29.99,25096
393420,Hurtworld,23486,7324,24.99,16162
1201400,Not For Broadcast: Prologue,686,50,0.0,636
1066780,Transport Fever 2,15326,2017,39.99,13309
1096410,Vampire: The Masquerade - Coteries of New York,1538,569,19.99,969
1198110,Fantasy Realm TD,2,3,9.99,-1
1065260,GENSOU Skydrift,469,53,7.19,416
1197710,Golden Rails: Tales of the Wild West,22,0,6.99,22
601220,Zup! F,7346,196,0.99,7150
608120,AFTERBURN,232,34,9.99,198
863590,Starcom: Nexus,1362,124,11.99,1238
1174500,Yuletide Legends: Who Framed Santa Claus,92,15,14.99,77
1168280,Resident Evil 2 R.P.D. Demo,1494,337,0.0,1157
1089790,Winter Resort Simulator,673,166,19.99,507
538100,Feel The Snow,2399,289,8.99,2110
1122720,Sayonara Wild Hearts,6285,180,12.99,6105
1180250,DIVINATION,85,11,1.99,74
1161650,Sakura Gamer 2,113,22,9.99,91
869690,Cat Lady - The Card Game,167,9,3.99,158
377950,Jamestown+,153,17,17.99,136
1163560,SuperEpic: The Entertainment War,49,23,17.99,26
1088950,Touring Karts,96,26,19.99,70
1150550,Winter Polaris,58,3,14.99,55
1092430,Budget Cuts 2: Mission Insolvency,310,70,29.99,240
920320,Virgo Versus The Zodiac,682,51,19.99,631
997380,The Sapling,195,23,7.99,172
1098080,3000th Duel,359,121,14.99,238
1169040,Necesse,2776,140,9.99,2636
677380,Disco Destruction,46,4,0.0,42
1194680,ZooKeeper Simulator,262,40,4.49,222
1191820,Spot The Differences 2020 | 大家来找茬 2020,7,11,0.99,-4
827610,Dead End Job,61,14,2.54,47
1097170,Backspace Bouken,56,4,14.99,52
1083820,Eternal Dread 2,65,16,9.99,49
1105810,Onset,580,168,18.99,412
1186400,West Sweety,2544,428,1.99,2116
1056350,Wizard Warfare,45,1,6.99,44
422510,DEMON'S TILT,609,35,19.99,574
1098100,OhShape,207,54,19.99,153
1148510,Pretty Angel,3014,267,0.99,2747
1056750,Shera and the Three Treasures,205,43,14.99,162
981590,VZX Player,155,21,0.0,134
1188080,Cats are Liquid - A Better Place,149,10,1.99,139
840430,Planetary Dustoff,39,6,14.99,33
924140,Hand Simulator: Survival,8196,1250,0.99,6946
1173740,Woodle Tree 2: Deluxe+,60,3,12.99,57
1196450,Stop Sign VR Tools,43,4,5.99,39
1205690,Defending Frontiers,0,2,3.99,-2
1160330,Fight of Animals,411,23,9.99,388
1148810,Tip of the Spear: Task Force Elite,212,43,9.99,169
819630,Basketball Classics,128,7,9.99,121
1086630,Spelling Quest Online,8,1,0.0,7
1204360,Blink Cam,15,2,13.99,13
1054370,Sandbox Anything,20,10,0.0,10
1188930,Chrono Ark,3564,406,19.99,3158
538990,SugarMill,38,37,19.99,1
1200860,The Good Time Garden,1833,78,0.0,1755
967460,Red Eclipse,477,91,0.0,386
668360,Bokuten - Why I Became an Angel,65,10,17.99,55
741140,Baldr Sky,869,34,49.99,835
1112400,Project Torque - Free 2 Play MMO Racing Game,1134,423,0.0,711
1206110,Frontline: The Great Patriotic War,23,2,5.99,21
1041840,Fight Angel Special Edition,954,301,19.99,653
1191330,Inferna,1208,722,0.0,486
1204270,New Year's Eve 2020,59,18,0.99,41
488440,Angeldust,881,509,2.99,372
1188260,Creature Card Idle,57,25,1.99,32
980940,My Little Blacksmith Shop,568,151,9.99,417
1155980,Princess Maker ~Faery Tales Come True~ (HD Remake),79,61,29.99,18
724260,Princess Maker Go!Go! Princess,65,43,9.99,22
896890,VR Paradise - Steam Edition,138,50,19.99,88
1198320,DOTOKOI / 像素男友,885,10,0.0,875
557580,Ancient Guardian,105,39,7.99,66
1208030,Let's Learn Japanese! Vocabulary,25,6,4.99,19
1206050,Sea King,20,3,4.99,17
1195230,Darkness and Flame: Enemy in Reflection,51,2,6.99,49
1208520,The Alchemist's House,174,77,0.0,97
1201870,Drinks With Abbey,303,82,0.0,221
1166240,Asian Riddles,17,4,4.99,13
694770,Vestaria Saga I: War of the Scions,671,95,19.99,576
1192940,Monkey GO Happy,92,3,0.0,89
1193990,Trapped,67,9,3.99,58
906250,Encore Casino Games Collection,0,4,19.99,-4
1203890,Mirage Online Classic,36,12,0.0,24
1205040,Granny: Chapter Two,586,33,4.99,553
1211790,Bad Girl,1,4,2.99,-3
801120,Kirchhoff's Revenge,85,25,0.0,60
968350,Hotel Sowls,451,14,4.99,437
1187030,星礼研究所 | Sighchology Research Lab,97,22,2.99,75
1139890,Dictators:No Peace Countryballs,4198,238,0.99,3960
293480,FRONTIERS,90,232,14.99,-142
1058710,Medieval Monarch,232,44,8.49,188
1168060,Knight Solitaire,10,2,0.49,8
1139800,Chinatris,815,106,1.99,709
1168470,千面 Melancholy Love,1376,24,4.99,1352
1049100,泡沫冬景,4059,190,14.99,3869
1191070,[Chilla's Art] Yuki Onna | 雪女,101,27,4.99,74
1201630,Mineirinho Director's Cut,869,442,0.99,427
1208770,Saber Fight VR,113,49,14.99,64
1178430,Summer Games Heroes,28,15,0.0,13
1192730,ADULT SHERIFF,43,14,0.99,29
1215090,My Friend is a Raven,947,79,0.0,868
486860,MMORPG Tycoon 2,1862,239,24.99,1623
1178490,港詭實錄ParanormalHK,10985,1177,12.99,9808
1180370,Wienne,43,4,0.0,39
1190130,Araha : Curse of Yieun Island,164,93,15.99,71
1206740,Omnify Hotspot - The Best Wi-Fi Hotspot & Repeater,25,13,0.0,12
1189050,Hot And Lovely,39,24,1.99,15
1131720,PROP AND SEEK®,2739,589,0.0,2150
1119520,HITOTSU NO MORI,103,8,0.0,95
1072500,AO Tennis 2,736,337,49.99,399
1145960,The White Door,4077,265,3.99,3812
1212830,Seek Girl Ⅳ,1381,450,0.99,931
1160750,Grim Clicker,1673,373,0.0,1300
814360,Mythic Ocean,78,1,14.99,77
1090670,Orbi Universo,111,30,19.99,81
1216220,Boiling Steel: Preface,87,26,0.0,61
1201260,Happy Engine,18,15,0.74,3
1208260,Hentai Vs Furries,1993,279,0.99,1714
1169020,Dark Fall: Ghost Vigil,143,12,10.99,131
1106530,GemCraft - Frostborn Wrath,1900,250,12.99,1650
1216200,Coloring Game 2,2992,92,0.0,2900
1046470,Deep the Game,685,221,0.0,464
1213570,Cave Quest,71,4,3.74,67
1026880,FIREGROUND Modern War,35,17,9.99,18
1217640,God's Challenge,3,2,1.99,1
544920,Darwin Project,15023,3441,0.0,11582
1159640,ANIME - World War II,643,124,1.99,519
1217100,Mega Hasan,304,19,0.0,285
1216080,坦率的小红帽和爱说谎的狼,858,18,0.0,840
1042670,Orangeblood,241,91,19.99,150
1120690,Knock Harder: Useless,358,19,0.0,339
796290,World of Tennis: Roaring ’20s,176,60,0.0,116
1153430,Love wish,1163,286,0.99,877
1211360,NEOMORPH,492,140,0.99,352
1208600,Bunny Park,451,40,4.99,411
1142810,Toasterball,108,4,5.99,104
1152320,Atelier Shallie: Alchemists of the Dusk Sea DX,124,14,39.99,110
910880,Mad Tower Tycoon,297,80,14.99,217
1169100,Gazillionaire,144,11,19.99,133
1217390,Some Some Convenience Store,2636,99,14.99,2537
1180030,Wardwell House,581,122,1.99,459
1152310,Atelier Escha & Logy: Alchemists of the Dusk Sky DX,163,20,39.99,143
606920,EXA: The Infinite Instrument,87,3,14.99,84
1152300,Atelier Ayesha: The Alchemist of Dusk DX,269,14,39.99,255
618620,Naval Armada: Fleet Battle,69,55,0.0,14
1212940,Ayahuasca,247,56,12.99,191
994140,Lightmatter,2014,182,0.0,1832
914700,MINImax Tinyverse,369,144,0.0,225
948640,Wizardry: Labyrinth of Lost Souls,221,86,14.99,135
872410,ROMANCE OF THE THREE KINGDOMS XIV,7075,4983,59.99,2092
1074170,SELF,190,45,4.99,145
1163590,Bullet Girls Phantasia,499,97,29.99,402
851850,DRAGON BALL Z: KAKAROT,30838,2277,59.99,28561
364210,Sierra Ops - Space Strategy Visual Novel,180,32,14.99,148
1065940,Country Girl Keiko,157,49,15.99,108
1204630,Firefight!,8,0,1.99,8
1162630,Solitaire Call of Honor,6,1,7.99,5
1027250,The Alliance Alive HD Remastered,136,28,39.99,108
907670,Super Crush KO,158,7,14.99,151
676500,Time Warpers,428,74,19.99,354
1190110,H-SNIPER: Middle East,414,46,0.99,368
1214450,Featherfall,114,18,2.99,96
1212100,fishy,134,24,2.99,110
1207310,Gizmos: Steampunk Nonograms,31,3,4.99,28
1218920,Sunset Kingdom,63,18,2.99,45
1206720,kraken's curse,22,5,2.99,17
1218790,Good Goods Incorporated,7,18,2.99,-11
1212190,deer hunter II,34,7,2.99,27
1218890,Ollie & Bollie: Outdoor Estate,98,31,2.99,67
1211540,bobo robot,36,3,2.99,33
1178030,Star Fetchers,5893,163,0.0,5730
1114870,Lenna's Inception,164,20,9.99,144
801750,Hot Shot Burn,158,13,14.99,145
745920,Temtem,28128,4297,41.99,23831
1188970,Ether Loop,217,84,11.99,133
1220680,Spooky Spins Remastered - Casino Slot Simulations,1,1,6.99,0
1086970,Battle Bruise 2,19,4,4.99,15
1185600,神国：创造（The Kingdom of God）,131,56,9.99,75
1201280,A Space For The Unbound - Prologue,1133,16,0.0,1117
1119710,looK INside - Chapter 1,270,15,7.99,255
1007400,Alien Shooter 2 - The Legend,440,422,14.99,18
801220,Magnificent 5,47,74,0.0,-27
916840,The Walking Dead: Saints & Sinners,6551,836,39.99,5715
1200290,FlyManMissile,11,2,2.99,9
1149550,Utawarerumono: Mask of Deception,818,57,39.99,761
1151440,Utawarerumono: Mask of Truth,822,28,39.99,794
971650,Failspace,27,17,9.99,10
1221440,Path of Redemption,51,10,6.99,41
846730,RUGBY 20,123,57,19.99,66
1100420,Praetorians - HD Remaster,618,63,19.99,555
1100410,Commandos 2 - HD Remaster,974,816,19.99,158
1148730,Errant Kingdom (Chapters 0-5),58,11,19.99,47
1218570,The Twins,30,7,1.99,23
1220160,Virtual Race Car Engineer 2020,7,4,19.99,3
1202220,Egypt Solitaire. Match 2 Cards,5,0,0.49,5
1213890,Frostford,3,2,2.99,1
926420,Model Railway Easily Christmas,20,11,0.0,9
1192640,Hentai Mosaique Neko Waifus,1703,165,1.99,1538
1217190,浮世万千之前世今生,83,23,5.49,60
1178050,狐の旅路,1418,79,0.0,1339
1215860,Model Railway Easily,17,7,19.99,10
897930,Demonheart: Hunters,172,34,9.99,138
705340,Kofi Quest: Alpha MOD,189,7,19.99,182
975950,Effie,265,83,19.99,182
1171370,The Supper,2923,44,0.0,2879
1045720,The Coma 2: Vicious Sisters,1988,77,14.99,1911
1209140,Peace Data,200,21,4.99,179
914800,Coffee Talk,5843,279,12.99,5564
466630,The Pedestrian,2966,75,19.99,2891
1188540,Apex Aim Trainer,485,130,4.99,355
1058530,H-Rescue,377,110,1.99,267
1078730,Soccer Manager 2020,1125,358,0.0,767
1097530,Mortal Glory,419,56,5.59,363
1225640,First Day: Home Defender,9,4,9.99,5
1185820,Hollow Island,66,10,4.99,56
1130710,Bookbound Brigade,26,10,19.99,16
1011190,SIMULACRA 2,1058,159,7.99,899
966400,Speaking Simulator,39,8,14.99,31
874040,Ministry of Broadcast,309,55,14.99,254
945680,Here Be Dragons,85,34,9.99,51
880750,Astra Exodus,23,25,29.99,-2
727850,ELDERBORN,1651,251,14.99,1400
1147450,Divine Miko Koyori,376,108,19.99,268
1226010,Storm Chasers: Tornado Islands,23,1,5.59,22
1185560,Astellia,1086,562,0.0,524
1198450,The Secret Order 8: Return to the Buried Kingdom,91,15,14.99,76
414160,Nubarron: The adventure of an unlucky gnome,411,232,9.99,179
1003090,Through the Darkest of Times,734,132,14.99,602
1202480,36 apples,93,9,0.0,84
1167950,Vampire's Fall: Origins,508,126,12.99,382
1186880,OctoFurry,115,13,1.99,102
1014050,Hockey Manager 20|20,56,22,34.99,34
1200420,Awesome Pea 2,24,3,2.49,21
1162930,Split or Steal,989,269,0.0,720
1162070,喵可莉的兔玩偶 - Nyakori's Rabbit Doll,826,32,2.99,794
1194830,Master Bladesmith,279,50,23.99,229
1168170,WAIFU HORROR: The Eight Pictures,35,30,0.99,5
1164310,Fairytale Solitaire. Witch Charms,4,1,0.49,3
1156360,Peaceful Days,152,21,9.99,131
1097790,The Dark Crystal: Age of Resistance Tactics,75,24,19.99,51
732160,The Wild Age,196,94,12.99,102
1014040,PictoQuest,188,39,7.99,149
1159660,Moe Era,4104,557,0.0,3547
795990,Rise: The Vieneo Province,16,8,19.99,8
1089830,Monster Energy Supercross - The Official Videogame 3,900,126,29.99,774
1215260,Efflorescence of Lust,235,88,1.99,147
454350,Days of War: Definitive Edition,1008,923,24.99,85
1227910,Roguelite 2,24,6,1.99,18
1185960,Napoleon in Russia,5,1,9.99,4
747850,Warm Village 暖暖村物语,265,134,14.99,131
897220,Summer Pockets,1647,18,44.99,1629
968370,The Blind Prophet,216,27,19.99,189
1149400,The Yellow King,111,95,24.99,16
1185270,经典扫雷,2,9,0.99,-7
625960,Stoneshard,16131,4953,24.99,11178
1203140,RaidTitans,55,5,8.99,50
1146630,Yokai's Secret,5738,592,1.99,5146
369530,Void Destroyer 2,461,92,9.99,369
1001800,KUNAI,373,78,16.99,295
1112830,The Watchers,241,87,8.99,154
523890,StarDrone VR,2,0,2.99,2
1203570,HexON,50,14,0.99,36
851280,MindSeize,190,55,3.74,135
1189440,VenusBlood FRONTIER International,682,46,39.99,636
1076500,Valgrave: Immortal Plains,762,156,0.0,606
1174940,Kill or Love,1850,213,0.0,1637
1177640,ROCKETRON,42,6,5.99,36
1224640,Jump To Die 2 - Bloody Soul,31,13,0.0,18
1192610,ANIME REDEMPTION,110,41,1.99,69
1232180,Sakuya Izayoi Gives You Advice And Dabs,1676,28,0.99,1648
1236990,Boris and the Dark Survival,2186,168,2.99,2018
1220930,Metaphobia,329,53,0.0,276
1222040,Offroad Mania,358,21,4.99,337
928950,LOEK,870,67,0.0,803
939000,Crisis VRigade,201,56,6.99,145
1197440,Broken Spell 2,41,70,1.49,-29
1183500,Puppy Cross,224,4,11.99,220
1229730,Achievement Clicker,22,24,0.99,-2
1202780,Theme Park Simulator: Rollercoaster Paradise,22,12,17.99,10
1170400,Labyrinth of the Witch,16,6,14.99,10
1222360,Cybershoes,13,2,0.0,11
1216550,Player's Eleven,28,4,17.99,24
1102130,Florence,6945,479,5.99,6466
1114940,I Wanna Maker,2899,135,0.0,2764
844960,Pro 11 - Football Manager Game,144,53,0.0,91
1167450,DAEMON X MACHINA,4894,609,49.99,4285
1167790,绝望监牢 / 絶望プリズン,345,112,0.0,233
1078330,Liz ~The Tower and the Grimoire~,363,32,14.99,331
465100,LUNA The Shadow Dust,1233,111,19.99,1122
424370,Wolcen: Lords of Mayhem,35262,27492,39.99,7770
1171270,TroubleDays,629,62,12.99,567
1150080,Azur Lane Crosswave,4751,2113,39.99,2638
1205240,Tentacle Girl,1006,114,1.99,892
1117160,Minds of Nations,355,116,0.0,239
1144400,Senren＊Banka,9632,80,34.99,9552
1145660,Drift Of The Hill,568,227,1.99,341
1041210,Mission: It's Complicated,154,9,0.0,145
1019450,Table Manners: Physics-Based Dating Game,251,181,8.99,70
1233170,Utopia Colony,55,23,16.99,32
1181400,Path of Giants,695,20,8.99,675
1195220,Gunman And The Witch,130,44,0.0,86
1233540,How Buddy’s parents met - a jigsaw puzzle tale,140,11,1.99,129
412020,Metro Exodus,67663,8557,29.99,59106
1247650,Immortal Love: Stone Beauty Collector's Edition,7,0,9.99,7
831470,One Dollar Simulator,37,7,1.0,30
1235790,dancing chair,55,9,0.0,46
726000,No King No Kingdom,90,19,14.99,71
1033220,The Amazing Shrinking Giraffe,93,17,3.99,76
1207850,Project RTD: Random Tower Defense PvP,450,445,0.0,5
974910,Magical Diary: Wolf Hall,158,10,24.99,148
1241040,Deep Despair,164,73,4.99,91
1228520,[Chilla's Art] The Convenience Store | 夜勤事件,1466,267,2.99,1199
1241950,Warzone 2100,946,98,0.0,848
346010,Besiege,42123,1936,14.99,40187
948850,魔神之战,14,10,0.0,4
994220,NEOVERSE,3004,538,19.99,2466
964570,DCL - The Game,536,126,29.99,410
1220900,Astonia Remastered,98,17,0.0,81
1221050,Ultimate Low Poly Pet,27,9,3.99,18
1074620,Adore,270,27,14.99,243
926860,Bloody Rally Show,201,18,9.99,183
1227780,Taur,1090,263,24.99,827
1057750,The Suicide of Rachel Foster,3048,1247,2.69,1801
420290,Blackwake,19561,4208,4.99,15353
1128810,RISK: Global Domination,22345,4545,0.0,17800
1062340,KATANA KAMI: A Way of the Samurai Story,183,124,29.99,59
926340,Roman's Christmas / 罗曼圣诞探案集,1280,37,9.89,1243
1232430,Counter Fight 4,14,3,9.99,11
1022710,Conglomerate 451,133,65,2.99,68
407130,Tank Mechanic Simulator,5771,765,19.99,5006
913740,WORLD OF HORROR,4796,269,14.99,4527
1212620,Pretty Neko,2621,185,0.99,2436
1020800,CAR TUNE: Project,268,60,13.99,208
1215200,Shining Song Starnova: Idol Empire,72,11,14.99,61
1221640,Ultra Foodmess,65,3,3.99,62
590670,Epic Card Game,78,27,0.0,51
1227160,MENTAL,46,20,29.99,26
1166290,Death and Taxes,2385,290,3.89,2095
1200230,Ludus,291,145,9.99,146
1243140,Hellpoint: The Thespian Feast,494,220,0.0,274
738270,Ciel Fledge: A Daughter Raising Simulator,73,20,9.99,53
1232590,DREAMGATE,71,17,14.99,54
875480,Somnium Space VR,43,34,0.0,9
1183260,TrymenT ―Ima o Kaetai to Negau Anata e― AlphA,500,39,29.99,461
969220,Up in the Air,26,2,0.0,24
1224020,Creepy Tale,1479,223,4.99,1256
1248740,Campgrounds IV Collector's Edition,2,0,9.99,2
1227250,小镇放置修仙,10,11,1.99,-1
945710,DreadOut 2,1064,340,19.99,724
1240230,Tony Stewart's Sprint Car Racing,163,21,19.99,142
1060600,Lair of the Clockwork God,629,30,19.99,599
696220,Folklore Hunter,662,232,11.99,430
1221800,Anime Artist 2: Lovely Danya,69,9,1.99,60
1241510,The Test,16679,410,1.59,16269
1234260,Deadly Land,94,22,5.99,72
1004770,Maiden and Spell,531,9,12.99,522
1202660,Elizabeth,46,7,3.99,39
989430,随风而逝/Story About Times,60,12,2.99,48
1184810,Mainframe Defenders,458,41,3.99,417
999020,Mega Man Zero/ZX Legacy Collection,1096,287,29.99,809
1146370,Master of Magic Classic,467,11,5.99,456
926580,Broken Lines,470,115,24.99,355
1174400,Togainu no Chi ~Lost Blood~,235,8,19.99,227
875800,Wasteland Remastered,140,47,14.99,93
1095060,Jar Wars,127,53,0.0,74
712190,Genesis Alpha One Deluxe Edition,1347,620,29.99,727
817840,Max Gentlemen Sexy Business!,1237,90,19.99,1147
1130560,RPG NPC Simulator VR,51,19,14.99,32
613900,Museum of Other Realities,309,26,0.0,283
912570,BEAUTIFUL DESOLATION,392,97,9.99,295
1133590,Stilt Fella,711,62,9.99,649
400080,Out of Space,1509,406,14.99,1103
1115450,Bastide,199,62,9.99,137
964650,Invasion Machine,345,101,18.99,244
1054040,Warlander,37,34,0.0,3
1007830,Edgar - Bokbok in Boulzac,80,14,7.99,66
1032590,Heaven Dust,402,33,7.99,369
1081100,Insurgence - Second Assault,19,0,7.99,19
1235810,Retro,4,2,4.99,2
1233270,OshiRabu: Waifus Over Husbandos,3145,454,19.99,2691
1228560,Boxman's Struggle,193,33,4.99,160
991560,ONE PUNCH MAN: A HERO NOBODY KNOWS,518,483,11.99,35
1127610,Iris and the Giant,887,111,17.99,776
1151120,Arrest of a stone Buddha,147,49,14.99,98
1033780,Lootbox Lyfe,31,4,4.99,27
1226990,Mechanica,382,61,19.99,321
281080,Reversion - The Return (Last Chapter),60,7,0.99,53
1239260,Barro F,876,185,0.99,691
1234220,Paper Pirates,78,9,8.99,69
1121420,Kingdom Under Fire: The Crusaders,786,68,19.99,718
532750,Dwarrows,94,17,14.99,77
1202540,Marco & The Galaxy Dragon,4069,85,19.99,3984
1189780,Wallachia: Reign of Dracula,84,27,9.99,57
598330,SimAirport,2675,731,9.99,1944
1216880,Risen Kingdom,202,60,9.99,142
422860,Holodance,185,29,19.99,156
1221080,Strip 4: Classmate Study,38,16,1.99,22
912550,Savage Vessels,27,6,12.99,21
1156990,Return to Shironagasu Island,1885,64,4.99,1821
1207590,Builders of Egypt: Prologue,2861,958,0.0,1903
1231590,Isle of Ewe,533,78,0.0,455
1250560,Chess Sudoku,147,6,4.99,141
1188680,The Political Machine 2020,584,124,14.99,460
1233690,Hypergalactic Psychic Table Tennis 3000,106,11,1.99,95
562730,MechDefender - Tower Defense,117,36,4.99,81
1180540,Puddle Knights,119,1,9.99,118
1232310,Bonfire,10,3,4.99,7
1240290,Infestation: Battle Royale,127,151,0.0,-24
1058380,Streamer Daily,856,109,14.99,747
1016860,Boiling Steel,272,54,14.99,218
1227750,Puzzle - LINES AND KNOTS,191,25,0.49,166
1061010,深海：即刻抉择,272,343,2.99,-71
732930,Wunderling DX,81,0,14.99,81
1214280,Walking Simulator,7502,1049,0.0,6453
589290,Holdfast: Nations At War,18245,2009,19.99,16236
1226690,Great British Railway Journeys,31,12,29.99,19
825190,MisBits,412,79,0.0,333
1162640,Adventure mosaics. Forest spirits,3,0,5.99,3
893850,THE LONGING,4137,342,11.24,3795
1238330,Frontline: Panzer Blitzkrieg!,58,8,9.99,50
1104450,Bombergrounds: Battle Royale,6186,577,0.0,5609
1115690,"Yes, Your Grace",5055,890,19.99,4165
1140290,Murder by Numbers,954,159,14.99,795
362890,Black Mesa,80256,3770,19.99,76486
1074180,Smart City Plan,68,34,15.99,34
1241100,POLYGON,11507,4586,0.0,6921
1255040,Let's Learn Korean! Hangul,48,2,1.99,46
1224290,Horizon's Gate,595,19,19.99,576
1258040,Super Bernie World,2347,648,0.0,1699
445220,Avorion,9561,1010,24.99,8551
1217050,Shaolin vs Wutang 2,243,42,16.99,201
1241520,The Horrorscope,972,56,1.99,916
1234520,The Escaper,577,32,3.99,545
1202970,Mad Tracks,101,10,9.99,91
582290,Rest House,9,24,4.99,-15
1256950,Draft Day Sports: College Basketball 2020,39,18,24.99,21
1002430,Victory Road,164,12,19.99,152
1057090,Ori and the Will of the Wisps,86228,3149,29.99,83079
1060220,Langrisser I & II,453,146,49.99,307
960170,DJMAX RESPECT V,16522,2632,49.99,13890
1007810,重明鸟 Bright Bird,567,187,9.99,380
1234550,Quest Rooms,67,26,19.99,41
1111620,Gloomy Eyes,129,17,2.69,112
1162470,IIslands of War,96,13,9.99,83
1229500,Shieldmaiden: Remix Edition,96,17,12.99,79
644290,MEMORIES OF MARS,981,612,19.99,369
1217570,Lessons with Chii-chan,94,19,19.99,75
1048740,Half Past Fate,206,11,19.99,195
1058450,MY HERO ONE'S JUSTICE 2,2154,269,59.99,1885
992910,The Black Masses,601,280,19.99,321
524910,Hidden Through Time,1705,103,7.99,1602
931950,Labyrinth: The War on Terror,85,20,12.99,65
1252560,Love Breakout,469,66,0.99,403
1090630,Granblue Fantasy: Versus,4458,995,19.99,3463
848030,Roundguard,300,44,19.99,256
397540,Borderlands 3,87281,16216,59.99,71065
1202650,Gift Girl,387,186,0.79,201
319540,A Year Of Rain,280,319,1.49,-39
1048600,Stela,504,136,19.99,368
1093790,Seals of the Bygone,48,6,12.99,42
1069210,Pulang Insanity - Director's Cut,91,33,14.99,58
495420,State of Decay 2: Juggernaut Edition,29710,6880,29.99,22830
1250060,法利恩戰記（Furion Chronicles）,86,27,4.99,59
1097210,WoMen in Science,35,9,7.99,26
865040,Super Bit Blaster XL,589,31,3.99,558
1055490,Weed Farmer Simulator,112,67,14.99,45
1250650,AI＊Shoujo/AI＊少女,1498,458,69.99,1040
1161870,Epiphyllum in Love,1541,16,3.99,1525
1249010,ISOLAND3: Dust of the Universe,148,5,2.99,143
1208810,Green: An Orc's Life,35,1,2.99,34
676510,Industrial Petting,63,3,15.99,60
1259520,Topang,4,2,0.99,2
1253570,Futuball - Future Football Manager Game,30,16,0.0,14
1212400,Heroines of Swords & Spells,488,26,6.99,462
821350,R.B.I. Baseball 20,201,127,0.0,74
1209490,Exit the Gungeon,2232,598,9.99,1634
1162480,DIMENSION REIGN - ROGUELIKE DECKBUILDER,155,38,17.99,117
1259380,Submarine Titans,190,21,4.99,169
1241700,There Is No Game: Jam Edition 2015,5024,146,0.0,4878
1173240,Profitania,2,1,19.99,1
1313,SiN: Gold,233,38,9.99,195
1058060,Princesses Never Lose!,312,57,19.99,255
1148590,DOOM 64,4856,315,4.99,4541
1247640,Dwarf Shop,60,23,9.99,37
1082180,TT Isle of Man Ride on the Edge 2,819,196,29.99,623
1229260,Monster Girls and the Mysterious Adventure,99,11,18.99,88
782330,DOOM Eternal,139391,13658,39.99,125733
1072040,Panzer Corps 2,2195,476,23.99,1719
1238680,Amairo Chocolate,470,11,24.99,459
773790,Ostriv,2774,210,24.99,2564
1249880,Tiny Bunny: Prologue,1774,55,0.0,1719
1246020,NOeSIS01_诉说谎言记忆物语,903,30,0.0,873
1260830,Metallic Metronome,65,9,0.0,56
890700,Caffeine: Victoria's Legacy,27,3,17.99,24
1087280,Out of the Park Baseball 21,1521,139,0.0,1382
1238280,100 Doors Game - Escape from School,408,136,0.0,272
1203930,The Last Haven,1289,290,19.99,999
1070150,SLAYERS FOR HIRE,112,6,0.0,106
1258460,Escape First 3,120,68,6.99,52
1262060,Battle Ram,247,29,11.99,218
1257810,I'm on Observation Duty 2: Timothy's Revenge,192,17,2.99,175
546560,Half-Life: Alyx,71580,1112,59.99,70468
1216320,Shieldwall,3928,463,13.99,3465
1209860,BDSM: Big Drunk Satanic Massacre Demo,133,26,0.0,107
991270,The Legend of Heroes: Trails of Cold Steel III,2180,180,59.99,2000
1144250,WAIFU HELL,275,63,0.99,212
1189800,Bleeding Edge,1064,521,29.99,543
12210,Grand Theft Auto IV: The Complete Edition,84223,24474,5.99,59749
1150640,Yu-Gi-Oh! Legacy of the Duelist : Link Evolution,2567,576,39.99,1991
1218740,Rakion Chaos Force,1875,1226,0.0,649
955050,Bright Memory,28670,2551,7.99,26119
899310,Iron Danger,587,203,2.99,384
1021770,Wanba Warriors,1806,160,4.99,1646
627690,Idle Champions of the Forgotten Realms,8436,2055,0.0,6381
1121710,Total Lockdown,602,179,5.99,423
1162650,Ken ga Kimi,715,34,49.99,681
903950,Last Oasis,14473,7425,29.99,7048
1071870,Biped,4427,543,14.99,3884
1256690,Hot And Lovely 2,219,76,1.99,143
1216230,Project Heartbeat,182,19,7.79,163
1225070,Family Mysteries: Poisonous Promises,127,38,14.99,89
758080,BloodLust 2: Nemesis,88,22,12.99,66
1084790,WarPlan,120,25,39.99,95
1104380,The Room VR: A Dark Matter,2722,67,29.99,2655
1202900,Assemble with Care,2513,228,7.99,2285
1046660,Charterstone: Digital Edition,168,54,18.99,114
1255970,Kicks Online,168,52,0.0,116
1177020,Gigantosaurus The Game,22,6,24.99,16
1215270,Down the Rabbit Hole,305,19,19.99,286
474890,Uncrewed,89,45,11.99,44
1089090,ONE PIECE: PIRATE WARRIORS 4,9968,886,14.99,9082
960690,One Step From Eden,5820,373,19.99,5447
578210,A-Tech Cybernetic VR,436,266,14.99,170
878940,Collective: the Community Created Card Game,160,33,0.0,127
1250770,前進吧！高捷少女Initiating Station PLUS,82,4,9.99,78
869170,Oneiros,156,25,4.99,131
681390,ZomDay,679,114,9.99,565
1221540,KUUKIYOMI: Consider It,316,78,4.99,238
261550,Mount & Blade II: Bannerlord,167602,23552,49.99,144050
1241910,Victory and Glory: The American Civil War,41,21,29.99,20
1107790,The Complex,1744,496,4.93,1248
985260,The Morrigan,199,30,9.99,169
985950,Operencia: The Stolen Sun,343,90,29.99,253
965590,Sagrada,198,7,9.99,191
1168840,Project Oasis,140,7,0.0,133
895480,Fates of Ort,104,10,14.99,94
1202310,Sakura Succubus,388,82,9.99,306
1227400,Over the Alps,188,14,12.99,174
738510,メモリーズオフ-Innocent Fille-,804,78,39.99,726
1200350,Dead Ground Arcade,35,5,0.0,30
1267870,Xenogunner,22,0,14.99,22
1267270,Yumeutsutsu Re:Idol,23,2,4.99,21
1274800,Pancake Sailor,138,20,0.0,118
1149940,Lock 'n Load Tactical Digital: Core Game,352,48,4.99,304
1222800,VALKYRIE CONNECT,660,168,0.0,492
1206240,Talvisota - Winter War,920,123,0.0,797
1144460,SOUNDART,55,17,19.99,38
683940,Lawgivers,271,49,7.99,222
1178150,MazM: Jekyll and Hyde,76,6,14.99,70
1151740,Prison Princess,217,34,19.99,183
952060,Resident Evil 3,45330,12669,15.99,32661
441440,Sometimes Always Monsters,108,39,19.99,69
1218250,We Went Back,3481,595,0.0,2886
890720,In Other Waters,1127,147,14.99,980
1245470,Ultimate Ski Jumping 2020,44,14,0.99,30
1262460,Zompiercer,787,140,19.99,647
838110,HyperParasite,122,17,17.99,105
1271050,Shrine,610,45,0.0,565
1200720,Making*Lovers,497,5,29.99,492
1265240,Uniform Girl,238,108,0.99,130
1275630,Drug Dealer Simulator: Free Sample,2295,278,0.0,2017
1144440,UnderParty,495,74,6.99,421
1248820,Lost Memories 3 Side Stories,393,48,0.0,345
1174390,ANNIE:Last Hope,538,44,9.99,494
1060210,Disaster Report 4: Summer Memories,249,101,59.99,148
1259390,Military Service,4,0,0.0,4
969540,Pattern,23,6,7.49,17
1259890,Northern Tale 5: Revival,22,1,5.99,21
1248650,Fate Arena (Alpha),327,80,0.0,247
804870,Armed to the Gears,120,61,11.99,59
772570,Crew 167: The Grand Block Odyssey,27,2,10.99,25
1232580,Knock on the Coffin Lid,410,65,24.99,345
1111940,Quiplash 2 InterLASHional,222,22,9.99,200
334310,Plebby Quest: The Crusades,2033,296,19.99,1737
1015790,Dark Hero Party,177,92,14.99,85
993790,Ancient Enemy,324,27,14.99,297
1071130,The Procession to Calvary,597,9,4.99,588
1011610,Radio General,334,55,19.99,279
1245950,Ironlights,129,36,19.99,93
1265850,Chatventures,92,4,2.99,88
820020,Alder's Blood: Definitive Edition,150,73,19.99,77
606800,Startup Company,4463,1019,12.99,3444
1056610,Heal,265,36,6.99,229
1276040,Mini Words: Top Movies,48,11,0.99,37
900010,Meeple Station,474,274,19.99,200
1252780,Bloons Monkey City,3506,325,0.0,3181
1221240,Tavern Cards,31,15,2.99,16
1266980,Madrun,379,27,0.0,352
1231520,Farmtale,173,59,4.99,114
1046300,Pirates Outlaws,436,76,19.99,360
1279770,Tower of God,4,2,1.99,2
1182020,WGT Golf,1120,693,0.0,427
1096300,九霄缳神记 JIU XIAO,285,194,19.99,91
895400,Deadside,20272,5490,19.99,14782
1129310,Receiver 2,1923,179,19.99,1744
1259460,Trendpoker 3D: Free Online Poker,76,27,0.0,49
1151340,Fallout 76,52215,19901,39.99,32314
838630,Deadliest Catch: The Game,591,534,19.99,57
640310,Drive-By Hero,110,115,3.99,-5
975620,Project DeepWeb,60,14,4.99,46
823940,Virtual Battlegrounds,333,152,19.99,181
1040630,Alchemy Story,132,25,19.99,107
1100260,Circle Empires Rivals,1194,138,14.99,1056
544810,KARDS - The WWII Card Game,19408,4169,0.0,15239
1269150,Fly Punch Boom: First Impact!,467,52,0.0,415
638490,Soldat,1490,80,0.0,1410
1122120,STATIONflow,366,53,17.99,313
1209450,Potion Commotion,84,12,0.0,72
1215320,Piczle Cross Adventure,54,3,9.99,51
976500,Venineth,128,23,19.99,105
451310,A Fold Apart,73,13,19.99,60
1250870,Cyrano Story,727,346,0.0,381
1232940,The Under Presents,69,8,11.99,61
612570,Fort Triumph,651,167,19.99,484
812870,Sentinels of Freedom,188,57,24.99,131
1201550,Mad Experiments: Escape Room,176,52,14.99,124
1252320,Touhou Kikamu ~ Elegant Impermanence of Sakura,431,11,13.99,420
1170610,Sexy Fitness Girl,203,57,1.99,146
1205960,My Cute Fuhrer,929,135,1.99,794
1163040,Billion Road,133,31,19.99,102
682990,Drug Dealer Simulator,11041,1680,19.99,9361
1249130,Hero of the Kingdom: The Lost Tales 1,806,65,4.99,741
876650,Aground,1228,66,14.99,1162
951330,Weaponry Dealer VR,36,16,9.99,20
1040070,Merchant of the Skies,1120,148,14.99,972
1250410,Microsoft Flight Simulator Game of the Year Edition,29473,9244,59.99,20229
1275640,Coloring Game 3,1271,54,0.0,1217
1202240,Fighters Wizards,38,8,0.99,30
1271080,Car Dealer,104,55,7.99,49
1235360,Epic Conquest 2,271,35,0.0,236
1127460,Mod and Play,758,880,2.99,-122
1034890,Obey Me,63,8,19.99,55
596000,The Shattering,177,26,19.99,151
1119600,Help Will Come Tomorrow,548,126,19.99,422
833090,Swords of Gurrah,647,161,14.99,486
1022310,Warhammer Underworlds: Online,911,544,9.99,367
1177030,PONG Quest™,31,7,14.99,24
1149440,Dragon Marked For Death,614,176,39.99,438
1134320,GLADOM - 2D PVP Free & Skill Based,19,7,0.0,12
1034750,The Flower Collectors,111,25,19.99,86
1283130,Micro Platformer,1287,41,0.0,1246
1254370,No one lives under the lighthouse Director's cut,988,117,6.99,871
1281080,Train Station Renovation - First Job,700,104,0.0,596
949600,Intergalactic Fishing,191,6,14.99,185
1268140,Lair Land Story,81,1,14.99,80
1050280,Kaion Tale MMORPG,169,51,0.0,118
1267260,Yumeutsutsu Re:After,64,5,49.99,59
777130,Blush Blush,4674,621,0.0,4053
1111370,A Summer's End - Hong Kong 1986,1217,38,14.99,1179
1097240,Crawling Of The Dead,36,18,24.99,18
807120,Iratus: Lord of the Dead,5248,828,5.99,4420
793460,112 Operator,3279,455,24.99,2824
1244930,Mask of the Plague Doctor,40,3,6.99,37
1137350,Filament,468,51,16.99,417
1284820,Desktop Kanojo,1319,201,2.99,1118
1175200,Forbidden Ingress,179,55,4.99,124
1280100,Element Battle Royale,49,35,0.0,14
1178140,Pixel Ripped 1995,140,2,19.99,138
1164000,六阶谜题 six-step mystery,488,61,6.99,427
882100,XCOM®: Chimera Squad,14530,5491,4.99,9039
609850,Slinger VR,30,10,14.99,20
470310,TROUBLESHOOTER: Abandoned Children,6204,338,24.99,5866
746850,Cloudpunk,9544,1153,19.99,8391
1258590,Locked Up,600,139,12.99,461
1161490,MotoGP™20,2322,283,5.99,2039
955740,Mini Healer,1408,48,7.99,1360
1258480,Aladdin - Hidden Objects Game,32,4,2.49,28
1267310,[Chilla's Art] Onryo | 怨霊,73,58,4.99,15
924980,Trials of Mana,4206,335,49.99,3871
1226000,Nations At War Digital Core Game,70,18,4.99,52
1210030,노베나 디아볼로스,1282,80,18.99,1202
1263490,Sweet Solitaire: School Witch,9,3,4.99,6
1216490,Knock Harder,294,9,9.99,285
1282200,The Test: Hypothesis Rising,4916,101,1.99,4815
523660,HYPERCHARGE: Unboxed,2458,246,19.99,2212
840140,武侠乂 The Swordsmen X,1673,1829,24.99,-156
1135830,Brave Alchemist Colette,722,68,24.99,654
1230410,Chaos,3125,392,0.0,2733
1287260,BarnFinders: The Pilot,451,39,0.0,412
970600,Paranoia: Deliver Me,86,26,1.99,60
1165870,Mahou Arms,366,58,29.99,308
1184050,Gears Tactics,4298,1321,39.99,2977
1291500,Kill It With Fire: Ignition,1454,130,0.0,1324
996770,Moving Out,1208,350,6.24,858
804850,Pax Nova,222,146,24.99,76
1071290,Wild West and Wizards,266,75,14.99,191
1287250,! Wild Russia !,41,22,19.99,19
1281800,Samsara Room,6615,175,0.0,6440
384960,Vengeance,290,68,7.99,222
1200110,メモリーズオフ-Innocent Fille- for Dearest,216,14,39.99,202
434190,Follia - Dear father,101,65,19.99,36
1213740,She Will Punish Them,11430,954,9.59,10476
1226920,Riposte!,6,0,4.99,6
1258090,Duck Duck Goose,10,12,0.0,-2
1207320,Gray Zone,34,12,16.99,22
792710,Levelhead: Platformer Maker,788,46,19.99,742
985890,Streets of Rage 4,13115,1089,24.99,12026
1239440,Surviving Titan,112,49,4.99,63
1249510,Hnefatafl,35,0,9.99,35
947940,SCP: Nukalypse,376,167,0.0,209
1127840,Landlord's Super,742,76,19.99,666
1191940,Deathtrap Dungeon: The Interactive Video Adventure,143,12,7.99,131
939790,Royal Alchemist,205,10,19.99,195
1189630,Path Of Wuxia,22347,5652,34.99,16695
1243130,Nimbatus - Drone Creator,183,24,0.0,159
521150,Another Brick in The Mall,1716,326,16.99,1390
1247190,Family Mysteries 2: Echoes of Tomorrow,84,31,14.99,53
574980,Them's Fightin' Herds,3144,266,19.99,2878
1261960,STRIKERS 1945,105,6,9.99,99
926140,CHANGE: A Homeless Survival Experience,1640,145,14.99,1495
865540,PLAYNE : The Meditation Game,949,35,14.99,914
1257410,Cat in the Box,823,43,6.99,780
984610,Mech Merc Company,72,11,11.99,61
1251750,Family Man: Prologue,85,15,0.0,70
731620,Hide Or Die,871,672,0.0,199
378760,Pixel Starships,1052,395,0.0,657
1210800,Rum & Gun,120,7,4.99,113
1273790,Empires and Tribes,165,69,24.99,96
1127110,Outpost,536,71,0.0,465
1264740,Lucid Dream,784,68,0.0,716
651380,BANG! BANG! Totally Accurate Redneck Simulator,211,17,0.99,194
1291830,Outlaws: Corwin's Treasure,16,17,4.99,-1
1219860,Monster Girls You-ki Chan,22,7,14.99,15
968870,Close to the Sun,535,180,19.99,355
1292540,Escape: The Brother's Saloon,70,19,7.99,51
1284240,Black Book: Prologue,1204,74,0.0,1130
1239430,Population Zero,461,740,0.0,-279
1258080,Shop Titans,9584,2630,0.0,6954
1141020,Adventure Escape Mysteries,298,56,0.0,242
840370,Someday You'll Return,505,80,19.99,425
917840,Wintermoor Tactics Club,369,26,7.49,343
844500,Draw a Stickman: EPIC 3,82,46,7.99,36
1213670,Solitaire Forever II,137,21,0.0,116
957790,War Dust VR,1090,284,24.99,806
1281390,Wasted World,53,17,19.99,36
1233950,Wayhaven Chronicles: Book Two,174,3,6.99,171
1298180,Pair Matching Puzzle Connect,2,2,0.49,0
1243220,Picklock,261,36,7.99,225
864160,BE-A Walker,264,92,9.99,172
1274140,One Dreamer: Prologue,744,27,0.0,717
290690,Tonight We Riot,465,22,14.99,443
1272110,Close Combat: Wacht am Rhein,39,7,39.99,32
1233720,The Parenting Simulator,40,5,3.99,35
1213700,Spirit of the North,2040,256,19.99,1784
1298500,Fantasy Mosaics 33: Inventor's Workshop,2,0,6.99,2
1050880,Wavey The Rocket,26,2,10.99,24
1041690,Mace and Grace: action fight blood fitness arcade,46,6,9.99,40
1265230,Engine Evolution 2020,164,81,0.0,83
999860,Enemy On Board,1142,421,0.0,721
465200,Fury Unleashed,1511,161,19.99,1350
1134520,Dark Light,235,63,16.99,172
1106840,Hydroneer,11540,1730,9.99,9810
1313350,Living Legends Remastered: Ice Rose Collector's Edition,5,1,9.99,4
1256610,Dream Date,1632,258,1.99,1374
1305720,Delores: A Thimbleweed Park Mini-Adventure,458,62,0.0,396
1284110,Amy's Greenmart,34,2,9.99,32
1289310,Helltaker,104471,2160,0.0,102311
1190990,Colormeleons,54,4,0.99,50
1019310,VirtuaVerse,733,128,14.99,605
1299600,Tinseltown Tycoon,16,7,5.99,9
913060,Jet Lancer,648,34,14.99,614
346970,OBEY,348,62,7.99,286
1210250,Island Saver,2389,100,0.0,2289
1252580,Rising Hell - Prologue,83,13,0.0,70
1100990,Aimbeast,1361,106,19.99,1255
548430,Deep Rock Galactic,138093,4679,29.99,133414
1300360,Neglected,291,27,0.0,264
988910,Super Mega Baseball 3,1359,132,44.99,1227
1277950,Heart's Medicine - Season One,47,14,12.99,33
1277310,Saving You From Yourself,28,29,0.0,-1
383840,Nimbatus - The Space Drone Constructor,1479,343,19.99,1136
1243670,Higurashi When They Cry Hou - Ch.8 Matsuribayashi,328,24,5.19,304
1270930,Hentai vs Virus: I Am Waifu,29,2,2.99,27
1163070,RaiOhGar: Asuka and the King of Steel,203,34,14.99,169
1011420,Bus Mechanic Simulator,82,58,24.99,24
1232420,Atlantica Global,495,264,0.0,231
1058690,Signs of the Sojourner,129,16,19.99,113
1190160,LIT: Bend the Light,214,10,6.99,204
1070690,RollerCoaster VR Universe,70,34,2.99,36
682450,Garrison: Archangel,189,32,14.99,157
1297160,a new life.,1525,52,2.99,1473
1293650,b 2,181,21,0.0,160
838410,Tabletop Playground,104,51,14.99,53
1129920,Tales From Off-Peak City Vol. 1,382,3,9.99,379
1259000,Damascus,189,54,0.0,135
979640,Cepheus Protocol,1291,268,19.99,1023
764230,Shoujo City,182,23,9.99,159
1274490,Green Project,890,160,5.99,730
1225810,FOS,266,64,0.0,202
1289640,The Confession,878,37,1.99,841
804270,Chex Quest HD,1424,321,0.0,1103
1258710,"BEAR, VODKA, FALL OF BERLIN! 🐻",334,28,0.99,306
1201940,Project Speed,66,31,0.0,35
1194930,Blackthorn Arena,2499,1089,19.99,1410
1291530,Arena,181,16,0.0,165
1284410,GWENT: The Witcher Card Game,20082,4557,0.0,15525
1098170,Dark Nights with Poe and Munro,252,58,12.99,194
1223500,Umurangi Generation,693,51,10.49,642
1030830,Mafia II: Definitive Edition,10410,4624,29.99,5786
1306580,Left on Read,4013,955,0.0,3058
1150730,Island SAGA,226,33,19.99,193
1041920,If Found...,1034,114,12.99,920
1214540,SUPER CIRCUIT BREAKERS,71,16,0.0,55
1190400,The Wonderful 101: Remastered,605,81,39.99,524
360430,Mafia III: Definitive Edition,24121,18879,29.99,5242
431240,Golf With Your Friends,45633,5311,14.99,40322
780270,Brimstone Brawlers - Early Access,138,15,0.0,123
1140100,The Persistence,96,45,29.99,51
1084990,Old Gods Rising,82,27,9.99,55
1150950,Timelie,1769,104,17.99,1665
1261980,Samurai Aces,28,3,9.99,25
1272450,Mahjong Deluxe,15,3,2.99,12
733210,Neversong,664,88,14.99,576
674500,Total Tank Simulator,4343,1275,19.99,3068
1283960,东方幻灵录 ~ Touhou Hakanai Cards,509,78,0.0,431
1309130,Lucky and a life worth living - a jigsaw puzzle tale,70,3,1.39,67
1264160,からかい上手の高木さんVR 1学期,128,32,13.99,96
865980,BOSSGARD,149,108,19.99,41
1226470,Shadow Arena,3095,2440,0.0,655
1309910,Vacation Adventures: Park Ranger 10,3,0,6.99,3
789770,Starena,57,8,14.99,49
1321230,Angels of Death Episode.Eddie,268,28,6.99,240
863460,Cyber Ops,47,46,14.99,1
1078490,Seed Hunter 猎源,241,102,8.99,139
1102190,Monster Train,15457,570,24.99,14887
906100,Observation,2835,713,24.99,2122
979110,Space Haven,5139,714,22.99,4425
1175360,Doomsday Hunters,428,42,15.99,386
726360,BOOBS SAGA: Prepare To Hentai Edition,367,103,2.99,264
326460,ShellShock Live,28180,1974,6.99,26206
904360,Family Man,338,126,19.99,212
700240,Project Genesis,93,19,29.99,74
1020780,DarkStory Online,270,128,0.0,142
582890,Estranged: The Departure,1759,261,5.99,1498
477900,Lord of Dwarves,55,13,19.99,42
1200330,Strategic Mind: Blitzkrieg,337,49,39.99,288
1254870,High Strategy: Urukon,72,12,5.99,60
1274540,Tomatenquark,29,8,0.0,21
1290070,Hot And Lovely 3,168,47,1.99,121
1316390,Thermo Sudoku,132,5,4.99,127
1293820,YOU and ME and HER: A Love Story,1628,54,29.99,1574
1288170,Red Planet Farming,606,25,0.0,581
1313880,Test Tube Titans: Taster Trial,5,1,0.0,4
431940,Wildfire,524,108,14.99,416
1291240,Zamboni Simulator 2019,206,25,0.0,181
1296510,Dread X Collection,304,57,6.99,247
1150460,Summer Paws,289,11,4.99,278
1318030,Fractal Alchemist,23,3,9.99,20
1292010,Missile Command: Recharged,149,16,2.99,133
1222300,Into The Flames,503,29,19.99,474
1015930,Blood Rage: Digital Edition,343,326,19.99,17
835650,Rising Lords,416,154,19.0,262
1198400,Rhythm Fighter,358,79,14.99,279
1144800,Drop In - VR F2P,436,86,0.0,350
975150,Resolutiion,83,29,19.99,54
1146170,KingSim,142,18,9.99,124
1259840,The House of Da Vinci 2,1100,87,19.99,1013
1283140,Burn Me Twice,193,40,0.0,153
1191630,Shantae and the Seven Sirens,1087,123,29.99,964
1062160,Poly Bridge 2,4818,209,14.99,4609
1055210,Retrograde Arena,368,21,0.0,347
1101190,Dungeon Defenders: Awakened,2637,1327,29.99,1310
715380,Those Who Remain,335,159,19.99,176
1166350,Alexis Almighty: Daughter of Hercules,2,3,11.99,-1
1187330,Tower Tag,251,30,4.99,221
1154080,Rugby League Team Manager 3,51,12,39.99,39
935980,AETERNITAS,13,14,9.99,-1
1011290,Hotel R'n'R,129,17,19.99,112
1078280,Ruins Seeker,536,31,19.99,505
610160,Aeronautica Imperialis: Flight Command,79,91,24.99,-12
1051960,Fly Punch Boom!,103,10,5.99,93
1289010,Haypi Monster 3,20,11,0.0,9
1215180,The Beasts Of 9500,347,216,9.99,131
1318420,Summer in Mara Prologue,924,133,0.0,791
915320,Pixel Strike 3D,6946,2389,0.0,4557
1293230,House of Detention,4635,372,0.99,4263
1287000,COVID: The Outbreak,65,25,13.99,40
636970,Tales Of Glory,645,145,29.99,500
440640,Sweet F. Cake,433,51,9.95,382
1195020,Guardians of the Ashes,288,88,2.99,200
1287800,Schwarzerblitz,119,2,0.0,117
1292220,Apoc Runner,17,4,0.0,13
1271300,Methods: The Detective Competition,285,25,19.99,260
934580,Hell Wedding 夜嫁,979,129,0.0,850
1054510,Survivalist: Invisible Strain,2022,274,6.99,1748
1114220,Gedonia,1135,122,11.99,1013
754050,Bomb Bots Arena,506,90,0.0,416
1266600,亦春秋 Power Of Seasons,604,307,12.99,297
605800,Skelattack,58,32,19.99,26
1272130,Close Combat: The Longest Day,35,13,39.99,22
1302990,MARDEK,187,3,9.99,184
1277320,FirstQueen1 NEXT,23,12,11.99,11
1273520,The Last Day Defense VR,28,7,9.99,21
1172620,Sea of Thieves,210637,22585,39.99,188052
1077520,The Light Remake,900,103,4.99,797
1262540,Need for Speed™,8753,3575,29.99,5178
1238080,Burnout™ Paradise Remastered,2720,1629,19.99,1091
1225580,Fe,480,118,19.99,362
1262240,Plants vs. Zombies: Battle for Neighborville™,6915,2680,39.99,4235
1233570,Mirror's Edge™ Catalyst,7761,1545,19.99,6216
1225590,Sea of Solitude,1279,235,19.99,1044
1222680,Need for Speed™ Heat,41355,8243,69.99,33112
1250790,Crafting Idle Clicker,273,286,0.0,-13
1245820,Life of a Mercenary,9,1,3.99,8
1262600,Need for Speed™ Rivals,3181,1096,19.99,2085
1304910,My Hidden Things,33,5,8.99,28
1295230,三国志猛将传,60,47,4.99,13
1218360,Luna : The Dimension Watcher,25,14,0.0,11
1160020,AshenForest,151,8,2.3,143
1282690,Crysis® 3,4039,665,29.99,3374
1225560,Unravel,2626,234,19.99,2392
1222690,Dragon Age™ Inquisition,7504,2479,39.99,5025
1178400,Pro Cycling Manager 2020,739,116,19.99,623
1225570,Unravel Two,2888,563,19.99,2325
1238040,Dragon Age II: Ultimate Edition,2227,514,29.99,1713
1103860,The Wizards - Dark Times,289,71,24.99,218
1250120,Swamp Castle,1,1,2.99,0
1100140,Touhou Fuujinroku ~ Mountain of Faith.,586,4,14.99,582
1100150,Touhou Chireiden ~ Subterranean Animism.,313,9,14.99,304
1268350,A Game of Humans,49,12,11.99,37
1163340,Carrier Battles 4 Guadalcanal - Pacific War Naval Warfare,180,27,29.99,153
1299120,Mosaique Neko Waifus 2,1840,84,1.99,1756
337460,18 Wheels of Steel: Pedal to the Metal,41,6,9.99,35
851150,Burning Knight,79,17,14.99,62
1100160,Touhou Seirensen ~ Undefined Fantastic Object.,181,3,14.99,178
1213210,Command & Conquer™ Remastered Collection,23178,2360,19.99,20818
1340540,Chimeras: Cherished Serpent Collector's Edition,3,0,9.99,3
877330,Castle Kong,38,8,0.0,30
1279800,Legend of Towercraft,54,20,0.0,34
1296840,The Spike,996,57,4.99,939
1196080,Space Simulation Toolkit,53,6,14.99,47
1318690,shapez,7744,219,9.99,7525
1316640,Ironsmith Medieval Simulator: Prologue,75,19,0.0,56
1274300,Cyber Agent,329,122,1.99,207
526870,Satisfactory,97842,2841,29.99,95001
1016730,Deck of Ashes,699,227,19.99,472
1332610,TeamJumpers: Rejumped,27,21,0.0,6
1332890,HopBound,27,2,2.99,25
961010,The Hand of Glory,135,3,18.99,132
1139870,The Dark Eye : Book of Heroes,74,114,9.99,-40
1279410,GUNBIRD 2,35,1,9.99,34
1276540,Persian Nights 2: The Moonlight Veil,70,13,14.99,57
1316700,Escape from Kyoto House,132,10,4.99,122
883360,Beyond Blue,872,124,19.99,748
1237950,STAR WARS™ Battlefront™ II,33941,5028,15.99,28913
1170760,XIII - Classic,1484,152,5.99,1332
690980,TO4: Tactical Operations,182,67,0.0,115
1110050,Evan's Remains,917,114,6.99,803
1238000,Mass Effect™: Andromeda Deluxe Edition,7698,2256,29.99,5442
1322170,Pluviophile,181,12,0.49,169
1237980,STAR WARS™ Battlefront,2560,732,9.99,1828
1238840,Battlefield 1 ™,66908,10835,9.99,56073
1238880,Battlefield™ Hardline,1561,695,9.99,866
683260,Inops,11,4,0.0,7
1238860,Battlefield 4™,38824,5829,9.99,32995
1238820,Battlefield 3™,4795,2145,9.99,2650
638230,Journey,20432,1120,14.99,19312
1210380,Bingo VR,17,6,0.0,11
1275890,Baldi's Basics Plus,1589,72,9.99,1517
1238020,Mass Effect™ 3 N7 Digital Deluxe Edition (2012),1475,460,29.99,1015
1067860,NewCity,308,76,9.99,232
1313490,Slimes,22,2,6.99,20
408900,Unfortunate Spacemen,6028,885,0.0,5143
1311640,Swarm,220,16,0.0,204
1306620,[Chilla's Art] Missing Children | 行方不明,256,44,2.99,212
304690,Star Sonata 2,127,74,0.0,53
1269770,Bullet Art,9,7,0.0,2
1113000,Persona 4 Golden,54742,1587,19.99,53155
1227890,Summer Memories,7905,583,19.99,7322
1218280,Bad Guys at School,1043,158,4.99,885
845050,Last Regiment,69,4,19.99,65
536280,Disintegration,341,336,29.99,5
1264180,Blueplanet VR,43,10,12.49,33
1274290,Kidnapped Girl,4746,736,0.0,4010
991170,Barn Finders,2768,559,19.99,2209
1329440,Detective Solitaire Inspector Magic and the Man Without Face,5,1,4.99,4
1153730,SteamCity Chronicles - Rise Of The Rose,6,6,12.99,0
1099460,The Forgotten Land,33,12,14.99,21
610370,Desperados III,9822,333,49.99,9489
962580,Summer in Mara,1158,347,9.99,811
940710,Colt Canyon,610,87,14.99,523
1184840,Chaos Galaxy,200,34,7.49,166
957820,Across the Grooves,88,6,12.99,82
1023700,Palais de Reine,87,17,29.99,70
1258870,Aura Kingdom 2,80,161,0.0,-81
1205900,Alwa's Legacy,238,17,17.99,221
1333090,Gravity,43,7,0.0,36
966430,Neverinth,675,261,15.99,414
1250250,NAMCO MUSEUM ARCHIVES Vol 1,59,25,4.99,34
1230140,ATRI -My Dear Moments-,8080,107,20.99,7973
960910,Heavy Rain,5865,1253,19.99,4612
999660,SAMURAI SHODOWN NEOGEO COLLECTION,142,26,39.99,116
1338250,Nohra,261,9,0.0,252
1262580,Need for Speed™ Payback,8972,1327,29.99,7645
1302930,Cricket Captain 2020,62,31,9.99,31
960990,Beyond: Two Souls,11817,1473,19.99,10344
1262560,Need for Speed™ Most Wanted,8890,2453,19.99,6437
1222700,A Way Out,32094,4188,29.99,27906
1222670,The Sims™ 4,52059,7448,19.99,44611
1191840,Legend Creatures(传奇生物),3217,322,4.99,2895
1214360,SKYE,1081,93,0.0,988
1094820,Adabana Odd Tales,556,12,17.99,544
1047870,Something Ate My Alien,51,6,16.99,45
1222140,Detroit: Become Human,51168,4033,39.99,47135
1016790,West of Dead,793,283,19.99,510
1209040,Cyber Hunter,7304,2634,0.0,4670
1331530,Paws and Soul: First Step,39,28,0.0,11
753640,Outer Wilds,36098,1777,24.99,34321
1175430,Project Starship X,79,2,14.99,77
427880,P.A.M.E.L.A.®,529,328,24.99,201
1328570,Lighton,52,4,1.99,48
1068600,Waking,58,48,19.99,10
1238060,Dead Space™ 3,6020,1835,19.99,4185
1237970,Titanfall® 2,115504,6465,29.99,109039
1294230,Interrogation Files: Port Landsend,59,6,6.99,53
1189200,Moonlight Basket,41,2,6.99,39
1131410,Sable's Grimoire: Man And Elf,42,0,5.99,42
1173150,Goosebumps Dead of Night,27,12,29.99,15
1259560,Britannic: Patroness of the Mediterranean,580,67,14.99,513
1147940,3dSen PC,332,27,9.99,305
1271990,Premier Manager 09,2,0,2.99,2
1253680,Super Soccer Blast,79,29,7.99,50
1155460,The Academy: The First Riddle,43,21,5.99,22
1305050,Lightless,122,26,0.0,96
711980,Starship EVO,649,106,19.99,543
1311700,汉武大帝传,72,33,7.99,39
1174690,love wish 2,1015,247,1.99,768
1333410,Stream Racer,189,37,0.0,152
1174670,Nordic Warriors,42,6,19.99,36
1281270,Fatum Betula,245,13,5.99,232
1065180,Azure Striker Gunvolt 2,341,23,9.99,318
1146230,DungeonTop,407,73,15.99,334
590840,Attack of the Giant Mutant Lizard,23,2,1.99,21
1321270,Duck Life: Adventure,208,22,5.99,186
1286710,Hylics 2,1545,46,14.99,1499
1231950,The Innsmouth Case,67,25,2.49,42
1303990,Mini Motor Racing X,193,26,14.99,167
1049890,Little Witch Nobeta,7438,1510,9.99,5928
873840,Truck and Logistics Simulator,903,392,19.99,511
1163740,Card Hog,375,11,3.99,364
1302110,Inertial Drift: Sunset Prologue,374,69,0.0,305
1029760,TANKNAROK,96,7,6.99,89
969990,SpongeBob SquarePants: Battle for Bikini Bottom - Rehydrated,11471,591,29.99,10880
1296280,Car Trader Simulator - Welcome to the Business,279,158,0.0,121
1126750,Mr. DRILLER DrillLand,166,34,29.99,132
1166860,Rival Stars Horse Racing: Desktop Edition,1634,176,39.99,1458
1315200,Kingdom Under Fire: Heroes,238,68,19.99,170
1333190,Rescue Team: Danger from Outer Space!,26,0,6.99,26
1351450,Steel Fury Kharkov 1942,83,36,2.99,47
1303140,Escape Game Fort Boyard,13,0,24.99,13
1339410,雾之本境S Conspiracy Field: Fog Shadow,257,17,1.99,240
1323000,Space Court,126,2,2.99,124
679490,Lisa's Memory - 丽莎的记忆,258,43,7.99,215
656240,Heat,1406,1387,19.99,19
1281630,Anno 1404 - History Edition,1261,271,14.99,990
1115780,The Almost Gone,585,105,9.99,480
1262910,Heart's Medicine - Doctor's Oath,99,47,12.99,52
1272000,Premier Manager 08,2,0,2.99,2
1347490,箱庭小相撲,1,2,0.0,-1
1324070,Monolight,281,38,0.0,243
1279400,STRIKERS 1945 III,42,7,9.99,35
1325730,Keysight,28,2,29.99,26
1066890,Automobilista 2,4278,491,23.99,3787
1237610,The Catch: Carp & Coarse Fishing,179,79,14.99,100
1217930,VR Jetpack Game,31,9,0.0,22
1296560,Vectromirror 0™,357,65,0.0,292
1311250,Don't Be Afraid - The First Toy,646,65,0.0,581
1334040,Paper Dolls 2 纸人贰,1690,296,19.99,1394
1342340,MadGuns,256,177,0.0,79
1273710,King of Crabs,5923,1564,0.0,4359
315070,Blob From Space,35,108,1.99,-73
1334700,tomorrow won't come for those without ██████,451,19,1.99,432
1344790,Unsung Kingdom,54,6,0.0,48
1353120,ココロクローバー パート１/Kokoro Clover Part1,70,6,3.99,64
1311660,Friendly Fire,869,50,0.0,819
1322650,RITE,205,27,4.99,178
1355930,Escape the Clinic,275,109,0.0,166
1302800,Chair F*cking Simulator,483,30,1.99,453
1275350,Ninja Kiwi Archive,3300,225,0.0,3075
1362430,Lairchitect,28,18,2.99,10
594770,Legends of Aria,901,698,0.0,203
1211020,Wobbly Life,7579,246,13.99,7333
1264670,The Wind Road,4357,2061,29.99,2296
946050,Soda Dungeon 2,4252,223,0.0,4029
1361700,Half-Life: Alyx - Final Hours,736,36,9.99,700
981880,GrowRilla VR,54,6,14.99,48
1009290,SWORD ART ONLINE Alicization Lycoris,3571,2174,59.99,1397
1284080,Legion Gold,53,8,9.99,45
1080110,F1® 2020,36358,2556,59.99,33802
1330550,Magic Lessons in Wand Valley - a jigsaw puzzle tale,45,3,1.99,42
1265860,NASCAR Heat 5,1382,347,14.99,1035
980610,Quaver,8530,661,0.0,7869
1304660,Vagrus - The Riven Realms: Prologue,103,43,0.0,60
1336560,Hashiriya Drifter-Online Drift Racing Multiplayer (DRIFT/DRAG/RACING),664,342,4.99,322
1191580,Nexomon,1001,111,9.99,890
1325800,Viticulture Essential Edition,92,50,14.99,42
1225780,他人世界末 On-looker,1831,117,8.99,1714
1257360,Bloodstained: Curse of the Moon 2,948,122,14.99,826
1229900,ARIA CHRONICLE,871,225,17.99,646
1283220,Devolverland Expo,5055,608,0.0,4447
1020730,Dark Bestiary,411,39,11.99,372
1359300,Knights and Dungeons,90,26,0.0,64
1138080,斗地主少女/ Landlord Girls,1492,584,4.99,908
1333020,Roundabout 3,21,0,1.99,21
1233550,Rocket Arena,1152,719,4.99,433
788100,Neon Abyss,15937,1978,19.99,13959
1253870,ANIME STANDING,1472,207,0.99,1265
978780,STORY OF SEASONS: Friends of Mineral Town,3805,216,39.99,3589
1292630,3on3 FreeStyle: Rebound,1095,713,0.0,382
1201760,Kari,79,24,0.0,55
1263550,Combat Arms: the Classic,711,380,0.0,331
1209000,romantic player,315,87,2.99,228
1360670,MiniMap Kingdom,64,8,4.99,56
911680,REZ PLZ,29,4,14.99,25
1114130,My Koi,558,39,4.99,519
1180900,SGS Winter War,40,6,19.99,34
1072710,Soviet Jump Game,1184,239,0.0,945
1292910,Accident: The Pilot,460,203,0.0,257
1320550,The Call of Karen,827,224,0.0,603
1146310,Beyond a Steel Sky,813,108,34.99,705
1097770,Aeolis Tournament,68,13,14.99,55
1309860,Family Mysteries 3: Criminal Mindset,66,20,14.99,46
1096610,Incident Commander,42,30,19.99,12
1304320,重装无限·Metal Infinite,29,6,1.99,23
690040,SUPERHOT: MIND CONTROL DELETE,7812,1342,24.99,6470
1126600,Before I Forget,93,7,7.99,86
1135910,Hunting Simulator 2,317,196,39.99,121
1226530,Trap Legend,494,24,9.99,470
1352680,Winter War 1939,80,8,4.99,72
1349920,Caterpillarnoid,86,13,0.0,73
1259180,Ashina: The Red Witch: Prologue,156,20,0.0,136
1321070,Death Come True,561,157,15.99,404
880220,~Azur Ring~virgin and slave's phylacteries,132,65,13.99,67
1254900,迷雾之夏-The Vigilant Villa,749,183,7.99,566
1185680,White Wings ホワイトウィングス,58,73,19.99,-15
1366290,Kill It With Fire: HEATWAVE,1741,161,0.0,1580
1350850,Dreamland Solitaire: Dark Prophecy,17,4,6.99,13
492150,RPG World - Action RPG Maker,379,162,0.0,217
1348300,大千世界,1972,269,3.99,1703
1106750,Fault: Elder Orb,2306,1450,0.0,856
1096550,Desktop Magic Engine,573,205,3.99,368
732240,SpaceBourne,499,135,14.99,364
1361810,be you 2,71,14,0.0,57
1361580,Armoured Commander,25,5,0.0,20
1012790,Into the Radius VR,4226,361,29.99,3865
1326000,Sakura Succubus 2,211,24,9.99,187
975510,Panzer Paladin,313,104,19.99,209
1321010,Labyrinth Legend,30,4,6.99,26
1306110,Angkor: Celebrations,1,2,8.99,-1
1286830,STAR WARS™: The Old Republic™,39819,4369,0.0,35450
1292770,Grisaia Phantom Trigger Vol.7,89,10,24.99,79
1101360,Rock of Ages 3: Make & Break,547,199,29.99,348
1318090,Vertigo Remastered,695,50,24.99,645
1346890,Motoride Rollercoaster VR,48,14,3.99,34
291840,The Feud: Wild West Tactics,56,36,29.99,20
1306180,Retrocycles,108,7,0.0,101
1347430,Cute Honey,2161,354,1.99,1807
1322730,Endless Battle: Return of Hero +1,17,8,4.99,9
1073320,Meteorfall: Krumit's Tale,656,54,14.99,602
1362390,Ties,79,16,0.0,63
1349060,It Steals,440,4,4.99,436
956030,Creaks,2268,127,19.99,2141
725270,Necrobarista,942,169,19.99,773
1349230,5D Chess With Multiverse Time Travel,4879,146,11.99,4733
1292180,Krush Kill ‘N Destroy 2: Krossfire,136,47,6.99,89
1248460,Werewolves 2: Pack Mentality,31,1,5.99,30
1367320,Close Combat: Cross of Iron,62,13,39.99,49
1131740,Snowdome,210,15,6.99,195
672150,LOGistICAL 3: Earth,88,14,39.99,74
1228600,Blankspace,64,1,4.99,63
1364960,Hello Neighbor 2 Alpha 1.5,4384,727,0.0,3657
811620,Organosphere,31,9,0.0,22
1269810,The Curse of Kubel,296,104,14.99,192
1292170,Krush Kill 'N Destroy Xtreme,89,28,6.99,61
1067540,Röki,1707,150,19.99,1557
1349960,[Chilla's Art] The Ghost Train | 幽霊列車,249,64,2.99,185
708720,Gridiron,1598,359,0.0,1239
953490,CARRION,15683,930,19.99,14753
1232570,Paper Beast,443,16,19.99,427
1344350,SUCCUBUS: Prologue,4261,902,0.0,3359
1276550,Faefever,328,46,0.0,282
1058770,我来自江湖 From Jianghu,1482,403,7.99,1079
1348180,From Frontier,202,1,15.99,201
1264520,Vibrant Venture,433,7,9.99,426
830820,Jets'n'Guns 2,983,80,14.99,903
1010100,Airborn,84,9,8.44,75
1179680,Wurm Online,934,634,0.0,300
1250520,Love Spell: Written In The Stars - a magical romantic-comedy otome,111,8,18.99,103
1316760,Suicide Guy VR,61,34,6.99,27
1059120,Kinoko,762,136,0.0,626
1305420,Agrou,1971,226,4.99,1745
1361860,Toilet Management Simulator,206,66,6.99,140
1047010,Synergia,433,58,11.99,375
1368340,Beneath a Steel Sky,272,27,0.0,245
798490,Othercide,2766,568,11.99,2198
962730,Skater XL - The Ultimate Skateboarding Game,14680,2317,39.99,12363
826940,Maid of Sker,882,205,24.99,677
1370570,First Person Shooter Kit Showcase,37,7,0.0,30
1259510,Venge,242,17,1.99,225
1210150,Ageless,156,119,14.99,37
443000,DUAL GEAR,239,66,19.99,173
962130,Grounded,31124,4774,29.99,26350
1312760,Dreams Keeper Solitaire,3,2,5.99,1
1139980,Travellers Rest,2883,273,11.99,2610
1102370,Dr. Derk's Mutant Battlegrounds,17,6,4.99,11
803330,Destroy All Humans!,7741,544,29.99,7197
1352440,Brick Building,24,16,0.0,8
1327820,The Lost Art of Innkeeping,67,0,4.99,67
1279590,Fritz Chess 17 Steam Edition,39,26,59.99,13
1236720,Spirit Island,487,41,24.99,446
1233260,FAIRY TAIL,996,413,59.99,583
889710,Muv-Luv photonmelodies♮,133,19,29.99,114
1213750,Fight Crab,669,54,19.99,615
1238730,Flowers -Le volume sur automne-,485,2,19.99,483
1238360,Into A Dream,50,5,11.99,45
616700,Rage of Car Force: Car Crashing Games,625,195,0.0,430
1144970,Necronator: Dead Wrong,329,129,19.99,200
875310,LIBERATED,428,124,19.99,304
1183470,Imperiums: Greek Wars,273,46,29.99,227
628670,Hellpoint,2626,884,34.99,1742
1203360,Core Defense,260,59,2.49,201
1350340,Simp Simulator,203,36,0.99,167
611160,Karnage Chronicles,995,153,24.99,842
805590,ARMORED HEAD,674,4,4.99,670
1371350,Solenars Edge II: Champions,3,7,2.99,-4
1178780,BattleGroupVR,614,45,24.99,569
1278500,Tower! 3D,34,21,4.49,13
1310510,Handy Harry's Haunted House Services,471,60,4.99,411
1360430,Lapso: NIMBO,98,9,0.0,89
1357610,Desktop Farm,460,159,2.99,301
995980,Fae Tactics,964,160,19.99,804
892990,Sable's Grimoire: A Dragon's Treasure,49,0,5.99,49
1305000,Kingdom Karnage,20,9,0.0,11
612240,Tank games Zoo War: Battle Royale online,30,29,0.0,1
1349000,Jigsaw Puzzle - Animals,26,1,0.99,25
987020,DRONE The Game,866,427,19.99,439
1367720,General War Memories,13,15,0.0,-2
1194840,Frog Fractions: Game of the Decade Edition,1917,98,0.0,1819
1314460,Flicker of Hope,761,50,0.0,711
941570,Relicta,216,95,3.99,121
822800,Soulfire,619,229,6.99,390
1351170,東方催狐譚 ～ Servants of Harvest Wish,289,11,0.0,278
1279420,Dragon Blaze,39,1,9.99,38
1261180,Rebirth Online,112,171,0.0,-59
723410,Doomtrooper CCG,107,32,0.0,75
1313810,Her Lie I Tried To Believe - Extended Edition,37,0,5.99,37
1380260,Space Empires: Starfury,5,2,9.99,3
1249110,Skully,113,76,29.99,37
1236900,Verdant Village,44,3,14.99,41
753590,Hellbound,643,328,14.99,315
1302860,Assembly Planter,134,15,4.99,119
1254360,街机捕鱼Arcade Fishing,249,101,0.0,148
894940,Littlewood,5188,307,14.99,4881
1002000,SPITLINGS,29,4,14.99,25
874390,The Battle of Polytopia,2481,123,14.99,2358
1373920,Sword Rogue,358,13,0.0,345
383120,Empyrion - Galactic Survival,22599,5360,19.99,17239
1285210,CasinoLife Poker - #1 Free Texas Holdem 3D,68,36,0.0,32
1343680,1001 Jigsaw: Earth Chronicles 2,7,2,4.99,5
1384770,Scrutinized,706,85,9.99,621
1056640,Phantasy Star Online 2 New Genesis,14256,5460,0.0,8796
1378290,The Citadel,561,33,14.99,528
1293860,The Riftbreaker: Prologue,3890,168,0.0,3722
1351400,Canvas Hockey,30,1,0.99,29
551620,Approaching Infinity,166,13,12.99,153
1354300,Club Soccer Director 2021,74,58,0.0,16
1133330,Helicopter Simulator,93,47,24.99,46
1056690,Drink More Glurp,110,12,9.99,98
1285670,Post Void,6696,159,2.99,6537
1269820,Kozue's Strange Journey,157,18,14.99,139
1066130,Truck Life,858,573,6.99,285
1302780,Zombo Buster Advance,126,22,4.99,104
1356180,Mahjong Nagomi,146,32,4.99,114
1340470,Wait! Life is Beautiful! Prologue,392,45,0.0,347
1240210,There Is No Game: Wrong Dimension,16479,321,12.99,16158
1366610,Fox Simulator,21,2,3.99,19
656350,UnderMine,6883,511,19.99,6372
1318130,Robin Hood: Winds of Freedom,18,2,6.99,16
1360000,The Infected,3874,533,13.99,3341
1339460,Dinosaur Fossil Hunter: Prologue,506,123,0.0,383
1089980,The Henry Stickmin Collection,31088,411,14.99,30677
1326700,CHRONOSHOT,356,51,0.0,305
1368750,Jigsaw Puzzles: Master Artists of Old,5,0,0.0,5
1343660,True Detective Solitaire,4,1,4.99,3
1014580,RB: Axolotl,36,5,9.99,31
1338420,A Night In Berlin,325,64,0.0,261
1368950,VTuber Maker,711,174,0.0,537
1151640,Horizon Zero Dawn™ Complete Edition,67572,10829,49.99,56743
1267470,Warriors of the Nile,1934,501,12.99,1433
1337820,Emergence,70,13,0.0,57
1286340,Daily Wife,533,128,1.49,405
1229420,Company of Crime,85,84,19.99,1
1294220,"Learn Game Development, Unity Code Monkey",95,14,0.0,81
1369470,Pincremental,349,88,0.0,261
1376890,Drill Deal: Borehole (Alpha),318,48,0.0,270
1308250,Knight Bewitched 2,19,0,4.99,19
1363690,Fantastic Contraption Classic 1 & 2,47,1,9.99,46
1096560,Windy Kingdom,65,61,14.99,4
632360,Risk of Rain 2,199048,7354,24.99,191694
1097110,Willy Morgan and the Curse of Bone Town,270,29,19.99,241
917150,Godhood,679,237,26.99,442
1314270,Adventure mosaics. Small Islanders,2,0,5.99,2
1371630,Incremental Adventures,490,113,0.0,377
1025410,Metamorphosis,385,60,24.99,325
1235110,Rising Star 2,322,16,29.99,306
1359090,Zero Hour,17947,4248,11.99,13699
1383630,Antarctica 88,109,14,5.99,95
591460,Parkasaurus,2291,129,24.99,2162
1282930,Volta-X,24,9,19.99,15
1258020,SNIKS,29,0,2.99,29
349730,Popup Dungeon,665,203,24.99,462
1347420,One Way: The Elevator,236,13,3.99,223
1342740,Moose Life,79,2,6.99,77
1338980,Chess Knights: Viking Lands,56,6,2.99,50
1302050,Milky Way Prince – The Vampire Star,208,44,14.99,164
1220370,Ever Forward,191,36,14.99,155
965680,Boomerang Fu,1198,47,14.99,1151
1314820,RealFlight Trainer Edition,58,12,39.99,46
1146600,For the People,427,129,16.99,298
432210,The Revenant Prince,14,3,3.99,11
1179210,Kill It With Fire,2531,160,14.99,2371
1377260,Miracle Sudoku,131,9,4.99,122
589670,Double Kick Heroes,177,32,19.99,145
1075550,Bite the Bullet,42,30,14.99,12
1366720,Vidiot Game,156,18,0.0,138
1265870,Cave Digger PC Edition,39,13,14.99,26
1370410,Progress Game,273,21,0.0,252
1058270,Inn Legend,208,27,7.99,181
1333350,Angel Legion,2183,225,0.0,1958
1202870,The Heiress of Sorcery,94,13,9.99,81
1390010,pyramida,406,60,2.99,346
427520,Factorio,145186,5216,30.0,139970
1214410,Zooma VR,215,14,5.99,201
1336160,Chupa Chupa VR,79,9,10.99,70
1103950,ANAREA Battle Royale,838,1004,0.0,-166
325260,PANZER BALL,1101,130,4.99,971
1367950,Aeloren Tactics,3,2,9.99,1
1383500,客栈江湖-Vagabond Inn,37,22,1.99,15
1201240,BLEACH Brave Souls,4998,725,0.0,4273
610730,The Chosen Warriors,60,23,0.99,37
412220,DDraceNetwork,8050,492,0.0,7558
1257930,Zero Tolerance,34,8,4.19,26
1095120,Helheim Hassle,136,8,19.99,128
1386040,Jelly Brawl: Classic,239,100,0.0,139
972660,Spiritfarer®: Farewell Edition,20617,891,29.99,19726
1266220,Death end re;Quest 2,241,117,39.99,124
1316800,Destropolis,131,10,5.99,121
1362420,Siege Survival: Gloria Victis Prologue,809,107,0.0,702
1247020,Lovingly Evil,76,9,12.99,67
1094420,Rainy Season,380,22,3.99,358
1368860,像素女友,1161,15,0.0,1146
1259430,First Snow,473,30,0.0,443
1125330,Griefhelm,206,66,19.99,140
1124050,Ogre Tale,60,44,19.99,16
1306750,黑色花与红山羊 / Black Datura & Red Goat,363,13,7.99,350
1390380,Wolf's Gang,106,10,0.0,96
1162280,Eternal Hope,175,18,11.99,157
1282590,Train Sim World® 2,5769,1196,19.99,4573
1244950,Battletoads,1151,500,19.99,651
886900,Chef: A Restaurant Tycoon Game,824,293,19.99,531
788630,Gaia Beyond,150,45,14.99,105
1310520,Occupy Mars: Prologue (2020),1022,261,0.0,761
1230560,Cyber Attack,105,33,4.99,72
1013310,Peaky Blinders: Mastermind,555,160,4.99,395
1016120,PGA TOUR 2K21,5409,1062,14.99,4347
692890,Roboquest,3591,213,19.99,3378
1388370,Heroic Armored Company,96,63,16.99,33
1080410,Bake 'n Switch,63,18,14.99,45
1380390,Dread X Collection 2,350,13,9.99,337
1077630,Australian Football Coach 2020,23,10,14.99,13
1379900,Shikokushi ~food and sightseeing and beauties~,52,9,19.99,43
1328910,Otome the Exorcist,75,21,14.99,54
1257910,DethKarz,40,2,6.99,38
1204700,Pangea Survival,43,28,19.99,15
1150590,Samurai Jack: Battle Through Time,912,148,39.99,764
938560,INMOST,3126,285,14.99,2841
1038300,New Super Lucky's Tale,171,8,29.99,163
1375530,Exo One: Prologue,668,35,0.0,633
1261040,Streamer Life Simulator,3979,1037,19.99,2942
1155880,The Bonfire 2: Uncharted Shores,167,83,11.99,84
375480,Chronicon,7097,331,13.99,6766
611770,Void Source,79,20,4.99,59
1069760,Ethereal Enigma,431,22,19.99,409
1373780,Bakery Magnate: Beginning,592,104,0.0,488
1352330,Zoo 2: Animal Park,671,157,0.0,514
1225840,BeatBeat,32,1,14.99,31
1120560,Sense - 不祥的预感: A Cyberpunk Ghost Story,392,83,19.99,309
909320,Ruinarch,705,173,24.99,532
1178160,Blackjack Championship,371,186,0.0,185
1233800,Kandagawa Jet Girls,210,33,39.99,177
1251980,Jessika,118,43,2.49,75
1389160,Dark Fracture: Prologue,912,150,0.0,762
893840,Roll for the Galaxy,96,5,14.99,91
45200,Defense of the Oasis,31,3,4.99,28
1392820,Milk inside a bag of milk inside a bag of milk,12226,339,0.99,11887
1281790,SHEEPO,166,2,4.99,164
575430,VR Home,19,13,7.99,6
1363490,Dragon Spirits : Prologue,98,0,0.0,98
1004330,My Exercise,326,21,2.99,305
1385730,Mosaique Neko Waifus 3,1360,66,1.99,1294
1377380,Night of the Dead,5712,1335,24.99,4377
1340530,Mr. Prepper: Prologue,1978,383,0.0,1595
856990,A Long Way Down,149,63,17.99,86
1392170,Schastye,117,52,0.99,65
1352020,Yupitergrad 🚀(Virtual Reality Adventure),49,3,14.99,46
1303740,Love n Dream,231,65,1.99,166
1096900,RPG Maker MZ,790,194,47.99,596
958400,Project CARS 3,1651,1422,59.99,229
1385780,My Village Life,133,12,11.99,121
870780,Control Ultimate Edition,27911,3700,39.99,24211
746560,Gadgeteer,106,2,14.99,104
1332470,Gladiator Guild Manager: Prologue,1394,86,0.0,1308
1078200,Spirits Abyss,290,9,9.99,281
936500,Transport INC,513,178,11.99,335
719040,Wasteland 3,12712,2457,39.99,10255
536270,Ancestors: The Humankind Odyssey,4734,1403,39.99,3331
1361110,Karen: An Outrage Simulator,177,9,2.99,168
1391600,Anime Jigsaw Puzzles,5,0,3.99,5
1180660,Tell Me Why,6890,1256,19.99,5634
1035560,Struggling,456,74,14.99,382
680830,Wait! Life is beautiful!,140,42,4.99,98
1287590,Tour de France 2020,157,42,19.99,115
1034850,Best Friend Forever,112,37,19.99,75
1024480,Immortal Realms: Vampire Wars,274,168,29.99,106
1162130,Windbound,468,346,19.99,122
1359470,Kawaii Girl 2,163,94,1.99,69
1396260,FALAFEL Restaurant Simulator,74,38,14.99,36
1393410,Seek Girl V,612,252,1.99,360
1263370,Seek Girl:Fog Ⅰ,3521,640,3.99,2881
1103730,Shing!,184,55,19.99,129
1377150,Operation: Tango - Friend Pass,1072,148,0.0,924
640860,Stone Rage,91,68,11.99,23
1300310,Move Code Lines,36,5,5.99,31
987150,BMX The Game,344,200,24.99,144
1340120,IxSHE Tell,120,9,29.99,111
1239520,Madden NFL 21,2576,2586,0.0,-10
1196630,Nexomon: Extinction,1962,151,19.99,1811
826630,Iron Harvest,7895,3097,29.99,4798
1133580,Snapshot VR,75,10,19.99,65
1369370,Combat Mission Shock Force 2,497,82,59.99,415
1240630,Hex of Steel,221,6,24.99,215
1378940,Verdungo,29,3,7.99,26
1357870,Metel - Horror Escape,284,17,1.99,267
1246950,Where in the World is Carmen Sandiego?,43,16,9.99,27
1142830,9-nine-:Episode 3,330,26,19.99,304
1386730,Wordle 2,92,15,3.99,77
816430,Radical Relocation,126,40,9.99,86
1397010,1980,484,60,0.0,424
1247940,Greyhat - A Digital Detective Adventure,127,9,9.99,118
1393830,INFLUXIS,58,24,0.0,34
1158310,Crusader Kings III,71574,5380,49.99,66194
1318560,Husbandry,77,18,1.99,59
1395560,Kandidatos,2535,248,0.99,2287
1390300,Stream Arenas,38,3,0.0,35
1325470,Pianistic,170,25,4.99,145
935570,Ary and the Secret of Seasons,99,59,39.99,40
1389630,High Entropy: Challenges,839,43,0.0,796
1393500,Time Break Chronicles,110,7,14.99,103
1325870,Kotel Ne Gori: A Friend of Lena Boots,61,3,0.99,58
1353100,SCP: The Foundation,155,156,0.0,-1
1086860,TOUHOU SKY ARENA MATSURI CLIMAX,138,15,39.99,123
1401610,Leons Identität,70,37,0.0,33
1363560,Shattered Worlds,5,0,6.99,5
1391000,Scrapyard  Simulator,211,236,0.0,-25
794240,Spinch,114,46,14.99,68
897410,Esports Life Tycoon,310,178,19.99,132
1225330,NBA 2K21,16140,22709,59.99,-6569
916180,Doodle Derby,54,20,0.89,34
1282210,DEEMO -Reborn-,2511,358,24.99,2153
1229490,ULTRAKILL,27319,250,19.99,27069
1291540,Cartridge Defense,41,0,11.99,41
1379130,League of Angels-Heaven's Fury,322,242,0.0,80
1379110,Anime Feet,124,24,1.99,100
956540,Color Phase,32,16,0.0,16
1330790,Hunting Unlimited 2,3,0,9.99,3
1160220,Paradise Killer,2388,154,19.99,2234
1367690,Tony Stewart's All-American Racing,109,24,29.99,85
1214520,Pro Gymnast Simulator,75,8,14.99,67
1307550,Craftopia,12448,2942,24.99,9506
997070,Marvel's Avengers,17741,8922,39.99,8819
1379970,Solar System VR,160,52,3.99,108
1301720,Escape Room - Der kranke Kollege,6867,819,0.0,6048
1323420,H-SNIPER: World War II,763,98,0.99,665
556530,Faerie Solitaire Dire,30,10,19.99,20
566440,Necromunda: Underhive Wars,1428,1072,19.99,356
1281170,Pro Strategy Football 2021,90,15,14.99,75
891480,Idle Expanse,69,59,0.0,10
1198740,Colony Siege,176,15,9.99,161
1398030,永夜之冬,35,7,0.0,28
1351370,Sakura Knight 3,41,11,9.99,30
1304550,Progressbar95,1055,53,4.99,1002
1388490,Capital Simulator,28,19,5.99,9
1248800,The Rule of Land: Pioneers,213,86,10.99,127
810040,Swords 'n Magic and Stuff,756,46,19.99,710
1041720,Kingdoms of Amalur: Re-Reckoning,3521,1223,39.99,2298
651670,Star Renegades,1783,300,24.99,1483
1004750,WRC 8 FIA World Rally Championship,648,241,29.99,407
1301620,Cross Princess,671,23,2.99,648
609920,Hotshot Racing,931,340,3.99,591
860900,Bounty Battle,15,34,19.99,-19
658830,Artificer: Science of Magic,49,21,9.99,28
1206430,The Unfinished Swan,783,132,14.99,651
1045580,Deleveled,239,61,2.59,178
1376070,Rushdown Revolt,1000,164,0.0,836
1119700,As Far As The Eye,1358,436,24.99,922
1387560,Educational Games for Kids,18,4,12.99,14
1375870,川建国同志想要连任/Comrade Trump's Re-election,997,124,2.99,873
1237490,Redneck Ed: Astro Monsters Show,34,28,4.99,6
1233880,Disgaea 4 Complete+,546,58,39.99,488
1052990,A Monster's Expedition,843,35,19.99,808
1279630,Vampire: The Masquerade - Shadows of New York,733,234,12.99,499
1022980,Ostranauts,414,128,19.99,286
1103880,Bullet Roulette VR,346,62,7.99,284
1323860,Crowded Blue Dot,32,17,5.99,15
1270390,The Golem,29,2,9.99,27
1307090,Barro Racing,294,74,0.99,220
1184480,Inertial Drift,498,44,19.99,454
856850,AFL Evolution 2,110,29,49.99,81
780670,Fantasy of Expedition,529,117,9.99,412
919260,Final Upgrade,197,38,15.99,159
1384700,A Gay Love Story About Gay Love,356,55,0.99,301
1397350,好久不见 - Long Time No See,168,57,4.99,111
1259970,eFootball PES 2021 SEASON UPDATE,28442,8712,0.0,19730
1375930,Minesweeper: Collector,53,6,7.99,47
1217380,Encore Classic Puzzle & Board Games,16,9,19.99,7
1409640,Tomato Way 3,49,8,14.99,41
1161880,Vaporum: Lockdown,186,28,17.99,158
1286350,BPM: BULLETS PER MINUTE,7888,704,19.99,7184
1246930,Encore Classic Card Games,22,3,19.99,19
1352930,HAAK,193,28,17.99,165
1408110,The Grounding,614,77,0.99,537
1229310,Godking: Master of Rituals,33,16,29.99,17
1383770,Interstate Drifter 1999,233,11,0.0,222
578690,Dog Duty,90,17,9.99,73
1399660,My Little Prince - a jigsaw puzzle tale,54,2,1.99,52
1373220,Live the Life,212,112,19.99,100
1410580,Wave of Time,21,2,5.99,19
1015940,Welcome to Elk,172,5,14.99,167
1386790,Gordian Rooms: A curious heritage Prologue,85,10,0.0,75
1387170,Similo: The Card Game,23,7,2.99,16
1142100,WWE 2K BATTLEGROUNDS,469,350,39.99,119
573090,Stormworks: Build and Rescue,26542,2272,24.99,24270
1336060,TAISHO x ALICE episode 2,271,30,9.99,241
1411800,"Goodnight, Lily",69,18,0.0,51
757320,Atomicrops,974,81,14.99,893
804530,Cubism,39,0,9.99,39
725480,Slap City,2592,139,19.99,2453
970830,The Dungeon Of Naheulbeuk: The Amulet Of Chaos,4729,583,34.99,4146
1364130,Chaotic Airport Construction Manager,188,22,7.99,166
1145360,Hades,190880,2662,24.99,188218
1379930,Power & Revolution 2020 Edition,514,286,49.99,228
1054490,Wingspan,5186,317,19.99,4869
1398590,1001 Jigsaw World Tour Asia,3,2,0.49,1
839910,Mythgard,1096,164,0.0,932
739630,Phasmophobia,441220,13579,13.99,427641
953690,Doom & Destiny Worlds,69,22,19.99,47
1408700,Osman Gazi,56,17,2.99,39
1186460,Songs Of Wuxia,454,108,6.99,346
1146970,My Vow to My Liege,2946,152,9.99,2794
1162750,Songs of Syx,1715,56,24.99,1659
1263510,Spy Story. The Elusive Evidence,1,1,0.49,0
1347780,Freedom Fighters,1002,46,0.0,956
1407860,Space Travel Idle,308,143,0.0,165
1417010,Shrine II,564,39,0.0,525
1240050,Pendragon,71,34,16.99,37
1164050,When The Past Was Around,2372,96,7.99,2276
474220,Soldat 2,286,34,14.99,252
1285080,Gordian Rooms 1: A curious heritage,290,31,2.99,259
910830,Rebel Galaxy Outlaw,429,242,29.99,187
994910,Poker Master,652,58,0.0,594
1394090,Power of Ten - Demo,46,1,0.0,45
1311510,Embracelet,77,4,12.99,73
1404130,Gothic Murder: Adventure That Changes Destiny,34,1,11.99,33
1157940,Gnomes & Goblins,80,31,19.99,49
550320,art of rally,3314,208,24.99,3106
393380,Squad,97784,13416,49.99,84368
939100,Darksburg,1511,750,14.99,761
1406140,Wiggly Boy,41,2,1.0,39
1016920,Unrailed!,12513,901,19.99,11612
837470,Untitled Goose Game,10728,478,19.99,10250
1408060,Idle Armada,29,4,3.99,25
1130410,Cyber Hook,1502,80,14.99,1422
885910,Ginga Force,60,4,7.99,56
1223910,Tennis World Tour 2,104,139,39.99,-35
1290270,Vampire: The Masquerade — Night Road,422,46,9.99,376
745970,Terminal Conflict,42,14,29.99,28
363360,Interstellar Rift,1041,414,6.79,627
1206480,Swordsman VR,253,98,19.99,155
1030840,Mafia: Definitive Edition,37900,5785,39.99,32115
1375740,Surviv.io - 2D Battle Royale,1719,614,0.0,1105
1368820,RollerCoaster Tycoon® 3: Complete Edition,886,177,7.99,709
1329540,CROSSBOW: Bloodnight,252,48,2.99,204
965580,Root,2111,173,14.99,1938
1376690,蜀山幻剑录 Sword of Shushan,54,49,9.99,5
1154810,Going Under,2328,200,4.99,2128
257420,Serious Sam 4,10079,2056,39.99,8023
1363430,Propagation VR,3806,195,0.0,3611
1178880,Panzer Dragoon: Remake,420,87,24.99,333
1412170,Janosik - Highlander Precision Platformer,415,29,0.0,386
1411860,Invasion: Lost in Time,16,12,5.39,4
1265220,Cauldrons of War - Barbarossa,105,9,11.24,96
1024650,Port Royale 4,830,575,39.99,255
1359650,The Last of Waifus,1116,243,1.99,873
1416190,Fatiao发条：自动化工具,4,0,0.99,4
1411030,Square Game,26,0,0.0,26
1389560,Paint Girl,582,93,1.99,489
567080,Wizards and Warlords,173,24,14.99,149
1062960,UNDER the SAND - a road trip game,619,311,9.99,308
1406040,Scarlet Hollow — Episode 1,560,13,0.0,547
1400510,"Castle Rock Beach, West Australia",310,44,0.0,266
654690,Bermuda - Lost Survival,273,194,9.99,79
1172050,COCKHEAD,474,258,6.99,216
1163550,Captain Tsubasa: Rise of New Champions,2273,1281,59.99,992
1384380,KUUKIYOMI 2: Consider It More! - New Era,65,11,4.99,54
794960,The Sojourn,105,31,24.99,74
418530,Spelunky 2,13950,1007,19.99,12943
662960,Mysteria ~Occult Shadows~,2082,1009,12.99,1073
1363770,Escape Quest,172,51,2.99,121
726490,Projection: First Light,19,3,19.99,16
1228870,Bartlow's Dread Machine,43,6,14.99,37
1082680,The Walking Dead Onslaught,377,518,29.99,-141
1382200,Liquidators,602,29,0.0,573
1381530,Mess Adventures,349,85,2.99,264
1005460,NationWar2:Chronicle,251,58,15.99,193
1397920,Mr.Mine,10604,885,0.0,9719
1401220,冷血症骰子,180,16,7.99,164
1399370,Cute Honey 2,1049,319,1.99,730
1373180,The Sea Hotel☆Umineko Tei,43,7,6.99,36
1419730,Seek Girl Ⅵ,878,226,1.99,652
1344740,FOOTSIES Rollback Edition,312,7,3.99,305
1222730,STAR WARS™: Squadrons,15678,7033,9.99,8645
1064010,Escape until Friday,143,25,4.99,118
914010,Train Station Renovation,1860,390,18.99,1470
1416160,安堂的心理咨询室：杯中之心〈ANDOU：Pulse of cup〉,61,17,0.0,44
739650,Drake Hollow,1064,269,29.99,795
1346070,Sign of Silence,1050,944,4.99,106
1392030,Draft Day Sports: Pro Football 2021,30,17,19.99,13
1045430,Circadian City,104,38,11.99,66
1422200,Rev,31,5,3.99,26
1205260,Defeated Girl,282,55,1.99,227
711380,Code of Princess EX,24,13,19.99,11
1419480,Love's Sweet Garnish 2,97,5,16.99,92
1377360,Vampires' Melody,2612,58,3.99,2554
1257890,The Legacy: Realm of Terror,4,0,6.99,4
1219950,Evil Democracy: 1932,367,109,11.99,258
931000,URUZ Return of The Er Kishi,336,74,9.99,262
1385950,Guilt Free,177,28,0.0,149
1424630,CosmoDreamer,58,0,7.99,58
1395850,Home and Dungeon,211,26,16.99,185
1394800,Rebirth:Mr Wang,1536,395,3.99,1141
1335200,Action Taimanin,11174,1900,0.0,9274
1414480,Zof,36,4,14.99,32
1154850,9th Dawn III,362,45,15.99,317
1421020,Simple FPS Aim Trainer,44,5,1.99,39
1429740,Raji: Prologue,469,59,0.0,410
1075190,A Game of Thrones: The Board Game - Digital Edition,1022,376,19.99,646
1428820,Wordle 3,136,28,3.99,108
1424980,The Solitaire Conspiracy,581,58,11.99,523
726110,Overcrowd: A Commute 'Em Up,1160,220,19.99,940
1086940,Baldur's Gate 3,45069,6614,59.99,38455
1369320,Virtual Cottage,6310,134,0.0,6176
1422150,PP Puncher,24,2,0.0,22
1419100,The Unexpected Quest Prologue,68,16,0.0,52
1417640,Stella Voyager,5,0,4.99,5
951750,I Am Dead,195,34,19.99,161
341170,Adventures of Chris,94,12,14.99,82
1285020,Flipon,68,3,3.99,65
854940,Ikenfell,757,75,19.99,682
1283190,Neighbours back From Hell,2686,196,14.99,2490
925570,The Uncertain: Light At The End,511,269,1.89,242
1313860,EA SPORTS™ FIFA 21,43290,13629,0.0,29661
1420740,Your amazing T-Gotchi!,224,107,4.99,117
1314410,Rugby Union Team Manager 3,41,19,39.99,22
541930,Panoptic,252,10,11.89,242
1075080,Falcon Age,125,35,19.99,90
1425110,Space Empires I,3,3,1.99,0
1259980,RIDE 4,4806,1294,49.99,3512
1390680,Music Maker (64 Bit) Steam Edition,74,100,0.0,-26
1063040,Ben 10: Power Trip,114,19,29.99,95
1056720,Knight Club +,218,25,0.0,193
1409730,Hero of Not Our Time,104,41,5.99,63
897450,The Survivalists,3529,1139,24.99,2390
1377540,The Viking Way,144,171,14.99,-27
1288930,Hargrave,203,15,0.0,188
1369340,Cats Organized Neatly,1934,32,2.09,1902
1388230,DANMAKAI: Red Forbidden Fruit,73,3,9.99,70
904400,Cardpocalypse,131,14,24.99,117
1428310,The Test: Final Revelation,4378,73,1.99,4305
1403750,街机金蟾捕鱼2,21,34,0.0,-13
1211110,Petal Crash,240,4,9.99,236
1286730,Epicinium,225,28,0.0,197
1138960,Biomass,78,9,14.99,69
1142390,Remothered: Broken Porcelain,362,281,29.99,81
1430140,Space Empires II,4,3,2.99,1
1422630,Active Neurons - Wonders Of The World,89,4,0.0,85
1342620,Werewolf: The Apocalypse — Heart of the Forest,589,110,5.99,479
1111380,ROBOTICS;NOTES ELITE,276,19,34.99,257
1140630,Red Wings: Aces of the Sky,469,178,19.99,291
1421120,Montezuma's Revenge,44,4,2.99,40
1024380,Second Extinction™,3715,1410,24.99,2305
1398390,SPACE / MECH / PILOT,292,48,0.0,244
1030210,Torchlight III,4796,5419,39.99,-623
1263520,Dark Solitaire. Mystical Circus,3,0,4.99,3
1111390,ROBOTICS;NOTES DaSH,97,35,34.99,62
1049590,Eternal Return,34056,8199,0.0,25857
912900,Bunker Defense,20,2,24.99,18
1343400,RuneScape ®,15978,2183,0.0,13795
1195360,Re:Turn - One Way Trip,88,26,11.99,62
1292940,Cube Escape Collection,3694,55,4.99,3639
1211630,The Jackbox Party Pack 7,3276,110,29.99,3166
1227530,Partisans 1941,4690,925,5.99,3765
1175140,Vecter,2694,93,0.0,2601
1000030,"Cook, Serve, Delicious! 3?!",1503,104,19.99,1399
1030430,ARCADE,17,2,2.99,15
1329080,BORIS THE ROCKET 🚀,83,0,9.99,83
971690,Cake Bash,205,21,13.99,184
1266560,鋼鉄戦記C21,54,32,0.0,22
1374290,Palindrome Syndrome: Escape Room,259,47,9.99,212
1420050,Loot Grind Simulator,250,64,0.0,186
867400,Out of Reach: Treasure Royale,260,173,1.49,87
720560,Vigil: The Longest Night,2350,306,21.99,2044
1232460,Onee Chanbara ORIGIN,621,243,59.99,378
1367550,Kingdom Rush Vengeance - Tower Defense,4964,241,19.99,4723
717560,Lucifer Within Us,268,71,19.99,197
931310,Airplane Mode,151,97,11.99,54
1266800,Adorable Crush,423,122,2.99,301
1176710,Space Crew: Legendary Edition,1132,310,9.99,822
933110,Age of Empires III: Definitive Edition,22125,5688,19.99,16437
1328920,Mira and the Mysteries of Alchemy,86,25,19.99,61
1082930,The Signifier Director's Cut,172,30,19.99,142
1429100,Siren Head: The Siren's Forest,172,166,0.0,6
1405440,The Horror Of Salazar House,181,3,3.99,178
998740,Ring of Pain,3040,286,19.99,2754
1096640,Vital Signs: Emergency Department,28,19,0.0,9
1420830,Happy Numbers,303,36,1.99,267
1393820,Prodigal,125,4,14.99,121
1348390,I am an Air Traffic Controller 4,236,44,59.99,192
1330890,Crystal Caves HD,215,2,7.99,213
837460,Batbarian: Testament of the Primordials,166,26,19.99,140
461510,Tears of Avia,42,35,14.99,7
881100,Noita,43235,2071,19.99,41164
907710,This is the Zodiac Speaking,33,23,12.99,10
704030,Professional Farmer: Cattle and Crops,1149,503,19.99,646
1206670,Drive 4 Survival,183,43,19.99,140
1209360,Monster Truck Championship,94,43,39.99,51
1232640,Alpaca Ball: Allstars,66,4,19.99,62
1404530,RoboSkate,77,11,3.49,66
730390,Raji: An Ancient Epic,1344,206,24.99,1138
1210230,Suits: Absolute Power,121,7,4.99,114
1216350,Time Hacker,27,6,14.99,21
1356530,Mystery Hotel - Hidden Object Detective Game,35,10,4.99,25
739080,9 Monkeys of Shaolin,495,66,19.99,429
1264250,Fishing: North Atlantic - Enhanced Edition,1380,475,34.99,905
1388130,Religion inc God Simulator,48,15,4.99,33
1224600,G String,554,104,17.99,450
1433890,Lawnmower Game: Racing,73,19,0.49,54
1000010,Crown Trick,3861,599,5.99,3262
1176050,秘封旅行 ~ Secret Sealing Travel,215,0,5.99,215
1434880,ROBO OH,32,0,1.99,32
1430420,CBT With Yuuka Kazami,678,16,0.99,662
1397470,Tsuro - The Game of The Path,98,4,9.99,94
1088150,Scribble It!,5274,815,0.0,4459
567630,Blood of Steel,4611,1322,0.0,3289
1415140,Kandidatos Kart,456,54,0.99,402
1270010,Gone: Survival,55,73,6.99,-18
999220,Amnesia: Rebirth,4916,1493,29.99,3423
473950,Manifold Garden,3275,129,19.99,3146
710220,DreadStar: The Quest for Revenge,31,6,14.99,25
598730,Shakedown: Hawaii,269,26,19.99,243
1403830,Paper Beast - Folded Edition,76,8,16.99,68
401760,Drone Swarm,144,69,24.99,75
1236240,Zero IDLE,203,72,0.0,131
1209990,烈山海一(BMS1),114,32,12.99,82
1015140,10 Miles To Safety,629,214,9.99,415
1383740,My Cute Commissar,255,29,1.99,226
1061610,Tenderfoot Tactics,162,23,12.49,139
1037020,ScourgeBringer,1826,191,16.99,1635
1117670,GONNER2,73,28,12.99,45
795760,UPPERS,88,20,19.99,68
1058650,Beyond The Wire,4088,1724,34.99,2364
1238810,Battlefield V,82938,34383,14.99,48555
1328890,Succubus Affection,769,59,19.99,710
1426280,Hello Puppets! VR,163,36,7.99,127
1294760,HARD BULLET,1783,304,19.99,1479
1229580,Disc Room,577,32,14.99,545
908740,VALHALL: Harbinger - Pre-Beta Testing,128,164,22.49,-36
1392490,Forklift Load,79,12,2.99,67
1193340,Zelter,813,736,19.99,77
1261520,Asterix & Obelix XXL: Romastered,230,74,29.99,156
1177000,TRANSFORMERS: BATTLEGROUNDS,47,8,24.99,39
1387580,AbsentedAge: Squarebound,54,7,12.99,47
1243960,Unspottable,259,19,9.99,240
559650,Witch It,12880,1642,4.99,11238
1443430,Rogue,289,12,2.99,277
1435540,Yachu Dice,3,0,4.99,3
785790,WHAT THE GOLF?,2227,137,19.99,2090
691260,POPULATION: ONE,1884,342,29.99,1542
1249060,MyCompany996,244,88,9.99,156
1124560,Fallen Angel,103,28,14.99,75
1064460,Murder House,1357,48,11.99,1309
762220,Afterparty,376,132,19.99,244
1424350,Bunny Hill,49,5,7.99,44
1373430,Leisure Suit Larry - Wet Dreams Dry Twice,519,70,34.99,449
1105040,Alchemist Simulator,203,61,12.99,142
1372300,Iwaihime,356,68,29.99,288
1440870,Corrupted Hospital : Part1,44,25,2.99,19
1217610,Pro Player Life,77,29,2.99,48
852090,Penko Park,122,0,12.99,122
1359120,The Dungeon Beneath,347,57,14.99,290
1286670,Spooky Chase,32,2,4.99,30
578650,The Outer Worlds,16925,2891,19.79,14034
1437500,Dread X Collection 3,238,16,9.99,222
1140270,Monster Prom 2: Monster Camp,4399,87,11.99,4312
1186640,Pumpkin Jack,3464,246,11.99,3218
1427640,All-Time Battle,7,18,0.0,-11
1435310,Shotgun Witch,723,22,0.0,701
957070,iB Cricket,93,4,29.99,89
1264220,Card Blitz: WWII,44,24,0.0,20
1433950,Duck Life: Retro Pack,101,12,1.99,89
1128140,Under: Depths of Fear,157,72,9.99,85
511440,Last Year: The Nightmare,385,172,0.0,213
1417940,捕鱼炸翻天,17,29,0.0,-12
1426900,Dread Nautical,22,7,19.99,15
858260,Until You Fall,2584,144,24.99,2440
1139900,Ghostrunner,38750,3491,29.99,35259
1445540,The Chronicles of Moses and the Exodus,6,0,5.99,6
1404090,Trivia Tricks,111,10,7.99,101
1396140,Hexagroove: Tactical DJ,5,0,24.99,5
1172450,Carto,4649,135,19.99,4514
1292520,Crimson Spires,51,6,19.99,45
1387480,Farmer And Tree,69,10,0.0,59
1302240,Labyrinthine,6256,900,9.99,5356
1447410,Mandew vs the Colorless Curse,30,5,0.0,25
962630,Transient: Extended Edition,148,62,19.99,86
1322290,The Case Book of Arne,222,19,9.99,203
1249800,Xuan-Yuan Sword VII,5635,3319,34.99,2316
1074820,Eudemons Online,54,43,0.0,11
1442070,Claire's Cruisin' Cafe,21,4,6.99,17
1449690,The Walking Dead: The Telltale Definitive Series,5475,249,49.99,5226
1346330,Flea!,7,1,4.33,6
594330,Visage,5864,858,34.99,5006
1314140,TramSim Vienna - The Tram Simulator,1138,288,34.99,850
1178210,Stirring Abyss,262,32,24.99,230
1324270,Space Station Tycoon,87,27,19.99,60
1162960,Angry Video Game Nerd I & II Deluxe,417,23,14.99,394
1312740,Schlag den Star - Das 2. Spiel,1,7,19.99,-6
529970,PositronX,59,19,19.99,40
1194630,The Dark Pictures Anthology: Little Hope,4144,1627,29.99,2517
1356240,Who Wants To Be A Millionaire,83,83,29.99,0
1299400,Understand,409,31,3.99,378
1443490,Siren Head: Awakening,450,175,0.0,275
1412510,仙剑奇侠传九野,1136,413,0.0,723
1131800,Pixel Puzzle Makeout League,48,1,14.99,47
1350350,Touhou Gensokyo Visitor,161,6,3.99,155
1434480,Maitetsu:Last Run!!,2066,23,19.24,2043
1416460,Horror Globes,57,2,5.99,55
1438190,SHUT IN,65,5,4.99,60
1291790,Lakeview Cabin 2,288,9,9.99,279
1444350,House,1195,28,9.99,1167
1459870,King Pins,45,7,2.99,38
985000,Potion Paws,42,21,9.99,21
1427910,Gem Legends,5,1,4.99,4
1024890,Sector's Edge,2144,460,0.0,1684
1381450,Dreadful Shadows,3,0,9.99,3
1422380,Witches x Warlocks,391,29,0.0,362
1345740,恋爱绮谭~不存在的夏天~,1638,64,8.99,1574
1266690,Dark Deception: Monsters & Mortals,1667,273,2.49,1394
1434890,Portable Farm,28,1,2.99,27
1406020,Sakura Succubus 3,151,18,9.99,133
1436650,Battle Star,125,35,0.0,90
1263990,Floor 13: Deep State,9,18,19.99,-9
1431040,Golazo! Soccer League,132,31,8.99,101
1239080,Door Kickers 2: Task Force North,5483,173,24.99,5310
753650,Due Process,4643,997,14.99,3646
1408400,Adventures of Megara: Demeter's Cat-astrophe,0,2,11.99,-2
383740,Marble Age: Remastered,174,28,9.99,146
1455590,Sword of the Necromancer - Prologue,237,33,0.0,204
1416260,SpellForce 3: Versus Edition,802,235,0.0,567
1311330,Pro Basketball Manager 2021,61,61,2.19,0
1090440,Kelipot,609,117,13.99,492
1154040,SpellForce 3: Fallen God,954,97,19.99,857
689980,Car Trader Simulator,319,107,9.99,212
1359900,Gone Golfing,73,15,4.99,58
1302590,Swords and Sandals Crusader Redux,70,23,7.99,47
1449750,Space Commander: War and Trade,306,141,0.0,165
1449430,Jendo: Origins,230,51,0.0,179
1353680,三国吕布传说(Legend of Lv Bu of the Three Kingdoms),55,15,6.99,40
1172470,Apex Legends™,415524,66608,0.0,348916
1328530,Quantum Protocol,366,30,12.99,336
1084640,Chicken Police - Paint it RED!,1313,55,19.99,1258
1038250,DIRT 5,2741,2507,59.99,234
1194700,House Flipper VR,130,109,6.99,21
662680,Beetle Uprising,47,12,9.99,35
1384320,Grapple Tournament,228,18,14.99,210
1196310,Fantasy Grounds Unity,424,60,39.99,364
971160,Möbius Front '83,247,109,19.99,138
1210490,YesterMorrow,40,12,19.99,28
1049410,Superliminal,17104,955,19.99,16149
1019550,Thief Simulator VR,600,277,19.99,323
1204410,Kosmokrats,81,7,9.99,74
1252400,Discord Rich Me! (Custom Rich Presence),96,38,1.99,58
1421760,What Comes After,576,55,4.99,521
1431240,Coloring Book for Adults,181,39,0.0,142
977720,Starpoint Gemini 3,358,333,8.99,25
598430,Ergastulum: Dungeon Nightmares III,51,9,13.99,42
1204740,How Stories Die,92,8,0.0,84
1158940,Blazing Sails,5118,646,10.49,4472
1442480,Prank Call,18,9,2.99,9
1164060,The Last Show of Mr. Chardish,84,3,9.99,81
1428470,Stowaway,436,130,4.99,306
1337890,Choice of Life: Middle Ages,420,64,4.99,356
1286330,WhiteLily 2：梦醒少女,158,3,4.99,155
1449300,莉莉娜的奇幻之旅,66,11,0.0,55
1416130,Perfect Vermin,2116,125,0.0,1991
1340130,Aokana - EXTRA1,761,10,16.99,751
1065320,REKT! High Octane Stunts,65,5,5.99,60
1328660,Need for Speed™ Hot Pursuit Remastered,3590,917,29.99,2673
1378040,Tear and the Library of Labyrinths,236,21,19.99,215
951530,Alien Shooter - Last Hope,138,33,4.99,105
1290710,Shiro,212,32,1.04,180
1418160,Happy Quest,623,126,1.99,497
1132970,Time To Stop Time,91,38,9.99,53
268650,From the Depths,8243,907,24.99,7336
1166990,Kukoro: Stream chat games,440,9,4.99,431
1141840,Escape the Lab,5,1,4.99,4
1101400,Rune Knights,182,52,14.99,130
1461500,Cookie Store,7,1,13.99,6
1331440,FUSER™,1104,154,19.99,950
964800,Prodeus,3320,126,24.99,3194
1408530,Sudoku Starry Sky,15,6,1.49,9
1386900,Observer: System Redux,1101,153,29.99,948
972010,Raiders! Forsaken Earth,171,34,19.99,137
1356670,Sakuna: Of Rice and Ruin,3613,260,29.99,3353
1407190,My Universe - Cooking Star Restaurant,12,6,29.99,6
1235140,Yakuza: Like a Dragon,16181,620,59.99,15561
1423780,Plague M.D.,93,30,5.99,63
1154790,XIII,133,789,39.99,-656
1135260,The Falconeer,220,59,19.99,161
1239050,Mists of Aiden,888,81,6.99,807
1236620,Endurium,6,0,9.99,6
1450050,Rescue Team: Planet Savers,19,1,6.99,18
1455530,东方剑姬在西方旅行的故事,52,18,0.0,34
244930,SNOW - The Ultimate Edition,7926,4167,3.74,3759
1184210,Fragile,230,117,9.99,113
1436240,Krakatoa,17,14,0.99,3
1424720,墨心：波云诡船,1202,129,2.99,1073
1442300,Rags to Dishes,111,4,19.99,107
1437880,Heroes of the Three Kingdoms 7,1690,355,6.99,1335
1437840,Heroes of the Three Kingdoms 3,415,59,1.99,356
1437830,Heroes of the Three Kingdoms 2,1028,45,0.99,983
1437850,Heroes of the Three Kingdoms 4,108,28,1.99,80
1437870,Heroes of the Three Kingdoms 6,91,14,3.99,77
1460750,SUPER DRINK BROS.,168,22,4.99,146
598780,Boreal Blade,340,174,3.99,166
864680,Rover Mechanic Simulator,416,119,11.99,297
1433550,Space Gladiators: The Hole,44,1,0.0,43
1402580,No Place for the Dissident,13,10,11.99,3
737500,Chio Hero,35,9,0.0,26
958530,Fury of Dracula: Digital Edition,140,48,19.99,92
1325380,Live Empire,116,132,2.99,-16
450860,Andarilho,695,331,4.99,364
1437860,Heroes of the Three Kingdoms 5,117,13,3.99,104
1266640,SGS Afrika Korps,45,12,24.99,33
675690,Tribal Wars,348,116,0.0,232
1437820,Heroes of the Three Kingdoms,872,68,0.99,804
1458560,I'm on Observation Duty 3,104,35,2.99,69
821290,RUNE II: Decapitation Edition,233,190,0.0,43
1456710,Blood Knot,3,1,11.99,2
1452830,Disc Space,436,81,0.0,355
778010,Filmmaker Tycoon,23,54,14.99,-31
1341170,Strategic Mind: Spectre of Communism,141,26,29.99,115
1452990,Hero Allstars: Void Invasion,61,8,2.49,53
1423030,Evolution,23,27,0.0,-4
1459710,Seiga Kaku uses her amazing Taoist arts and gives you a life lesson,36,1,0.99,35
1037910,Paw Paw Paw,144,119,4.99,25
1081590,Quest? Quest!,30,6,8.99,24
1129190,Our Life: Beginnings & Always,7275,81,0.0,7194
420560,Firefighting Simulator - The Squad,2864,712,24.99,2152
1422610,Aurora,389,81,0.99,308
914750,Bee Simulator,459,192,19.99,267
1304130,ReRoad,83,16,16.99,67
1437340,My Name is Mayo 2,243,6,0.99,237
765810,Mars Horizon,1887,343,19.99,1544
1178220,ICBM,1034,88,19.99,946
1353270,Five Dates,1279,141,4.93,1138
1449280,Ghostbusters: The Video Game Remastered,712,50,24.99,662
1418970,"Movavi Video Suite 2021 Steam Edition -- Video Making Software - Video Editor, Screen Recorder and Video Converter",113,54,94.99,59
1426980,Hidden Memory - Nature,64,12,0.99,52
810500,PowerBeatsVR - VR Fitness,345,52,12.99,293
1416240,夜永 Eternal Love,661,33,4.99,628
1446280,Alice in Wonderland - a jigsaw puzzle tale,53,7,3.99,46
1175880,War Room,288,192,29.99,96
1402350,12 Labours of Hercules XI: Painted Adventure,6,4,11.99,2
1336120,Bridge Constructor: The Walking Dead,119,18,9.99,101
1381440,80's OVERDRIVE,258,79,9.99,179
1450830,At Dead Of Night,1492,93,14.99,1399
1419860,Tukoni,2554,66,0.0,2488
1335560,UNREAL LIFE,653,23,19.99,630
878670,Shenmue III,620,188,29.99,432
1415010,Lynium,8,7,4.99,1
1435590,Candy Bear 2,1,0,2.99,1
598060,Slasher's Keep,1523,265,13.99,1258
1149710,Tesla Force,135,37,16.99,98
1442150,Raidfield 2,31,40,0.0,-9
1249080,"Lynn , The Girl Drawn On Puzzles",61,8,7.99,53
1445810,Draft Day Sports: Pro Basketball 2021,27,14,19.99,13
1174460,Poker Club,145,123,19.99,22
1304420,Super Cable Boy,68,0,14.99,68
1383970,Captain Sabertooth and the Magic Diamond,24,2,34.99,22
1171350,Garden City,5,2,0.79,3
1370170,Diorama Builder,235,12,1.79,223
1454890,Titanfall­™,715,1169,0.0,-454
1278390,Succumate,550,108,14.99,442
1373550,BloodRayne 2: Terminal Cut,505,106,14.99,399
1373510,BloodRayne: Terminal Cut,808,83,14.99,725
1427970,Asian Riddles 3,4,1,4.99,3
1373350,Phobos,111,52,0.0,59
1243900,Climb the Tower,6,0,1.99,6
1450100,LUNA,188,32,0.79,156
1393350,Swaying Girl,3483,392,0.99,3091
1377550,~Be a maid in the Demon World~ The Secret Café of the Demon Angel Hero.,226,54,18.99,172
1135810,Vault of the Void,1277,64,14.99,1213
1221990,Chronicle: Unit Eight,32,8,14.99,24
1446450,Pretty Girls Klondike Solitaire,14,12,3.99,2
1444650,Haydee 2,948,87,24.99,861
1339500,Gym Tycoon,62,10,7.99,52
955900,Amazing Cultivation Simulator,16949,2307,24.99,14642
1416730,Ball at Work: The Ultimate Speedrun Platformer!,333,57,0.0,276
1263850,Football Manager 2021,21654,1550,0.0,20104
1454010,Diary of Lucie,100,5,12.99,95
926540,Prime & Load : 1776,263,77,7.99,186
1451740,Children of Silentown: Prologue,953,31,0.0,922
1264650,Faircroft's Antiques: Treasures of Treffenburg,9,0,6.99,9
1181840,HIVESWAP: ACT 2,776,110,14.99,666
1467870,Mystery Case Files: Crossfade Collector's Edition,5,3,9.99,2
1189060,The Floor Is Still Really Cheap Lava,168,8,0.0,160
674090,Sky Haven,556,162,24.99,394
1420770,Winter Resort Simulator 2,668,158,24.99,510
1406990,NEKOPARA Vol. 4,7123,172,9.99,6951
1461200,Duck Life,116,10,1.99,106
1271090,Let's Cook Together,74,3,15.99,71
1201380,Puck Buddies,8,1,11.99,7
1465860,*NEW* SCUFFED EPIC BHOP SIMULATOR 2023 (POG CHAMP),4587,426,0.0,4161
1427980,Strike Solitaire 3,1,0,4.99,1
1307670,The Unexpected Quest,108,27,12.99,81
1441790,Miner: Dig Deep,143,16,6.99,127
1314480,Don Flatus: Poop Hunter,61,9,0.0,52
1462650,LAST EMBRYO -EITHER OF BRAVE TO STORY-,415,26,12.99,389
1463510,英雄坛说X·归来,7,1,0.0,6
1430030,THE MONSTER OF MEMORY:DESTINY,131,16,18.99,115
1429640,HINGE VR,135,47,19.99,88
1217830,Khimera: Puzzle Island,116,2,6.99,114
801400,Hoser Hockey,25,7,7.99,18
1467590,Frontiers Reach,3,0,19.99,3
1414020,Mixolumia,169,1,9.99,168
1476350,Brain Meltdown - Into Despair,180,13,3.99,167
895870,Project Wingman,10343,623,24.99,9720
1186040,Worms Rumble,1172,625,1.49,547
1367760,AOD: Art Of Defense,180,49,0.0,131
1263860,Football Manager 2021 Touch,565,75,0.0,490
604540,Empire of Sin,2464,2647,39.99,-183
1463470,Ruff Night At The Gallery,174,16,0.0,158
1383960,Nickelodeon Kart Racers 2: Grand Prix,367,91,19.99,276
752900,Prehistoric Hunt,50,12,10.79,38
1460090,The Life and Suffering of Sir Brante — Chapter 1&2,1921,63,0.0,1858
1444110,Summerland,1342,135,0.0,1207
1409020,Mana Maker,13,26,0.0,-13
967390,Chronos: Before the Ashes,263,149,29.99,114
1404210,Red Dead Online,39311,7280,9.99,32031
1318790,BROK the InvestiGator - Prologue,253,6,0.0,247
1079510,Sumerians,184,20,14.99,164
1201330,I Am Your President: Prologue,403,109,0.0,294
1473050,100 hidden birds,316,16,0.99,300
1440440,Sam & Max Save the World,1029,100,19.99,929
1178790,Shiren the Wanderer: The Tower of Fortune and the Dice of Fate,457,121,19.99,336
1154840,Shadow Empire,737,118,39.99,619
803050,Per Aspera,2379,819,29.99,1560
1276660,Tinkertown,591,189,16.99,402
1293120,Silmaris: Dice Kingdom,59,25,9.99,34
853050,El Hijo - A Wild West Tale,124,28,19.99,96
1341400,Oniria Crimes,31,0,9.99,31
850320,PHOGS!,448,43,17.49,405
839770,Phoenix Point,3087,1188,24.99,1899
1367530,Rekt: Crash Test,432,77,0.0,355
983970,Haven,3110,257,24.99,2853
866140,Arise: A Simple Story,384,17,19.99,367
1140890,Morbid: The Seven Acolytes,462,137,24.99,325
848480,Creeper World 4,2823,124,24.99,2699
1478600,Amulet of Time: Shadow of La Rochelle,33,14,5.94,19
1457740,Stars Die,71,6,4.99,65
1347030,THE CORRIDOR,1318,68,1.99,1250
1086410,Golf Around!,842,42,4.99,800
1405790,John Wick Hex,275,151,19.99,124
1272580,Nine Witches: Family Disruption,170,10,19.99,160
1459910,Isolomus,173,10,0.99,163
655740,Tallowmere 2: Curse of the Kittens,248,31,9.99,217
1485380,iGuide Knossos VR,1,0,7.99,1
1061180,Crumble,461,43,14.99,418
1295510,DRAGON QUEST® XI S: Echoes of an Elusive Age™ - Definitive Edition,5361,309,39.99,5052
861520,#AkiRobots,25,1,7.99,24
677810,Wing of Misadventure,219,150,0.0,69
1251460,Tanuki Sunset,348,20,14.99,328
1207650,Suzerain,3756,285,14.99,3471
1468260,Leaf Blower Revolution - Idle Game,15584,789,0.0,14795
1453140,Abyss The Forgotten Past: Prologue,58,39,0.0,19
1078320,Public Defense Corp,204,33,14.99,171
1267930,Deadly Dozen: Pacific Theater,29,2,9.99,27
1466010,FPV Speed Drone,9,18,0.0,-9
1173370,Slapshot: Rebound,5137,812,0.0,4325
1378070,Drawn to Life: Two Realms,102,110,9.99,-8
1400520,Nomads of Driftland,83,28,0.0,55
1384890,Flag Collection,53,18,0.99,35
1264970,The Conquest of Go,328,23,14.99,305
1035510,Ultimate Zombie Defense,1084,151,4.99,933
1042490,Call of the Sea,2393,253,19.99,2140
1278210,Space Raiders in Space,107,2,9.99,105
814370,Monster Sanctuary,6070,495,6.79,5575
1456200,Initial Drift Online,1161,341,4.99,820
1056840,Arcanium: Rise of Akhan,344,87,16.99,257
1348700,Spice&Wolf VR2,403,10,24.99,393
1458930,Meridian 157: Chapter 2,101,4,2.99,97
1458920,Meridian 157: Chapter 1,129,8,2.99,121
1478220,Puzzle Together Multiplayer Jigsaw,2585,346,0.0,2239
1458900,Meridian 157: Prologue,100,29,0.0,71
1091500,Cyberpunk 2077,391643,129925,59.99,261718
1402320,Medal of Honor™: Above and Beyond,1222,773,31.99,449
1397980,THE NORMAL THING,357,14,0.0,343
1118070,1976 - Back to midway,106,10,14.99,96
1143770,StressOut,17,4,14.99,13
1270980,Rise Of Three Kingdoms,57,32,11.99,25
1307780,Kinda Heroes: The cutest RPG ever!,51,22,0.0,29
1331910,Morkredd,251,50,19.99,201
1481970,Drugs and Crime Idle,140,60,0.0,80
1116580,Shady Part of Me,794,48,14.99,746
1441480,Adventures of Megara: Antigone and the Living Toys,2,1,11.99,1
1453920,Heroes of Three Kingdoms,100,71,9.99,29
1480370,Love Puzzle,124,123,1.99,1
1042930,Trackmaster,16,7,11.99,9
1455630,The Game of Life 2,1444,411,9.99,1033
1477570,Gunspell 2 – Match 3 Puzzle RPG,45,40,0.0,5
976030,Drafting Tales,51,18,12.99,33
1379830,Cyber Crush 2069,569,168,1.99,401
686770,The Wind and Wilting Blossom,152,7,14.99,145
1464930,Seek Girl Ⅶ,840,307,1.99,533
1400290,[Chilla's Art] Hanako | 花子さん,110,39,7.99,71
676840,Contagion VR: Outbreak,415,214,9.99,201
1337010,Alba: A Wildlife Adventure,3084,68,16.99,3016
1475380,TheDawn,6935,540,0.0,6395
1476330,古龙传说,5,2,0.0,3
1468040,Elmarion: Dragon's Princess,55,14,10.99,41
1478070,Fights in Tight Spaces (Prologue),754,41,0.0,713
1090800,Northern Lights,145,65,15.99,80
1471910,Killer Sudoku,84,6,4.99,78
1478650,Diggles: The Myth of Fenris,373,43,9.99,330
1432220,G.I. Joe: Operation Blackout,47,36,29.99,11
1427890,Blaston,304,33,19.99,271
1399780,Spellbreak,11020,1838,0.0,9182
1489680,Pixross,36,1,3.99,35
964620,Shakes on a Plane,30,13,1.49,17
923570,Eternal Radiance,365,67,19.99,298
1131550,I Walk Among Zombies Vol. 3,168,18,14.99,150
1132720,I Walk Among Zombies Vol. 0,71,10,8.99,61
1486750,传奇世界之仗剑天涯H5,40,45,0.0,-5
1428040,Gizmos: Spirit Of The Christmas,6,0,4.99,6
1288790,BeachHead 2020,35,22,19.99,13
1457150,Leafling,428,175,0.0,253
1112890,Calico,2907,338,11.99,2569
1092040,BOMJMAN,463,118,9.99,345
1480010,Christmas Stories: The Christmas Tree Forest Collector's Edition,7,0,9.99,7
1292240,The Chess Variants Club,37,6,4.99,31
1484960,Escape to Moscow,240,35,0.0,205
1387350,Ken ga Kimi: Momoyo Tsuzuri,108,15,49.99,93
1428520,Mech Engineer,61,25,14.99,36
1462790,Fight of Animals: Arena,45,3,12.99,42
1448530,Soccer Manager 2021,1441,510,0.0,931
1477440,Mahjong Solitaire 100,2,0,2.99,2
1479310,Spare Parts: Episode 1,24,0,2.99,24
1048580,Terje Haakonsen's Powder VR,51,14,19.99,37
1259800,MXGP 2020 - The Official Motocross Videogame,451,119,39.99,332
1482700,Speed Stars,13,0,2.99,13
1345870,Franchise Hockey Manager 7,191,56,19.99,135
1442160,ABYSS OF THE SACRIFICE,159,22,39.99,137
1303660,Geometric Sniper,260,57,1.99,203
1489830,Bouboum,51,13,0.0,38
667610,Ancient Cities,458,356,49.99,102
1490130,CrashMetal - Cyberpunk,188,105,4.99,83
1422090,Sink Again,83,40,0.0,43
1079260,Fireworks Mania - An Explosive Simulator,3041,94,11.99,2947
1451720,Minesweeper Classy,69,3,2.99,66
1148480,SPACERIFT: Arcanum System,239,53,18.99,186
1386650,ZCREW（Z字特遣队）,64,53,9.99,11
1120400,Terra Randoma,65,9,11.24,56
1475970,Defentron,19,3,9.99,16
760410,Don't Be Afraid,323,53,9.99,270
1457550,Melody/心跳旋律,118,19,3.99,99
1271740,Magical Swordmaiden,86,26,19.99,60
1486030,Hollow Witch,18,4,1.99,14
702680,Wattam,284,48,19.99,236
1104330,Founders' Fortune,1388,271,21.99,1117
350150,Scraps: Modular Vehicle Combat,109,36,14.99,73
1090250,Crunch Element,283,101,19.99,182
1277930,Riddle Joker,2851,32,34.99,2819
1426110,Love n Dream: Virtual Happiness,166,55,1.99,111
1431350,Santa Claus in Trouble (HD),102,4,9.99,98
1455120,Pumping Simulator,192,69,19.99,123
1089780,Tales Of Glory 2 - Retaliation,136,43,19.99,93
1353300,Idle Slayer,2452,426,0.0,2026
1218900,Zup! Z,3472,95,0.99,3377
1108370,Ratropolis,4094,505,17.99,3589
1428780,Animal Rescuer,36,11,3.74,25
1027820,Hand Simulator: Horror,496,190,2.99,306
1504150,Hello Guest: Hello Neighbor 2 pre-alpha,253,39,0.0,214
1491640,"Understanding, The Game",234,42,0.0,192
1495640,Estigma [Steam Edition],119,12,0.0,107
1145570,Ortharion project,95,42,19.99,53
1485900,"Eye, caramba!",34,0,2.99,34
1480470,Go! Birdie,10,0,4.99,10
389800,AlterVerse: Disruption,12,3,17.99,9
1478410,像素男友 语音完整版,189,7,3.99,182
1341450,Yolo Space Hacker,152,6,24.99,146
1494920,星帷之瓣,68,2,0.0,66
1405180,Wilderness,24,54,14.99,-30
1496380,艾斯菲尔的谎言,34,15,0.54,19
1184160,RUSSIAPHOBIA,2965,1230,0.49,1735
1427800,Mutant Ops,431,125,4.99,306
1490190,"Happy New Year, Zeliria!",84,6,0.0,78
1150690,OMORI,42173,755,19.99,41418
832140,Infernal Radiation,40,6,1.99,34
1494840,SCOOT,308,51,9.99,257
1373880,Hello Neighbor 2 Alpha 1,313,51,0.0,262
1484730,Papa's Quiz,72,6,9.9,66
1415920,PBA Pro Bowling 2021,49,19,24.99,30
1412470,GranAge,328,114,0.0,214
1461630,Magic Potion Millionaire,24,2,14.99,22
1470790,Doug Flutie's Maximum Football 2020,26,24,29.99,2
1500820,Caravaneer 2,262,17,5.99,245
1480340,A traveler's photo album,612,217,0.99,395
1483570,Lost Lands: Redemption,29,7,6.99,22
1186050,Hero's Spirit,38,5,5.99,33
1279580,Fortress V2,279,182,0.0,97
1494460,Desktop+,299,31,0.0,268
1394500,Frontline: World War II,38,4,11.99,34
1501490,Ship Handling Simulator,55,6,8.99,49
1131190,NERTS! Online,1105,58,0.0,1047
1477330,Soulestination,422,38,2.99,384
1303590,Dura Vita Online,17,11,0.0,6
1279920,Cobra Kai: The Karate Kid Saga Continues,316,56,19.99,260
1445440,Blacksmith of the Sand Kingdom,85,29,19.99,56
1410840,Crystal Call,131,4,0.0,127
684840,Days Of Purgatory,13,0,24.99,13
1387590,列传：革新战争,157,41,16.99,116
1410830,Curse That Magic Cat!,215,16,0.0,199
1167170,Guilty Parade,184,7,6.99,177
1394270,SCP: Escape Together,1943,1046,0.0,897
1501110,Aim: Warmup,1,1,0.99,0
1448030,Press Any Button,1934,147,1.99,1787
1406690,Kasi,127,3,4.99,124
1325310,Endless Voyage / 无尽航线,469,140,16.99,329
1371480,Iron Conflict,1292,555,0.0,737
1477770,触尾少女,212,69,12.99,143
1404850,Luck be a Landlord,5260,370,9.99,4890
1433420,Hero by Chance,738,195,1.29,543
1340730,Oath,3,2,0.0,1
652050,The Labyrinth,24,3,4.99,21
1295810,A Little Shop in Squirrel Town,41,11,9.99,30
1235920,SwordBall,2,3,0.0,-1
1083600,Grow Defense,371,110,0.0,261
1504760,그랑 엠파이어,129,9,2.99,120
1508430,Kemono Mahjong,66,6,4.99,60
1498310,100 hidden cupcakes,102,40,0.99,62
1315160,鸢之歌-Singing Iris,369,40,4.99,329
1508360,Town Of The Dead Life 死寂之城,112,48,5.99,64
888530,Yaga,353,79,24.99,274
1472250,ROG CITADEL XV,358,140,0.0,218
875210,Kingdom Heroes 8,7179,6052,29.99,1127
1422540,云端之约,405,23,7.99,382
1096100,Skellboy Refractured,71,10,19.99,61
1508030,Object N,556,103,0.0,453
1361180,Gemini Strategy Origin,82,44,4.99,38
1496180,Cinderella Phenomenon: Evermore,131,5,9.99,126
682140,Undead Development,231,65,17.99,166
1497820,Golden Rails: Small Town Story,25,0,6.99,25
1227570,Lotus Reverie: First Nexus,38,7,3.99,31
1471200,YUME,735,598,2.99,137
1507970,Word Game: Episode 0,4061,37,0.0,4024
1509820,Cloud Climber,3227,284,0.0,2943
1451120,Sunlight,114,15,3.99,99
1229060,Dungeon and Puzzles,78,0,7.99,78
1107300,Down in Bermuda,362,53,1.99,309
973450,Ancient Abyss,130,51,14.99,79
1415410,Farm Manager 2021: Prologue,686,204,0.0,482
1414430,Project Morpheus: Prologue,347,75,0.0,272
1503040,Purplis Sandbox,125,40,4.99,85
1317500,Lucidscape,24,10,0.0,14
1463920,hexceed,1497,155,0.0,1342
1455920,EQI,152,16,0.0,136
1457730,Farmer's Life: Prologue,141,55,0.0,86
1163690,Wizards,304,50,0.0,254
1510030,Knights College,1331,34,24.99,1297
1509590,Fujiwara Bittersweet,263,27,0.0,236
1092400,月球坠落时 Moon Fall,600,61,8.99,539
1410860,Puzzle Box Palace,48,7,0.0,41
1430240,The Space in Between,88,20,0.0,68
1485250,Frame of Mind,644,32,0.0,612
1128920,EVERSPACE™ 2,4127,590,39.99,3537
1410870,Trikaya,200,39,0.0,161
996370,Watch Me Stream My Mental Breakdown,34,4,19.99,30
1476340,The Adventure of NAYU,1029,38,2.99,991
1484680,CrazyFlasher7 Mercenary Empire,146,332,0.0,-186
1458980,Misery Mansion,45,16,17.99,29
1451870,Sunset Drive 1986,114,14,0.0,100
1147560,Skul: The Hero Slayer,32454,2335,19.99,30119
1366540,Dyson Sphere Program,62266,1425,19.99,60841
1479940,Fragments,22,4,2.99,18
888140,Quatris,3,3,0.0,0
871210,Lamp Chronicle,44,15,14.99,29
1253690,Teke Teke - テケテケ,46,38,4.99,8
1354910,Tiny Lands,596,37,6.99,559
1342890,Who Needs a Hero?,852,62,2.99,790
1342330,Mad Games Tycoon 2,3294,236,24.99,3058
1400070,Don't Cheat On Me,135,158,7.99,-23
1502380,Combat Mission Black Sea,261,35,59.99,226
1506760,A House of Thieves,55,12,9.59,43
1513120,The Zodiac Trial,89,2,14.99,87
1480480,DesktopMMD3:Miss Fish,167,73,3.99,94
1480440,Desktop NEKO Girl,29,10,3.59,19
1204990,Milkcraft,103,88,0.0,15
1436590,Phoenotopia: Awakening,1116,149,19.99,967
1333700,Real Heroes: Firefighter HD,54,4,14.99,50
1495380,Tricky Machines,25,3,5.99,22
1280950,Interstate Drifter 2000,40,1,6.99,39
1469280,SuchArt: Creative Space,5511,112,0.0,5399
1393750,Ocean's Heart,668,128,7.49,540
886060,Redout: Space Assault,37,45,9.99,-8
1295390,ADVERSE,54,6,5.99,48
1151450,Utawarerumono: Prelude to the Fallen,575,35,59.99,540
1464550,RagingBlasters,87,1,14.99,86
1511650,Andromeda: Rebirth of Humanity,54,29,0.0,25
1456750,Ceres,25,28,0.0,-3
1490410,The fairy tale you don't know,121,31,18.99,90
1496320,Time Machine - Find Objects. Hidden Pictures Game,58,12,3.99,46
1484800,Zardy's Maze,992,74,0.0,918
1203370,Survival Classic,194,90,9.99,104
1234940,Astronarch,555,45,7.49,510
1480540,FICTION #F3F,29,4,4.99,25
1257850,SOLAS 128,145,4,14.99,141
1488100,IncrediMarble,65,3,6.99,62
1173380,NEKO ARENA,538,104,1.99,434
1513090,Blimps,5,2,6.99,3
1257290,Atelier Ryza 2: Lost Legends & the Secret Fairy,1872,161,59.99,1711
737050,Open Sorcery: Sea++,34,3,14.99,31
1078920,Main Assembly,895,110,7.99,785
1466190,You Arrive in a Town,9,10,4.99,-1
1258780,B100X - Auto Dungeon RPG,540,121,0.0,419
1124260,Snowtopia: Ski Resort Builder,460,213,24.99,247
1134710,NIMBY Rails,1043,94,16.99,949
1137450,ENCODYA,226,45,4.99,181
861250,Cyber Shadow,889,171,19.99,718
1277510,Re:ZERO -Starting Life in Another World- The Prophecy of the Throne,389,52,59.99,337
1435780,Farm Frenzy: Refreshed,78,10,8.99,68
1468810,鬼谷八荒 Tale of Immortal,105384,103661,19.99,1723
1507720,Märchen Forest,165,18,34.99,147
1173200,Metal Unit,1758,308,14.99,1450
1249430,Sarawak,16,3,5.99,13
672630,Academia : School Simulator,1810,335,19.99,1475
1093170,Monstrum 2,282,179,14.99,103
1297330,Olija,474,40,14.99,434
1040230,Curious Expedition 2,2398,273,11.99,2125
973810,Journey To The Savage Planet,3645,483,29.99,3162
1440670,Zeepkist,409,14,11.99,395
1105500,Yakuza 4 Remastered,2244,178,19.99,2066
854890,International Basketball Manager,93,43,0.0,50
1251970,Gladiator Manager,73,15,7.99,58
1494440,Garbage: Hobo Prophecy,1012,331,0.0,681
1081670,Fitforce,183,50,0.0,133
1262930,Handball Manager 2021,54,8,17.49,46
1517830,Miska's Cave,138,17,0.0,121
1075200,TOHU,347,55,14.99,292
1134700,Wild Terra 2: New Lands,715,505,34.99,210
1088710,Yakuza 3 Remastered,3419,767,19.99,2652
979310,Disjunction,89,16,15.99,73
1422940,Glider Sim,52,12,24.99,40
1243890,Sword of the Necromancer,166,54,14.99,112
1105510,Yakuza 5 Remastered,2391,231,19.99,2160
1274570,DEVOUR,41425,3672,3.99,37753
1378060,Hidden Lands - Spot the differences,193,12,0.0,181
1243690,Gods Will Fall,45,33,14.99,12
1325270,Escapeworld Dilemma,41,10,14.99,31
1218170,回门 Way Back Home,261,88,14.99,173
1106140,The Drift Challenge,443,99,5.99,344
1520250,Gnome Jigsaw Puzzles,24,0,1.99,24
1078350,Ambrosia,1389,81,14.99,1308
1469910,Slobbish Dragon Princess,159,27,14.99,132
1508460,Annalynn,267,4,4.99,263
1387460,Melancholy Love,57,2,8.99,55
862440,Angel Wings,514,64,0.0,450
1379550,The USB Stick Found in the Grass,46,69,9.99,-23
570950,Devilated,47,5,19.99,42
824600,HROT,2216,49,19.99,2167
1366010,Bromeliad,15,8,11.99,7
1520270,Kyvir: Rebirth,331,63,7.99,268
1517370,PACT - Process Affinity Control Tool,1,0,11.99,1
1495140,Halloween Night Mahjong,4,1,4.99,3
669500,Himeko Sutori,156,47,18.99,109
618850,Pumpkin Days,414,69,24.99,345
1495100,Detective Solitaire: Inspector Magic And The Forbidden Magic,2,0,4.99,2
1521870,Riddle of the Sphinx™ The Awakening (Enhanced Edition),63,8,19.99,55
1408720,Krunker,14951,3474,0.0,11477
794490,Journey Of Life,430,290,14.99,140
1151930,Buissons,90,1,8.99,89
1506600,My boss is weird,201,113,0.0,88
1280780,War on the Sea,1421,427,39.99,994
1495050,1001 Jigsaw: Earth Chronicles 3,4,1,4.99,3
1495080,Asian Riddles 4,8,0,4.99,8
1216710,Cyber Manhunt,9485,561,9.99,8924
892970,Valheim,337177,16241,19.99,320936
1529810,Psycholonials,525,64,2.99,461
1288310,Firework,26635,518,9.99,26117
1213050,Ink.,1,0,10.99,1
1515290,Boodunnit,263,92,0.0,171
543960,Rugby Challenge 4,40,40,49.99,0
1516190,A Hole In Space,10,2,11.99,8
1368870,Field of Glory II: Medieval,268,34,29.99,234
1342410,[TDA02] Muv-Luv Unlimited: THE DAY AFTER - Episode 02 REMASTERED,29,3,24.99,26
1220150,Blue Fire,1508,335,9.99,1173
955870,Battlecruisers,221,29,9.99,192
1527670,Goblin Dungeoneer,6,9,0.0,-3
1407100,[TDA00] Muv-Luv Unlimited: THE DAY AFTER - Episode 00 REMASTERED,53,18,14.99,35
1023550,Rogue Star Rescue,106,5,10.49,101
1454520,MONOLISK,323,83,0.0,240
1407090,[TDA01] Muv-Luv Unlimited: THE DAY AFTER - Episode 01 REMASTERED,35,3,24.99,32
1507210,aerofly RC 8,45,9,79.99,36
1367170,Planet's Edge,2,1,7.99,1
1475570,Shadowbane,283,121,10.99,162
1152950,Blackberry,77,41,3.99,36
1325200,Nioh 2 – The Complete Edition,27191,3674,49.99,23517
1397290,Comet 64,100,28,14.99,72
1508670,正宗台湾十六张麻将3,16,9,6.99,7
1508660,正宗台灣十六張麻將2,22,3,2.99,19
1508650,正宗台灣十六張麻將,18,1,0.99,17
1508740,Xuan-Yuan Sword 2,143,23,4.99,120
1450120,The Legend of Heroes: Sen no Kiseki I KAI -Thors Military Academy 1204-,264,62,34.99,202
1508750,Xuan-Yuan Sword: Dance of the Maple Leaves,175,6,4.99,169
1505560,Little Lives,138,20,8.99,118
1501440,Fritz & Chesster - Learn to Play Chess Vol. 1,2,2,24.99,0
1330460,Becastled,3057,593,14.99,2464
895110,Magical Battle Cry,643,297,19.99,346
672870,ScreenPlay,292,69,0.0,223
1530140,Aventura Copilului Albastru și Urât,2145,13,1.99,2132
661130,ChilloutVR,444,166,0.0,278
1505700,Berzerk Flashback,48,1,9.99,47
1524230,Mori's Nightmare : Hide and seek,38,18,2.99,20
1338940,Head AS Code,34,0,19.99,34
1510400,萌娘三国,19,23,0.0,-4
1529570,MorphVOX Pro 5 - Voice Changer,37,35,39.99,2
860510,Little Nightmares II,19693,939,29.99,18754
1511410,Grass Cutters Academy - Idle Game,30,19,0.0,11
1392060,Erzurum,1215,1851,4.99,-636
1512530,极限求生,6,8,0.0,-2
1203470,Earth Analog,56,31,24.99,25
1126890,Urban Cards,119,26,14.99,93
1474200,Sudoku RPG,99,18,2.99,81
606980,Potentia,241,113,19.99,128
1361320,The Room 4: Old Sins,9642,124,8.99,9518
1372220,Medievalien,59,12,19.99,47
1530860,Mental Hospital VR,37,13,9.99,24
1528130,Suicide Countdown: 7 Days,721,125,2.99,596
1449330,DRINK BAR MAID -REGRESSION-,46,17,9.99,29
1504020,Mosaique Neko Waifus 4,3609,171,1.99,3438
1533390,Gorilla Tag,17321,1123,0.0,16198
622980,TrainClicker Idle Evolution,37,18,2.99,19
1425730,Gal*Gun Returns,161,27,49.99,134
1519660,Goat over it,27,9,2.99,18
1214180,Mini Countries,37,14,9.99,23
1537600,Spring Flower,10,2,24.99,8
1511670,Enter The Backrooms,652,85,4.99,567
1533940,轮回修真OL,17,21,0.0,-4
1316160,M.E.A.T. RPG,143,33,11.99,110
1523680,Jigsaw Pieces - Sweet Times,12,0,9.99,12
330830,Tales from the Borderlands,15658,783,19.99,14875
1494500,FWsim - Fireworks Display Simulator,48,2,24.99,46
1016000,NERVE,44,3,11.99,41
1396240,Contraband Police: Prologue,3561,414,0.0,3147
1532510,Purrfect Apawcalypse: Love at Furst Bite,286,3,4.99,283
1027120,Bravery Network Online,141,7,24.99,134
1000360,Hellish Quart,3720,278,16.99,3442
1360270,Gem Wizards Tactics,48,6,14.99,42
899460,Shores Unknown,81,20,19.99,61
988310,Viola: The Heroine's Melody,77,3,14.99,74
1349120,球球少女/Pinball Girls,718,152,2.99,566
1029210,30XX,957,62,19.99,895
1544140,The Great Empire: Relic of Egypt,5,1,6.99,4
1539580,Bird,387,70,0.49,317
1532250,The Catacombs of Solaris Revisited,38,6,11.99,32
1045180,Shattered - Tale of the Forgotten King,378,149,29.99,229
1531720,Need for Drive - Open World Multiplayer Racing,937,491,4.99,446
1159680,Silent Sector,93,18,14.99,75
1157220,Nebuchadnezzar,928,232,19.99,696
1426530,Sid Classic,86,21,0.0,65
1269950,Buddy Simulator 1984,2694,156,9.99,2538
1150090,Learning Factory,199,28,14.99,171
1502080,ALTDEUS: Beyond Chronos,226,8,17.99,218
1538610,Legacy - Witch Island 3,9,3,5.99,6
1037120,Mutropolis,131,10,19.99,121
1175190,Natsuki Chronicles,57,3,7.99,54
1461770,Fantasy Tavern Sextet -Vol.2 Adventurer's Days-,141,20,12.99,121
1338330,Lemon Cake,982,109,14.99,873
1516090,Woodle Deluxe,79,10,5.99,69
694280,Zombie Army 4: Dead War,3866,751,49.99,3115
1071220,"After I met that catgirl, my questlist got too long!",89,8,12.99,81
1289340,TasteMaker,834,125,9.99,709
1028470,Dis The Game,916,605,0.0,311
1253190,"Warhammer 40,000: Dakka Squadron - Flyboyz Edition",264,65,19.99,199
1415660,TRADER LIFE SIMULATOR,1397,383,19.99,1014
1544570,Plot of the Druid: Nightwatch,92,8,0.0,84
1352730,Twin Horizons,2,1,14.99,1
1152160,Might is Right,110,25,9.99,85
1257200,False Myth,321,39,24.99,282
1506940,Muffin Fight,10,2,4.99,8
1458680,Bookshelf,13,12,0.99,1
1281150,Modiverse,32,20,0.99,12
1527880,Darkness Under My Bed,52,6,2.49,46
1140130,Survival Vacancy,54,28,19.99,26
1297300,The Shore,831,278,11.99,553
1379560,Steven Universe: Unleash the Light,390,13,24.99,377
1528860,The Legend of Karl,224,61,0.0,163
1541250,Super Raft Boat,691,46,0.0,645
1504740,Find Yourself,549,82,6.99,467
1064340,Chess Evolved Online,453,35,0.0,418
1530340,Incremental Epic Hero,172,64,0.0,108
1252170,InfiniteCorp: Cyberpunk Cards,23,4,3.99,19
1382330,Persona® 5 Strikers,9027,664,59.99,8363
1507910,Survival Engine,47,17,0.0,30
1316560,Otaku's Rage: Waifu Strikes Back,133,38,1.99,95
1557050,Combat Chess,4,0,0.99,4
1290170,Titan Chaser,410,84,4.99,326
1005240,Pixel Puzzles Illustrations & Anime,72,12,0.0,60
1409180,Of Mice and Moggies,28,0,4.99,28
1123770,Curse of the Dead Gods,4938,724,19.99,4214
787810,Rogue Heroes: Ruins of Tasos,1512,380,19.99,1132
576480,Drunken Fight Simulator,124,48,3.99,76
990260,Collapse: A Political Simulator,95,34,6.99,61
1450090,The Legend of Heroes: Sen no Kiseki II KAI -The Erebonian Civil War-,139,21,34.99,118
1483780,Tested on Humans: Escape Room,239,31,9.99,208
1538650,The Chronicles of Hercules: The 12 Labours,15,4,5.99,11
1525890,Death Park 2,103,8,5.99,95
1525320,Dadish 2,38,1,3.99,37
1379870,Tribal Hunter,630,16,14.99,614
1424710,Geneforge 1 - Mutagen,281,13,11.99,268
1546440,Lycanthorn II - Rain of Beasts,153,12,0.0,141
1343370,Old School RuneScape,10401,1068,0.0,9333
1540150,Crazy Flasher Series 2021,2073,241,0.99,1832
606500,HellSign,1391,588,19.99,803
1260590,Hadean Tactics,352,36,17.99,316
1304680,Voidigo,1305,34,14.99,1271
1476520,GunSoul Girl,1059,356,1.99,703
1386890,Hyper Dash,113,14,19.99,99
1252300,RetroMania Wrestling,211,30,29.99,181
557180,League of Maidens®,3275,2742,0.0,533
968970,Lumberjack's Dynasty,1501,565,9.99,936
1545620,Arcane Arts Academy,26,2,12.99,24
1471960,Room to Grow,117,4,9.99,113
738520,Breathedge,10322,1846,24.99,8476
1514840,All-In-One Sports VR,288,60,19.99,228
1418430,Horror Bar VR,54,6,19.99,48
1532780,The Magnets,17,1,2.99,16
1259640,Tiny Room Stories: Town Mystery,382,39,9.99,343
908100,九州：商旅（Nine Provinces: Caravan）,884,81,8.99,803
1304810,HANI,19,1,2.99,18
1518810,Koi Farm,535,22,2.99,513
1531040,Pavlov's House,37,0,8.99,37
750130,The Sinking City,900,369,39.99,531
1549030,100 hidden snails 2,177,9,1.99,168
1252710,Cardaclysm,293,143,4.49,150
1096690,Mighty Fight Federation,44,8,29.99,36
774181,Rhythm Doctor,15487,236,15.99,15251
1197260,The Perfect Tower II,1445,188,0.0,1257
1524630,KeepUp Survival,261,106,16.99,155
1173010,Flowers Blooming at the End of Summer,1108,46,0.99,1062
892860,Hot Brass,290,55,14.99,235
1469160,Wartune Reborn,87,49,0.0,38
1460490,Majikoi! Love Me Seriously!,93,6,34.99,87
1506620,Horror Squad,311,220,4.99,91
1513680,Wizardry Squared,9,0,4.99,9
1342050,Lisa and the Grimoire,67,30,16.99,37
1420780,校长模拟器,11,57,4.99,-46
1518770,Re: LieF ~ Shin'ainaru Anata e~,486,18,34.99,468
1355640,SYNTHSPACE,26,3,29.99,23
1181830,Urtuk: The Desolation,1696,177,19.99,1519
1515820,Guns of Succubus,41,6,6.99,35
1547340,Puzzle Car,48,0,0.99,48
1551850,Star Steel,8,3,1.99,5
1510670,ZADETTE,41,1,5.99,40
1494190,秘密舞会,453,9,2.99,444
1508260,Tortured Hearts - Or How I Saved The Universe. Again.,24,5,14.99,19
1534980,Terminus: Zombie Survivors,181,9,15.99,172
1000760,Foregone,554,116,19.99,438
1524110,Stories of Liane,65,21,0.0,44
1516350,Textreme 2,13,0,2.99,13
1542100,Wheelie King Online,38,8,0.0,30
1445040,Space Choice: Data Analyzer,121,6,0.0,115
1372810,Teamfight Manager,3784,586,9.99,3198
1466690,Sakura Succubus 4,129,10,9.99,119
1379270,First Session,59,10,0.0,49
762840,Maquette,313,136,19.99,177
1205480,Monster Jam Steel Titans 2,137,41,29.99,96
1544250,Trickery&Strategy,8,1,9.99,7
1522660,Introvert: A Teenager Simulator,519,146,0.0,373
1497680,Retro Classix: Bad Dudes,25,1,6.99,24
1540420,Retro Classix: Super BurgerTime,8,2,6.99,6
1532920,Clutter IX: Clutter IXtreme,7,0,9.99,7
1554550,Unlock The Cat,79,2,1.99,77
1200900,Crypto: Against All Odds - Tower Defense,52,8,6.99,44
1460610,hocus 2,37,6,2.99,31
1514360,Laid-Back Camp - Virtual - Lake Motosu,245,70,13.99,175
1394550,Tales From The Under-Realm: Hazel,16,3,11.99,13
1227650,Bang-On Balls: Chronicles,1445,31,16.99,1414
1555380,RPG IDLE,3,2,0.0,1
1515890,TAISHO x ALICE episode 3,181,6,9.99,175
1437890,Mexican Train Dominoes Gold,4,1,3.99,3
1502800,Escape Machine City: Airborne,15,2,3.99,13
1229380,Everhood,8202,352,9.99,7850
673610,Airport CEO,4952,886,24.99,4066
1240550,Until the Last Plane,66,24,8.39,42
1119730,Ranch Simulator,7842,1398,24.99,6444
1272160,The Life and Suffering of Sir Brante,3804,306,19.99,3498
1437280,Project Terminus VR,28,7,19.99,21
1552090,Cursed House 9 - Match 3 Puzzle,5,1,6.99,4
1282730,Loop Hero,26961,1817,14.99,25144
1546500,Warplanes: WW1 Fighters,326,32,19.99,294
1485870,Evil Inside - Prologue,401,164,0.0,237
1382320,Antonball Deluxe,164,4,14.99,160
574180,Remnants,492,159,15.99,333
959150,Making History: The First World War,55,19,16.74,36
883880,Faraway: Puzzle Escape,39,15,4.99,24
1554130,Draft Day Sports: College Basketball 2021,34,5,24.99,29
1555890,Paradise Lost,5,13,49.99,-8
1516240,Mitoza,2123,66,0.0,2057
1460040,Love Fantasy,190,55,1.99,135
1557710,Academy of Magic - Lair of the Beast,10,2,5.99,8
1282610,BitBattle,27,3,1.99,24
1497000,OceanCraft,43,6,9.99,37
1507410,Coloring Book for Kids,67,8,0.0,59
1541710,Wyvern,63,26,0.0,37
1302480,Slurkum,1,4,9.99,-3
1293830,Forza Horizon 4,122539,15095,59.99,107444
1518630,Pretty Girls Panic! PLUS,3,3,4.99,0
1451680,Game Master Engine,67,22,0.0,45
907650,Stronghold: Warlords,2164,1252,9.99,912
1144910,Space Gladiators,209,6,14.99,203
1230800,Beach Buggy Racing 2: Island Adventure,304,23,19.99,281
1558440,SPY ESCAPE,11,2,0.0,9
1092630,Rogue Glitch,961,54,0.0,907
1300600,Blind Drive,143,3,9.99,140
1554700,Inglorious Waifu VS Nazi Zombies,240,12,1.99,228
1164100,A Random Maze 某个迷宫,300,12,0.0,288
1547780,焚魂之梦,7,1,3.99,6
1555710,OMFG: One Million Fatal Guns,1702,93,0.0,1609
1304340,Monster Energy Supercross - The Official Videogame 4,353,199,39.99,154
869880,Cyanide & Happiness - Freakpocalypse (Episode 1),602,448,19.99,154
1456650,Pascal's Wager: Definitive Edition,647,297,19.99,350
1532350,Rogue Explorer,15,14,7.99,1
820540,Bloodroots,141,13,19.99,128
1325860,VTube Studio,1780,147,0.0,1633
1328900,Explorer of Yggdrasil,182,28,19.99,154
1348680,Meow Pow,47,6,0.0,41
951430,Dead Age 2: The Zombie Survival RPG,773,230,4.49,543
976700,Size Matters,308,41,4.99,267
380680,Gwan Moon High School : The Ghost Gate,45,8,18.99,37
1553320,Inside Depth 6,150,23,4.99,127
1514660,Battle Ball,365,58,0.0,307
1532180,Evo\Wave,396,18,0.0,378
1527080,XTHRUST,6,11,4.99,-5
1529470,Ethereal Estate,170,27,0.0,143
1428900,Tadpole Tales,681,68,0.0,613
1529860,Ulna Online,13,6,0.0,7
973250,Altered,60,0,11.99,60
1483870,Draw & Guess,22445,4053,2.99,18392
1506820,Kiki & Ana - The Child,36,0,1.99,36
1492250,44 Minutes in Nightmare,35,4,8.99,31
1563340,The Most Boring Game Ever,130,17,0.0,113
1262140,Rangok Skies,18,7,9.99,11
906470,Gravia,31,2,19.99,29
1547030,Outcasts of Orion,21,3,7.99,18
1462150,R.B.I. Baseball 21,99,83,0.0,16
1533050,Press Ctrl,312,32,1.99,280
1037080,Zedfest,127,14,14.99,113
1363840,Saviors of Sapphire Wings / Stranger of Sword City Revisited,80,45,49.99,35
370770,Holodrive,986,261,0.0,725
720350,Mundaun,716,33,19.99,683
1527910,Gladio and Glory,2566,210,0.0,2356
970840,OVERPASS™,64,82,29.99,-18
7800,Stubbs the Zombie in Rebel Without a Pulse,1283,184,19.99,1099
505740,Eximius: Seize the Frontline,459,161,29.99,298
1271400,Adios,835,41,17.99,794
1133120,Ecosystem,216,46,19.99,170
1543750,Jewel Match Atlantis Solitaire 2 - Collector's Edition,16,1,5.84,15
1535060,Incremental Epic Breakers,34,37,0.0,-3
1500970,BlackChain,75,10,4.99,65
1494110,QV,185,19,14.99,166
1145340,Rogue State Revolution,320,75,14.99,245
466980,Can't Drive This,282,55,19.99,227
1253860,Neurodeck : Psychological Deckbuilder,136,66,13.99,70
1508270,Doctor Who: The Lonely Assassins,495,60,5.99,435
785770,Emergency Call 112 – The Fire Fighting Simulation 2,1331,1312,29.99,19
1318750,18 Wheels of Steel: Hard Truck,20,1,9.99,19
1479340,Derelict Void,30,17,9.99,13
1511950,Magellania,25,0,9.99,25
1235830,Dark Water : Slime Invader,143,7,14.99,136
1318240,Shields of Loyalty,36,3,17.99,33
761830,Mr. Prepper,2776,531,19.99,2245
1558320,Sky Goddess,14,2,3.99,12
1559810,Salto,13,4,0.0,9
1220140,Cartel Tycoon,1331,336,24.99,995
1564550,Mini Words: Polyglot,34,4,1.39,30
933820,Endzone - A World Apart,5304,1531,29.99,3773
1455220,Succubus Farm,272,89,14.99,183
1534290,Space Mages: Dimension 33,15,2,1.99,13
1514780,Battle for Esturia,24,2,9.99,22
1569920,Saphyro,5,2,0.99,3
1424660,9-nine-:Episode 4,527,12,19.99,515
1320100,Wanted Raccoon,288,56,19.99,232
1522070,Zenith Into Maronarium,8,0,1.99,8
863940,Treasure Adventure Game,23,3,0.0,20
1543270,Clash of Irons,33,21,0.0,12
1333910,Sizeable,669,9,9.99,660
1546860,Saiko no sutoka,1838,86,4.99,1752
1577750,Hamster All-Stars,17,1,2.99,16
1547070,Wow Dance,14,8,0.0,6
1567370,just a game to test your lQ,188,86,0.0,102
1571070,Felix The Toy,38,5,0.49,33
1566090,Malice & Greed,56,5,14.99,51
1551820,Twin Mind: Murderous Jealousy Collector's Edition,1,1,6.99,0
1462470,Vectorio - Early Access,997,52,0.0,945
1539750,Realms of Antiquity: The Shattered Crown,38,1,20.0,37
1550710,Warbox,1469,260,9.99,1209
1564100,Synth Drift,9,4,0.99,5
1507190,Machinika Museum,416,40,7.99,376
1259790,Puyo Puyo™ Tetris® 2,782,182,29.99,600
873270,Rolled Out!,364,19,19.99,345
1243830,Overcooked! All You Can Eat,1297,639,39.99,658
840210,Arkham Horror: Mother's Embrace,337,203,19.99,134
1544480,Book of the Old,9,0,9.99,9
1573750,100 hidden mushrooms,180,16,0.99,164
1519590,Sentimental Trickster: Yaoi BL Gay Visual Novel,56,1,14.99,55
1188160,Ground Zero Texas - Nuclear Edition,5,4,14.99,1
1325970,Ghost of Tomorrow: Chapter 1,38,11,2.99,27
962700,Chronicle of Innsmouth: Mountains of Madness,50,12,19.99,38
1502040,大衍江湖 - Evolution Of JiangHu,403,218,9.99,185
1558970,Hair of the Dog,51,1,0.0,50
982720,Paradise Lost,1087,531,14.99,556
1530630,Couch Monsters,43,0,14.99,43
1496990,Barrage Fantasia,10,0,9.99,10
1556860,Role Player: Full Immersion,129,36,0.0,93
1536600,Digital Diamond Baseball V9,17,2,9.99,15
1450080,The Legend of Heroes: Sen no Kiseki III,201,34,44.99,167
1516900,RASPBERRY MASH,18,6,14.99,12
272230,Sub Rosa,2290,701,19.99,1589
1426210,It Takes Two,90731,3749,39.99,86982
1094730,Black Legend,117,61,19.99,56
1550080,LootLite,23,3,6.99,20
1037750,Looking for Heals,81,22,9.99,59
1037130,Dandy Ace,769,86,19.99,683
1044980,Mech Mechanic Simulator,299,128,19.99,171
1009560,The Tenants,3826,780,19.99,3046
1299480,The Fabled Woods,74,47,3.99,27
1388590,Yakuza 6: The Song of Life,2991,192,19.99,2799
1056600,Home Sweet Home : Survive,4504,3605,6.99,899
1256060,Cosmodread,288,25,14.99,263
491540,The Bus,2625,797,24.99,1828
1519890,Tiny Space Academy,26,17,9.99,9
1508570,Summer~Life in the Countryside~,279,101,18.99,178
1568190,Cat's Life Jigsaw Puzzles,7,0,2.99,7
1169740,Danger Scavenger,228,56,1.99,172
1243880,Evil Inside,70,67,12.99,3
1483300,MazM: The Phantom of the Opera,33,13,14.99,20
604510,Empires in Ruins,108,21,17.99,87
1527930,RHEM III SE,17,2,9.99,15
1509230,Prop Hunt,39,55,1.99,-16
1341050,BALAN WONDERWORLD,193,122,39.99,71
1519900,MASAGORO,33,11,12.99,22
840390,Spacebase Startopia,300,210,39.99,90
1455660,Out of the Park Baseball 22,1371,229,0.0,1142
1569650,Palladise Island,89,9,0.99,80
1343040,Blocky Ball,58,13,0.0,45
1195560,Alek - The Lost Kingdom,173,44,19.99,129
853140,Adeptus Titanicus: Dominus,345,197,0.0,148
735290,Genesis Noir,805,199,14.99,606
1568280,Evil Buster,2,7,3.99,-5
829280,Kaze and the Wild Masks,669,21,19.99,648
1268960,pureya,1819,25,5.99,1794
1561600,Coeus Plan,2,4,19.99,-2
1557840,Maze,49,5,0.0,44
1203630,Record of Lodoss War-Deedlit in Wonder Labyrinth-,4678,321,19.99,4357
1399840,Neptunia Virtual Stars,198,153,39.99,45
1566810,Emerland Solitaire 2 Collector's Edition,3,3,6.99,0
1157700,Pro Wrestling Sim,181,11,19.99,170
1534340,Fi da Puti Samurai,67,2,9.99,65
1346830,I Saw Black Clouds,219,123,4.93,96
700600,Evil Genius 2: World Domination,6625,3337,39.99,3288
1069530,Narita Boy,742,177,8.74,565
1252600,ANOTHER EDEN,832,375,0.0,457
1140030,AMazing TD,21,15,14.99,6
977630,Shelter 3,160,139,19.99,21
1144020,GolfTopia,374,11,19.99,363
1299790,Be Hero,79,6,12.99,73
1517340,From The Darkness,1412,130,6.99,1282
1263540,Mystery Solitaire. Dreamcatcher,4,0,4.99,4
1493800,Aircraft Carrier Survival: Tutorial,824,328,0.0,496
1463140,Destructo,7,8,6.99,-1
944920,Nanotale - Typing Chronicles,428,101,19.99,327
1483890,Loopomotive,19,4,0.0,15
1576830,Fruit Sudoku,5,0,0.99,5
1294650,The Mansion,73,14,6.99,59
1092950,Piposh,112,7,44.99,105
1426310,Dee-6: Dice Defenders,30,9,4.99,21
1499520,Spiritwish,19,22,0.0,-3
1508730,末日血战,9,13,0.0,-4
1515180,Junkyard Simulator: First Car (Prologue 2),302,126,0.0,176
781130,Creatura,80,21,11.24,59
621070,Legends of Ellaria,474,283,24.99,191
680420,OUTRIDERS,37517,19753,39.99,17764
1559430,Purrfect Apawcalypse: Purrgatory Furever,104,1,5.99,103
508440,Totally Accurate Battle Simulator,88348,1861,19.99,86487
1448260,下一站江湖Ⅰ,377,140,19.99,237
1536610,OpenTTD,7022,291,0.0,6731
1557740,ROUNDS,11031,520,5.99,10511
1358260,Conqueror 940 AD,27,9,9.99,18
1534850,Floor Plan 2,46,6,17.49,40
1011670,Totally Reliable Delivery Service,483,117,14.99,366
1449630,Crash Dive 2,124,6,11.99,118
1552430,Keeper of the Day and Night,26,1,5.99,25
1573730,Helicopter Simulator VR 2021 - Rescue Missions,108,20,17.99,88
1532750,Jigsaw Pieces 2 - Shades of Mood,5,0,9.99,5
1488380,Superstar Racing,85,61,0.0,24
1476970,IdleOn - The Idle MMO,7243,858,0.0,6385
1279280,Welcome to the Adventurer Inn!,57,35,19.99,22
1018830,Element TD 2 - Tower Defense,1850,167,14.99,1683
1139160,Divided Reigns,95,5,14.99,90
1577530,Spider-Robots War,16,5,2.99,11
1546320,Your Chronicle,760,176,0.0,584
1543080,Cute Honey 3,386,216,1.99,170
432410,The Sacred Stone,11,21,0.49,-10
448060,X-17,32,37,0.49,-5
1433990,NGU INDUSTRIES,1174,270,0.0,904
1576790,FPS Tactics,6,8,9.99,-2
1447330,Born Race,36,0,1.99,36
1481080,DRAMAtical Murder,1139,43,19.99,1096
1178230,The Wild Case,115,17,8.99,98
648410,Colony Ship: A Post-Earth Role Playing Game,532,95,29.99,437
599610,Lost Words: Beyond the Page,338,13,14.99,325
1286770,Internet Court,20,7,6.99,13
1104280,The Slormancer,2537,636,14.99,1901
1140620,CosmicBreak Universal,652,459,0.0,193
668550,8Doors: Arum's Afterlife Adventure,556,159,19.99,397
1458100,Cozy Grove,4236,469,14.99,3767
1069650,Ultimate Admiral: Age of Sail,1251,297,29.99,954
1536470,a guard walks into a tavern,120,12,7.99,108
1082430,Before Your Eyes,8172,180,4.99,7992
1452870,Roads of Time 2: Odyssey,6,1,4.99,5
11550,Second Sight,111,20,9.99,91
733460,First Feudal,342,104,19.99,238
1558990,Siege of Avalon: Anthology,159,18,3.99,141
1301930,Traffic Jams,50,11,19.99,39
1495860,What The Dub?!,205,15,7.99,190
1480410,Sentinel: Cursed Knight,13,4,4.99,9
1385380,Across the Obelisk,1841,115,19.99,1726
1502230,Tower of Waifus,196,73,1.99,123
1038370,Trials of Fire,2342,312,19.99,2030
1554840,Toree 3D,816,26,0.99,790
1543590,Wildshape - Map Editor (free demo),60,15,0.0,45
1191900,Say No! More,875,104,6.74,771
1198090,The Legend of Heroes: Trails of Cold Steel IV,1494,94,59.99,1400
1239020,TOGETHER BnB,3297,1550,17.99,1747
1405470,Scars of Summer,688,230,19.99,458
1583570,СИМУЛЯТОР ОДИНОЧЕСТВА В РУССКОЙ ДЕРЕВНЕ,412,134,1.99,278
1243360,Sigma Draconis,17,6,10.99,11
1048350,Nigate Tale,448,156,19.99,292
1557690,三国演义之蜀汉传奇,11,7,6.99,4
632300,Hobo: Tough Life,4896,1029,29.99,3867
1334000,Wordle,437,67,1.99,370
1373250,Lonely Birds,9,0,13.99,9
1447470,全战天下,44,13,0.0,31
1357220,PogoChamp,25,1,9.99,24
1522140,Demon Skin,77,17,14.99,60
1533960,Liars Village,2,1,6.99,1
1569550,Dread X Collection: The Hunt,267,22,9.99,245
1497600,Poker Squadrons,14,2,4.99,12
1015890,TASOMACHI: Behind the Twilight,299,89,19.99,210
1546350,Detective Riddles - Sherlock's Heritage 2,3,1,4.99,2
1546360,Easter Riddles,3,1,4.99,2
1487430,Muse:Night Out,130,112,2.99,18
1536070,Sword and Fairy 3,931,176,7.99,755
1538460,Sword and Fairy 2,694,90,5.99,604
1476760,Amazing Fix,24,0,9.99,24
720620,TaleSpire,2500,145,24.99,2355
1048660,Knight Squad 2,160,10,14.99,150
1536080,Sword and Fairy 3 Ex,234,48,7.99,186
1546570,Sword and Fairy,2441,59,4.99,2382
1576240,The Shadow of Yidhra,711,35,6.59,676
646240,Bacon May Die,593,34,0.0,559
1213230,Rain on Your Parade,538,10,14.99,528
1575040,Starlight X-2: Space Sudoku,6,0,6.99,6
1413870,Shadow Man Remastered,810,45,19.99,765
1497180,Nemesis: Race Against The Pandemic,15,17,0.51,-2
1273690,Ashwalkers,118,29,11.99,89
1571440,Lunch Lady,7364,1211,4.99,6153
732050,Voxel Tycoon,1083,175,24.99,908
1406250,Tanuki Justice,22,4,14.99,18
651150,Quantum League,1743,557,9.99,1186
1266890,Tactical Troops: Anthracite Shift,33,11,4.49,22
1494370,Insights - Maniac Vortex,9,0,7.99,9
1587560,100 hidden cats,838,48,0.99,790
795420,The Darkside Detective: A Fumble in the Dark,822,20,12.99,802
1588940,Storm Tale 2,26,4,9.99,22
1003120,Hitchhiker - A Mystery Game,75,25,14.99,50
1541020,Kakele Online - MMORPG,73,13,0.0,60
946990,Secret Government,157,86,24.99,71
1530720,Sport Mode,319,56,9.99,263
1295270,SaGa Frontier Remastered,416,36,24.99,380
1329600,Karting,397,56,1.99,341
1441840,FALL IN LABYRINTH,579,33,19.99,546
1591290,Tree Simulator 2022,970,27,2.99,943
1158720,Causality,159,11,3.49,148
978460,Emily is Away <3,3508,217,9.99,3291
1568330,Samurai Chess,21,4,1.99,17
1510460,Chicken Invaders Universe,1538,109,0.0,1429
1576720,Armageddon Empires,20,3,9.99,17
1421250,Tiny Bunny,8339,108,12.99,8231
1519790,Fast Food Manager,144,54,14.99,90
1092140,Exit From,436,50,4.99,386
1342790,GangV | VR & PC Battle Royale,321,154,10.49,167
968760,Blood Card 2: Dark Mist,183,29,5.99,154
1588870,iBLiS,165,180,9.99,-15
1356860,Project Boost,11,1,5.99,10
676070,an Orc's Tale: Kriegsruf,25,7,0.0,18
1432710,新魔剑（New Magic Sword）,25,34,0.0,-9
1177400,江湖余生：缘起,445,127,8.39,318
1587090,The Journey - Episode 1: Whatever This Is,254,4,1.99,250
1524650,Sakura Forest Girls,31,4,9.99,27
1265510,Machinist,14,9,0.0,5
578540,Perfect Gold - Yuri Visual Novel,681,10,7.99,671
1523720,Cook-Out,133,15,19.99,118
1337530,Maskmaker,164,10,19.99,154
1272070,Silicon Dreams  |  cyberpunk interrogation,159,6,14.99,153
1029550,Torque Drift,5287,1780,0.0,3507
1506850,Cards & Tankards,435,18,0.0,417
1572440,Bakery Shop Simulator,159,72,14.99,87
1502970,Atelier Sophie: The Alchemist of the Mysterious Book DX,397,41,39.99,356
1502990,Atelier Lydie & Suelle: The Alchemists and the Mysterious Paintings DX,138,9,39.99,129
1502980,Atelier Firis: The Alchemist and the Mysterious Journey DX,129,35,39.99,94
1205450,Turnip Boy Commits Tax Evasion,6062,356,14.99,5706
1554220,Paleon,132,19,9.99,113
1543550,Eviron's Chronicles,14,5,0.0,9
1447000,MotoGP™21,1250,291,39.99,959
1016600,Devil Slayer - Raksasi,2174,359,14.99,1815
945740,Buildings Have Feelings Too!,30,35,19.99,-5
1571960,The Corpsmen,23,12,19.99,11
1094540,Smelter,119,40,19.99,79
1113560,NieR Replicant™ ver.1.22474487139...,16234,2195,59.99,14039
1184890,Fleeting Iris,301,121,19.99,180
1549060,WAIFU IMPACT,85,12,5.99,73
1396150,Sutekina kanojo no tsukurikata,368,533,9.99,-165
1596640,Dark Chronicles: The Soul Reaver,28,7,5.09,21
1347630,Key To Heaven,104,42,0.0,62
1388320,老板，游戏凉了！- Game Company Simulator: back to 2000,152,78,4.99,74
1596310,Crypto Mining Simulator,507,278,9.99,229
1548820,Happy Puzzle,255,37,1.99,218
1558100,PixPhys,104,32,3.99,72
1458420,Nightfall,26,15,0.0,11
1577660,Trash Quest,60,2,2.99,58
1506280,Erophone,1831,450,4.99,1381
1459500,Atlas Architect,148,25,5.99,123
1595250,Dirty Blood,5,3,0.0,2
843180,Clan O'Conall and the Crown of the Stag,100,5,7.99,95
1548510,Drawing,272,87,0.0,185
1591860,审判者,120,215,9.99,-95
1598600,Robin Hood: Hail to the King,12,2,6.99,10
1407200,World of Tanks,27467,6544,0.0,20923
1530440,Balance Ball,9,2,0.99,7
1490680,God Sword,14,25,49.99,-11
1385100,Insurmountable,451,67,24.99,384
829590,CryoFall,3929,966,19.99,2963
1597400,LOST EGG 2: Be together,150,23,2.99,127
978520,Legend of Keepers: Career of a Dungeon Manager,2884,647,19.99,2237
1530770,Star Wars™ Pinball VR,60,94,24.99,-34
664000,HammerHelm,240,51,14.99,189
1556200,Predator: Hunting Grounds,1410,381,29.99,1029
885970,Total War: ROME REMASTERED,5812,2186,29.99,3626
1593860,Girl Jigsaw,204,52,0.99,152
1558630,Limitless Bit,13,2,6.99,11
1573580,CATch the Stars: Japan,76,3,0.99,73
1124600,Naau: The Lost Eye,25,16,24.99,9
1540220,Sugar * Style,172,4,29.99,168
1604020,Many Bricks Breaker,53,19,2.99,34
1545450,Incredibox,1362,34,4.99,1328
1585540,Snow-Swept Quest,214,26,9.99,188
1251850,Inferno - Beyond the 7th Circle,32,9,16.99,23
1285920,VR Skater,167,19,19.99,148
1394930,MAMIYA,74,1,16.99,73
1509090,Seek Girl Ⅷ,272,216,1.99,56
1442820,R-Type Final 2,464,139,39.99,325
1564560,Island Farmer - Jigsaw Puzzle,233,17,1.39,216
442210,Switchcars,388,40,8.99,348
1617370,Bridge to Another World: Endless Game Collector's Edition,6,1,9.99,5
1280060,Hoverflow,8,0,8.99,8
1408100,Penimorta,167,49,0.0,118
1527260,The Last Town: Excape,42,13,0.99,29
431950,Age of Fear 4: The Iron Killer,34,7,14.99,27
1141550,CUCKOLD SIMULATOR: Life as a Beta Male Cuck,1295,80,2.99,1215
1494140,7Days Origins,117,16,8.99,101
1495420,Dragon Creek,99,16,14.99,83
1024850,Flow Weaver,3,0,19.99,3
1604240,Sumotori Dreams Classic,91,6,4.99,85
1566410,Touhou Kouryudou ~ Unconnected Marketeers.,1521,30,14.99,1491
1609470,The Frog Game,5,3,0.99,2
1589880,Tower Of Wishes: Match 3 Puzzle,5,0,7.99,5
1574910,The Bart Bonte collection,51,1,9.99,50
1554400,Paint Chips,117,9,0.0,108
1565670,Five Nations,110,18,19.99,92
1244520,2D Baseball Duel,13,1,7.99,12
1599690,WORDLAND,30,1,1.99,29
1472540,Save me Mr Tako: Definitive Edition,27,1,14.99,26
1612200,Blokker: Orange,28,0,1.99,28
1422180,Galactic Crew II,12,14,13.99,-2
1484280,Demeo,1134,101,23.99,1033
1561750,Mission in Snowdriftland - Snowlogue,201,20,0.0,181
1608200,The Far Kingdoms: Forgotten Relics,8,2,5.99,6
1544430,Golf With Your Grandmother,7,3,4.99,4
1196590,Resident Evil Village,73926,3145,39.99,70781
1610790,Cossack and Magic,13,0,0.99,13
1470020,Dudes on a Map: Virtual Grid Paper,26,2,0.0,24
1432500,The Sekimeiya: Spun Glass,100,7,29.99,93
1123830,Farm Manager 2021,1201,323,19.99,878
1361670,Skate City,85,13,14.99,72
1487590,Yoshiwara Higanbana,201,11,44.99,190
1540960,Underworld Idle,378,152,0.0,226
937310,Infinitode 2 - Infinite Tower Defense,1767,140,0.0,1627
1491340,Marble World,466,41,11.99,425
593640,Papetura,655,48,11.99,607
1530890,Car Constructor,43,24,0.49,19
1347970,Patch Quest,361,7,13.99,354
1509960,PICO PARK,13583,1126,4.99,12457
1521980,Giants,25,24,0.0,1
628200,The Invisible Hand,258,55,12.99,203
1219590,HEAT REBORN,144,93,0.0,51
1502660,Untrusted,790,124,0.0,666
1600170,Solitaire Legend of the Pirates 3,1,0,4.99,1
927350,Hood: Outlaws & Legends,3698,3824,19.99,-126
1542060,Forgotten Spirits,14,1,9.99,13
1380760,Color Crush 2,5,5,5.99,0
1441230,Tanto Cuore,138,9,9.99,129
1599510,Deadly Threat,13,14,3.99,-1
1351500,SimPocalypse,69,29,9.99,40
1417950,Simon the Sorcerer 3D,6,4,5.99,2
1471040,Base One,164,208,24.99,-44
1377580,Soulworker,6329,2074,0.0,4255
1340180,Sherwood Extreme,201,49,0.0,152
1248060,Realpolitiks II,241,247,34.99,-6
1127970,Retro Machina,137,18,16.99,119
1439970,Broken Sky,9,1,7.99,8
598550,HUNTDOWN,1714,88,19.99,1626
1565290,"Survival Horror #8,436",13,13,0.0,0
848450,Subnautica: Below Zero,61536,5857,29.99,55679
1042380,Hundred Days - Winemaking Simulator,483,143,24.99,340
1073910,Before We Leave,902,223,19.99,679
1523390,Fantasy Tavern Sextet -Vol.3 Postlude Days-,145,16,12.99,129
1599470,Purrfect Apawcalypse: Patches' Infurno,116,1,6.99,115
952240,Dieselpunk Wars,85,42,14.99,43
1306630,Lost Ruins,2883,317,19.99,2566
1509790,The Other: Rosie's Road of Love,8,0,4.99,8
1435010,Succubus★Connect!,269,87,24.99,182
1585910,Roll,265,19,4.99,246
1611850,The Marionette 提线木偶,12,1,1.99,11
1361680,cyberpunkdreams,435,135,0.0,300
1328670,Mass Effect™ Legendary Edition,27137,1935,59.99,25202
1503850,中年失业模拟器When a man lose his job,224,67,3.59,157
1439220,Conquest: Medieval Kingdoms,7,5,2.49,2
1567800,星空列车与白的旅行,1268,11,19.99,1257
1183580,Terra Alia: The Language Learning RPG,38,16,19.99,22
1578950,Lady in Mystery,98,3,24.99,95
1600250,Jurassic mahjong,2,0,0.49,2
1259420,Days Gone,35504,2662,49.99,32842
1402020,SCP: Labrat,1278,111,0.0,1167
1482490,SEIKEN-MANIFESTIA,104,6,39.99,98
915310,SNKRX,3547,146,2.99,3401
1465360,SnowRunner,11119,1584,27.49,9535
1460540,Farlanders: Prologue,215,13,0.0,202
1218500,Galactic Mining Corp,634,91,12.99,543
1527520,Bombing!!: A Graffiti Sandbox,75,3,6.99,72
1586880,Essays on Empathy,79,17,12.99,62
1167140,Siege Survival: Gloria Victis,841,182,24.99,659
1567830,蛋蛋掌门日志,26,32,7.99,-6
1419350,Outbreak: Endless Nightmares,14,11,14.99,3
1093290,The Wild at Heart,271,10,24.99,261
1361010,Vampires Dawn 3 - The Crimson Realm,536,79,15.99,457
1363360,Noch,90,30,6.99,60
1416230,Panzer Knights,888,186,24.99,702
1343640,Polyville Canyon,102,8,1.99,94
657000,Rising Hell,226,17,9.99,209
1579260,Disc Golf Valley VR,32,16,19.99,16
1389550,Mind Scanners,507,98,16.99,409
1413480,Shin Megami Tensei III Nocturne HD Remaster,2008,269,49.99,1739
826740,Rise of the Slime,70,33,14.99,37
1432200,Not Another Weekend,60,1,10.99,59
1406780,Viscerafest,385,34,14.99,351
979070,Just Die Already,1349,333,5.99,1016
1271850,Grand Casino Tycoon,31,19,17.99,12
622680,Mayhem in Single Valley,184,14,14.99,170
1068360,Fearmonium,231,29,12.99,202
1237510,"Dr Livingstone, I Presume? Reversed Escape Room",55,6,14.99,49
1431610,Prison Simulator Prologue,2400,256,0.0,2144
1364100,Lacuna – A Sci-Fi Noir Adventure,1078,65,7.99,1013
1519070,SGS Halls of Montezuma,19,5,24.99,14
1399590,Strike Buster Prototype,558,68,3.99,490
1381850,Strategic Mind: Fight for Freedom,90,7,29.99,83
978300,Saints Row®: The Third™ Remastered,981,593,39.99,388
1572340,Ark of Artemis,159,25,17.99,134
1613680,Arrow Sudoku,59,1,4.99,58
1638920,Mystery Trackers: Nightsville Horror Collector's Edition,3,2,9.99,1
1542710,Dreams of an Exile,13,1,2.99,12
1365750,东方栖霞园 ~ Blue devil in the Belvedere.,289,25,9.99,264
1301210,Knockout City™,6174,974,0.0,5200
1515950,Capcom Arcade Stadium,1348,1365,0.0,-17
1613050,Flex hooks,40,2,0.99,38
1569340,Dwarves Craft. Father's home,2,0,5.99,2
1487680,Broken Universe - Tower Defense,85,8,9.99,77
1611280,G-MODEアーカイブス09 フライハイトクラウディア2,1,0,4.99,1
1514930,Erica,996,264,11.99,732
1270670,Touhou Double Focus,44,17,10.99,27
597820,BIOMUTANT,11047,5360,59.99,5687
1369520,Strangeland,507,27,14.99,480
629820,Maneater,8190,948,19.99,7242
280720,Imagine Earth,572,134,24.99,438
1386870,Wraith: The Oblivion - Afterlife,34,27,19.99,7
1209410,King of Seas,344,246,9.99,98
1246250,An Airport for Aliens Currently Run by Dogs,141,11,19.99,130
1005120,Touhou Genso Wanderer -Lotus Labyrinth R-,230,55,34.99,175
1335230,Sumire,220,6,9.99,214
1233590,Warhammer Age of Sigmar: Storm Ground,560,330,19.99,230
944250,Castle Flipper,469,259,18.99,210
1518820,Horse Club Adventures,54,4,29.99,50
1371690,GRAVEN,407,173,24.99,234
1578890,Murder at Midnight,10,0,7.99,10
1569090,Vivid Knight,1267,117,14.99,1150
1405810,Wedding Designer Prologue,105,50,0.0,55
784080,MechWarrior 5: Mercenaries,4721,899,29.99,3822
1199030,Tainted Grail: Conquest,5250,474,19.99,4776
1010560,Here I Come,2,5,9.99,-3
1497950,EARTH DEFENSE FORCE: WORLD BROTHERS,470,109,39.99,361
1295790,The Longest Road on Earth,240,43,9.99,197
1631500,Dumpy and Bumpy,28,1,4.99,27
1475670,Invincible Cleopatra: Caesar's Dreams,2,3,11.99,-1
1096530,Solasta: Crown of the Magister,10929,1321,15.99,9608
1397650,Jetborne Racing,361,32,4.99,329
1316230,Force of Nature 2: Ghost Keeper,895,143,15.99,752
1366770,Pecaminosa - A Pixel Noir Game,36,7,14.99,29
1463430,Niinamigota,5,2,0.99,3
1508680,Love n War: Warlord by Chance,955,130,2.99,825
1546010,Fallen girl - Black rose and the fire of desire,765,293,14.99,472
1634940,The Altered Lands,16,9,0.99,7
1551510,Psychic Guardian Super Splendor,96,32,19.99,64
1562260,Camping Simulator: The Squad,421,187,4.99,234
1274360,幽灵高校(Ghost College),278,59,0.0,219
1372530,Fly Corp,845,134,11.99,711
1642330,Fairy Godmother Stories: Puss in Boots Collector's Edition,2,3,9.99,-1
1540560,Operator,707,488,0.99,219
1611460,Hide and Run,169,21,2.99,148
1510950,NKODICE,390,13,9.99,377
1542790,SRX: The Game,115,13,39.99,102
1167700,hallucination - 幻觉,156,15,9.99,141
821820,Farmer's Fairy Tale,18,14,29.99,4
1222370,Necromunda: Hired Gun,3384,1470,39.99,1914
1375400,Ghosts 'n Goblins Resurrection,478,84,29.99,394
1114070,My Child Lebensborn,1015,65,7.99,950
1601680,The Advisor - Episode 1: Royal Pain,434,6,2.99,428
1617090,Setup Developer Tool 2021,4,2,19.99,2
1516400,Gaia Project,162,60,24.99,102
1278060,FPV.SkyDive : FPV Drone Racing & Freestyle Simulator,398,102,0.0,296
1029780,Going Medieval,10825,1226,24.99,9599
1595710,Chased by Darkness,204,77,4.99,127
1335790,Operation: Tango,3981,467,19.99,3514
601840,Griftlands,11436,593,19.99,10843
1255650,Geometry Arena,2035,60,4.01,1975
1610700,Clutter 1000,6,0,9.99,6
1651890,Haunted Hotel: Phoenix Collector's Edition,3,0,9.99,3
1529550,The Magnificent Trufflepigs,73,53,11.99,20
1179060,Wing of Darkness,81,106,29.99,-25
1639610,"Save Me, Sakuya-san!",440,10,2.99,430
824000,Hokko Life,879,309,19.99,570
1144770,SLUDGE LIFE,483,26,14.99,457
1546920,Overboard!,287,26,14.99,261
1629200,Anima : The Reign of Darkness,365,153,11.99,212
1631540,Squeakers II,22,2,0.49,20
760630,Tennis Elbow Manager 2,156,18,29.99,138
1264280,Slipways,1449,98,16.99,1351
1105670,The Last Spell,4956,448,19.99,4508
1412560,Death Rattle - Hell Unleashed,14,4,16.99,10
1642220,FIND ALL,252,7,0.99,245
1454050,Tour de France 2021,67,20,39.99,47
1525660,Sunblaze,221,15,14.99,206
1453850,Pro Cycling Manager 2021,421,123,39.99,298
1197570,Until We Die,2566,975,16.99,1591
1078420,Critters for Sale,549,15,9.99,534
1046400,Astalon: Tears of the Earth,504,31,19.99,473
1464410,末日杀 Might & Trap: Apocalypse,11,3,19.99,8
1338770,Sniper Ghost Warrior Contracts 2,5274,954,39.99,4320
1394130,Breach Wanderers,97,7,14.99,90
1211830,Explorers of the Abyss,102,53,19.99,49
1650740,Grim Tales: Threads of Destiny Collector's Edition,4,0,9.99,4
1611490,[Chilla's Art] Night Delivery | 例外配達,570,139,2.99,431
1601970,Tunguska: The Visitation,110,18,15.99,92
1630910,SATANIC PANIC 666,50,8,0.5,42
993110,Skinwalker Hunt,431,28,12.99,403
1645640,No Ghost in Stay Home,51,2,0.99,49
760640,Tennis Elbow 4,185,17,29.99,168
1253710,Garbage,543,202,14.99,341
1645140,Apple Bang!,30,3,0.99,27
1015920,Ynglet,253,2,4.99,251
1426490,LOST EPIC,605,221,19.99,384
1299360,Mighty Goose,495,87,19.99,408
1175800,Command & Control 3,16,7,19.99,9
1544580,Would you like to run an idol café?,21,6,9.99,15
1088770,Car Mechanic Simulator VR,140,78,19.99,62
269190,Edge Of Eternity,2292,668,29.99,1624
1422190,Fuzz Force: Spook Squad,47,3,14.99,44
865610,Backbone,901,534,24.99,367
1642890,Disc Golf Valley,118,17,4.99,101
1382910,Hell Architect: Prologue,673,143,0.0,530
1624870,Mystery Solitaire Powerful Alchemist,3,0,4.99,3
995070,Rise Eterna,52,63,19.99,-11
1414180,Motesolo : No Girlfriend Since Birth,697,108,22.99,589
1420290,No More Heroes,631,205,19.99,426
1369760,[NINJA GAIDEN: Master Collection] NINJA GAIDEN 3: Razor's Edge,596,245,39.99,351
1420300,No More Heroes 2: Desperate Struggle,220,104,19.99,116
1636000,Tybot Invasion: The Typing Runner,22,0,1.99,22
1580780,[NINJA GAIDEN: Master Collection] NINJA GAIDEN Σ,1196,300,39.99,896
1580790,[NINJA GAIDEN: Master Collection] NINJA GAIDEN Σ2,755,259,39.99,496
1193430,Vapormaze,24,2,7.49,22
1196470,WE ARE FOOTBALL,917,269,34.99,648
1631130,审判者 高清重制全章节版,60,125,9.99,-65
1335240,放置勇者：远征/Idle Heroes:Odyssey,271,243,5.99,28
1192010,Open Country,139,229,14.99,-90
1599150,Warlike,21,6,3.99,15
1476100,A Rogue Escape,25,5,19.99,20
1523400,Livestream: Escape from Hotel Izanami,382,82,19.99,300
1021940,Space Warfare,36,23,0.0,13
1601860,Warp Factory,37,2,9.99,35
520950,DRIFT21,1306,448,29.99,858
1123450,Chicory: A Colorful Tale,1835,39,19.99,1796
1425130,Forgotten Hill First Steps,65,3,2.99,62
1146300,Land of War - The Beginning,260,238,19.99,22
1582510,Mercenaries Blaze,324,96,19.99,228
1635020,Untitled Marble Game,34,2,3.99,32
1277940,Kinkoi: Golden Loveriche,1044,23,34.99,1021
1609230,Scarlet Hollow,569,4,19.99,565
1408570,Stand 'em Up,33,3,7.99,30
1627610,Jgsw,15,0,8.99,15
400750,Call to Arms - Gates of Hell: Ostfront,4680,1038,0.0,3642
1446470,Dome Discover,22,7,9.99,15
1384160,GUILTY GEAR -STRIVE-,26351,2391,59.99,23960
1597440,Wax Museum - Seek and Find - Mystery Hidden Object Adventure,19,5,4.99,14
1485120,BoomBox,121,12,19.99,109
1378020,Beasts of Maravilla Island,232,20,9.99,212
1631640,异变战区  E.E.R.I.E,333,83,14.99,250
1587710,Fossil Corner,181,2,9.99,179
1049710,Minute of Islands,290,62,19.99,228
976900,Lumberhill,116,24,14.99,92
1590660,Mr. Hopp's Playhouse 2,405,27,3.99,378
1334010,Last Room,232,109,2.99,123
1617270,The Faraway Land,42,6,11.99,36
1388770,Cruelty Squad,8013,232,19.99,7781
763890,Wildermyth,12399,637,24.99,11762
1374840,Dark Deity,1349,415,12.49,934
895620,Spellcaster University,2404,470,24.99,1934
1250440,Garlic,243,18,16.99,225
1049850,UFO2: Extraterrestrials,66,46,34.99,20
1219080,Dice Tactics,3,3,0.0,0
1651780,Sophie's Safecracking Simulator,45,2,2.99,43
1502710,Agent Intercept,34,5,19.99,29
1477790,Luna's Fishing Garden,1018,46,7.99,972
1451160,Bakumatsu Renka SHINSENGUMI,13,7,49.99,6
1605010,Adorable Witch,1256,128,1.99,1128
1640100,War Mines: WW1,35,1,1.99,34
768520,Red Solstice 2: Survivors,1872,755,29.99,1117
1637970,LOGistICAL 3,16,4,9.99,12
1592740,Railroad Ink Challenge,56,8,7.99,48
1076200,Roguebook,2097,368,24.99,1729
1655430,Witchaven II: Blood Vengeance,5,1,2.71,4
963870,Valor & Victory,77,37,19.99,40
1545290,Sword and Fairy 5 prequel,61,12,12.99,49
1360550,Summertime Madness,53,13,8.99,40
1621680,Sword and Fairy 4,102,31,12.99,71
1560770,Tower of Waifus 2,150,37,1.99,113
421190,Larcenauts,138,56,29.99,82
1650610,Flight 74,17,2,19.99,15
997010,Police Simulator: Patrol Officers,6944,1123,24.99,5821
1569930,Sword and Fairy 5,25,17,12.99,8
1562920,7 Years From Now,39,0,9.99,39
1644840,Kittens and Yarn,108,6,1.99,102
1647190,World End Diner,247,13,14.99,234
1669820,Haunted Hotel: A Past Redeemed Collector's Edition,5,0,9.99,5
1634680,Ficket: 追剧引擎,374,135,3.99,239
1235800,Oneiro,35,1,4.99,34
1420650,Touhou Bunkachou ～ Shoot the Bullet.,29,0,10.99,29
1571950,Slick Racing Game,28,14,12.99,14
1532760,Jigsaw Pieces 3 - Fantasy,17,0,9.99,17
1342100,Evening Starter,86,19,14.99,67
1606940,The Mystery of Caketropolis,63,0,9.99,63
1313580,CryptoClickers: Crypto Idle Game,102,57,0.0,45
1310990,Bishojo Mangekyo Kotowari to Meikyu no Shojo,2186,86,29.99,2100
722180,SURV1V3,1255,279,24.99,976
1482910,Idle Monster TD,502,178,0.0,324
623280,Dungeons & Dragons: Dark Alliance,2219,2244,29.99,-25
1600550,Imaginaria,11,0,5.99,11
1369630,ENDER LILIES: Quietus of the Knights,17358,849,24.99,16509
981890,Olympic Games Tokyo 2020 – The Official Video Game™,1145,1372,39.99,-227
1515140,Huntfeast,11,12,9.99,-1
989440,Phantom Abyss,1626,251,24.99,1375
427940,Industries of Titan,808,293,29.99,515
1502540,The Sisters - Party of the Year,4,0,11.99,4
1517150,Vedelem: The Golden Horde,572,58,0.0,514
1333470,Alex Kidd in Miracle World DX,365,61,19.99,304
1610120,MY FOX - Desktop Wild Pet,29,12,3.99,17
1205170,Super Magbot,135,9,4.49,126
1544360,LEGO® Builder's Journey,2026,430,19.99,1596
1270620,Project Chemistry,74,9,12.99,65
252870,PULSAR: Lost Colony,4295,399,24.99,3896
1421790,Labyrinth City: Pierre the Maze Detective,1441,45,11.99,1396
1647250,KUUKIYOMI 3: Consider It More and More!! - Father to Son,44,8,4.99,36
1620110,Slobbish Dragon Princess LOVE + PLUS,44,1,4.99,43
1672240,Surface: Lost Tales Collector's Edition,3,0,9.99,3
1124180,Rail Route,727,42,19.99,685
1475400,"Run Prop, Run!",495,97,0.0,398
1419290,Out of Line,142,10,4.49,132
1596750,Buddy and Lucky Solitaire,67,14,2.99,53
1624830,Path of Sacrifice,97,8,3.99,89
1596540,TAISHO x ALICE epilogue,228,6,4.99,222
1536420,Clip maker,66,26,0.0,40
1514980,Kingdom Builders,151,109,0.0,42
1175830,Legend of Mana,623,138,29.99,485
1260810,Touhou Blooming Chaos 2,2011,105,5.99,1906
775500,SCARLET NEXUS,8809,1541,23.99,7268
1676520,Hidden Expedition: A King's Line Collector's Edition,2,1,9.99,1
1518430,Eiyu*Senki Gold – A New Conquest,233,45,34.99,188
1181780,Ascendants Rising,9,20,19.99,-11
1591420,Hmmsim Metro,755,65,19.99,690
1432860,Sun Haven,2407,224,24.99,2183
673910,Wrestling Revolution 2D,40,1,4.99,39
1580420,Ambidextrous Psychopath,7,0,0.99,7
1663580,Thrice in a row: A new adventure,10,1,19.99,9
1617900,Head 2 Head,26,1,5.99,25
1420080,Wonder Boy: Asha in Monster World,82,18,34.99,64
1475650,12 Labours of Hercules XII: Timeless Adventure,12,1,11.99,11
1586820,The List,56,11,5.99,45
1623880,Noob - Les Sans-Factions,722,121,29.99,601
1637370,Letters From a Rainy Day -Oceans and Lace-,547,8,16.99,539
1490860,Til Nord,369,71,0.0,298
1519550,Rebellion Gaia,14,2,0.99,12
1137970,Zombies Ate My Neighbors and Ghoul Patrol,75,65,14.99,10
1664370,The Teleport,48,3,2.99,45
1195830,副作用之瞳-Tlicolity Eyes-,72,27,0.0,45
1446930,Merge & Blade,86,19,5.99,67
1463730,Arid,1126,171,0.0,955
1388880,Doki Doki Literature Club Plus!,15759,539,14.99,15220
1607670,Secret Agent HD,93,1,7.99,92
1516490,CompactO - Idle Game,48,15,2.99,33
965210,Café International,13,3,9.99,10
1648460,Space One - Electron,6,3,0.69,3
1543150,The Fermi Paradox,516,140,18.99,376
1451480,The Greatest Penguin Heist of All Time,718,102,14.99,616
1578860,Billionaire Lovers,2487,102,2.99,2385
1620340,Wrestling Empire,786,46,19.99,740
1537980,Myriavora,6,0,12.99,6
1351630,Ys IX: Monstrum Nox,1096,56,59.99,1040
1620540,Pixel Cup Soccer - Ultimate Edition,146,21,9.99,125
1546380,Fill and Cross Pirate Riddles,3,6,4.99,-3
1655850,Vacation Adventures: Park Ranger 6,1,0,6.99,1
1120810,Eastern Exorcist,4913,833,17.99,4080
1573350,Coastline Flight Simulator,11,4,19.99,7
1639430,Princess&Blade,456,98,9.99,358
1192380,TOTALLY BASEBALL,110,5,14.99,105
1552960,John Christian,24,7,4.99,17
1673530,Fantasy Mahjong connect,16,14,3.99,2
744260,Legend of Homebody,314,71,4.19,243
986350,Nemezis: Mysterious Journey III,60,35,19.99,25
1170060,Boomerang X,616,27,19.99,589
1523290,Blacksmith Legends: Prologue,84,45,0.0,39
1277400,Monster Hunter Stories 2: Wings of Ruin,10685,2387,59.99,8298
346820,Crash Drive 3,233,27,19.99,206
1458390,Rule No. 1,209,16,3.99,193
752480,Sniper Elite VR,342,252,29.99,90
1418100,Swords of Legends Online,3682,1672,0.0,2010
1631160,Logic Car,23,3,7.99,20
1451880,Color Breakers,22,0,14.99,22
508710,Project Lounge,52,20,0.99,32
1648590,UndercoverAgent,596,125,7.99,471
1143810,Black Skylands,979,126,19.99,853
1547290,"Nina Aquila: Legal Eagle, Season One",58,1,8.99,57
1618280,Idle Tentacles,6,17,0.99,-11
1674060,The Search For Fran,84,14,0.99,70
1465190,古代人生 Ancient Life,44,51,4.99,-7
1592120,Paladin Dream,6,2,4.99,4
1547160,无限跳跃/Infinite Jump,201,62,1.59,139
1336600,Cabin Fever,270,12,9.99,258
717110,Claire de Lune,25,11,39.99,14
1348800,PROJECTIONS,54,1,12.99,53
1604060,Cricket Captain 2021,43,17,12.99,26
1630590,Paint Drying Simulator,82,4,0.99,78
1665050,Griddlers TED and PET 2,2,0,4.99,2
1680300,Spades,2,2,3.99,0
1674440,Submarine War,19,4,0.64,15
1293180,SuchArt: Genius Artist Simulator,2515,58,24.99,2457
1385920,Impossible Pixels,7,0,9.99,7
975270,军团战棋Legion War,670,63,9.99,607
1626890,坏小孩,1095,29,2.99,1066
1660290,モン娘ぐらでぃえーた,36,2,4.99,34
1648730,S.O.T.A 2,187,113,4.99,74
1426730,The Immortal Mayor,1727,839,19.99,888
1076750,Dream Engines: Nomad Cities,279,88,29.99,191
1633660,Girl Jigsaw 2,268,47,1.99,221
1134570,F1® 2021,28536,4918,59.99,23618
1345820,Ragnarock,2108,111,16.24,1997
733820,Highrisers,44,61,2.79,-17
1408230,Walkabout Mini Golf VR,1512,24,14.99,1488
1278750,Lost At Sea,26,7,5.99,19
1591490,Distant Memoraĵo,106,0,19.99,106
1356580,Guild of Darksteel,17,3,12.99,14
1615100,The Last Stand Legacy Collection,1023,106,9.99,917
1273080,Raptor Boyfriend: A High School Romance,70,1,13.99,69
1618540,Ghost Exorcism INC.,3410,1186,17.99,2224
1665060,Halloween Patchwork Trick or Treat,3,2,0.49,1
1579850,夏まつりのハナビィ Hanaby's Summer Festival,35,1,19.99,34
1666510,Magical Valkyrie Lyristia,176,60,14.99,116
1568880,秘封フラグメント,93,4,7.49,89
1047640,Helios,30,14,9.99,16
1550510,Creepy Tale 2,575,82,9.99,493
1684080,Toroom,89,15,11.99,74
1673620,Rhythmetallic,8,1,3.99,7
875760,Furious Seas,169,59,13.99,110
1444420,WOMG Lite version,8,1,0.0,7
1587750,Fat Fritz 2.0 SE,1,1,79.99,0
933200,Ant Empire,22,9,6.99,13
1184820,Poker Quest,328,26,14.99,302
1675640,Planet B24,31,14,0.99,17
1127500,Mini Motorways,13145,548,9.99,12597
1659800,Sweet House,293,79,1.99,214
1378370,Fallen Knight,29,16,14.99,13
894020,Death's Door,10451,648,19.99,9803
1236780,AKIBA'S TRIP: Hellbound & Debriefed,88,25,29.99,63
1079830,Cris Tales,203,106,15.99,97
1671390,Ancient Dino Runner,9,2,12.99,7
1397790,Samurai Gunn 2,429,19,14.99,410
1646230,PEOPLEDOWN,1,0,4.99,1
1609080,Summer of '58,2242,213,8.99,2029
1488740,The Best BJ,9,1,4.99,8
1329350,蛊婆 Lady in Tomb,347,21,18.99,326
1435670,Song of Farca,529,93,19.99,436
1482750,Waves of Steel,144,14,19.99,130
1553230,Trailer Shop Simulator,78,30,19.99,48
1288420,The Secret of Retropolis,98,4,12.99,94
550840,Fresh Body,992,299,9.99,693
1552080,Deepest Chamber,85,37,12.99,48
1612480,Heal Hitler,122,41,4.99,81
1295500,"Warhammer 40,000: Battlesector",2706,294,25.99,2412
1684820,PEGGO!,53,22,3.99,31
1168610,Natural Instincts: European Forest,126,54,9.99,72
1678140,Shades of Sakura,260,111,1.09,149
1640710,Interregnum Chronicles: Signal,20,12,9.99,8
1122690,Last Stop,106,37,24.99,69
1524750,Dude Simulator 4,171,109,4.99,62
1522820,Orcs Must Die! 3,7115,1314,29.99,5801
1516080,That Time I Got Reincarnated as an Orc,243,26,18.99,217
1480030,A Way To Be Dead,65,27,6.99,38
1686690,408 - The Forbidden Room,7,4,2.99,3
1317950,Eternal Dreamers,65,9,0.0,56
882250,Metro Sim Hustle,205,46,19.99,159
1607280,YUME 2 : Sleepless Night,591,597,3.99,-6
1511830,Shadows Behind the Throne 2,32,7,7.99,25
1158850,The Great Ace Attorney Chronicles,3551,155,39.99,3396
758010,Big NEON Tower VS Tiny Square,24,0,4.99,24
821880,Idol Manager,2479,301,19.99,2178
1486630,Intravenous,1125,99,12.99,1026
1591530,SAMURAI WARRIORS 5,857,177,59.99,680
858820,Tribes of Midgard,10597,3008,19.99,7589
1434950,HighFleet,3809,489,29.99,3320
1263070,Blightbound,806,393,19.99,413
1688290,Destroy All The Cubes,11,1,0.99,10
1477920,Night Book,205,90,4.93,115
931070,Echo of Combats,111,38,0.0,73
1564110,Beside Myself,125,54,3.35,71
597170,Clone Drone in the Danger Zone,18291,563,19.99,17728
686810,Hell Let Loose,65532,11458,26.79,54074
1193590,Abomi Nation,79,11,19.99,68
969760,Omno,909,61,18.99,848
1016800,Chernobylite,7484,1484,29.99,6000
909380,Traditional Chinese Medicine Simulator,146,1,19.99,145
1173790,FINAL FANTASY III,1196,67,17.99,1129
1693000,Within the Range,154,29,11.99,125
1173770,FINAL FANTASY,3726,231,11.99,3495
1619790,Aggressor,72,57,19.99,15
1173780,FINAL FANTASY II,1021,305,11.99,716
1692900,CS Horizon,2,6,0.59,-4
1414400,Unnatural Disaster,8,3,9.99,5
874260,The Forgotten City,5673,183,24.99,5490
1674980,Viking Heroes 2,13,0,6.99,13
1357860,Fuga: Melodies of Steel,560,48,39.99,512
1555400,Gomoku Let's Go,439,44,2.99,395
814680,Unbound: Worlds Apart,561,72,9.99,489
1644150,OshiRabu: Waifus Over Husbandos ~Love･or･die~,348,66,12.99,282
1237070,The Cyclist: Tactics,54,1,17.99,53
1126110,Keep the Keep,21,0,4.99,21
1448780,Jewel Match Origins - Palais Imperial Collector's Edition,23,0,4.99,23
1273600,SPACE TOW TRUCK - ISAAC NEWTON's Favorite Puzzle Game,10,1,9.99,9
1075740,Banners of Ruin,1524,334,19.99,1190
1648100,Kinduo,60,2,1.99,58
1108590,Eldest Souls,1322,304,19.99,1018
1358140,Cooking Simulator VR,769,157,18.74,612
1588380,Blaster Master Zero 3,245,27,14.99,218
1602930,Pedro's Adventures in Spanish [Learn Spanish],52,7,19.99,45
1290350,Vampire: The Masquerade — Out for Blood,90,31,11.99,59
1614340,Matchsticks - Coffee Break Club,65,2,1.99,63
827330,Skydrift Infinity,58,10,9.99,48
755410,Vengeful Rites,226,13,9.99,213
979690,The Ascent,11266,3475,29.99,7791
1613490,Nothing To Remember,14,6,1.99,8
1346740,荧火微光,52,15,6.99,37
1689870,Meridian 157: Chapter 3,157,3,3.99,154
1689980,Yummy Mahjong,12,3,3.99,9
454120,Starbase,3712,2105,34.99,1607
337320,Paint the Town Red,18287,895,19.99,17392
1038820,拯救大魔王2:逆流 Falsemen2:Upstream,104,80,10.99,24
651490,No Longer Home,155,43,14.99,112
1549750,Vomitoreum,530,50,9.99,480
1709450,Grim Tales: The Heir Collector's Edition,7,1,9.99,6
1494470,BUSTAFELLOWS,278,25,39.99,253
1682580,Smithy Wars,19,4,3.99,15
1187130,Crimson Colosseum,86,25,14.99,61
1380650,Draft of Darkness,99,6,9.99,93
1689250,GATE,21,2,4.99,19
1683610,Profectus,1,0,4.99,1
1253880,Heart Fragment,79,8,0.0,71
1554790,Coloring Game 4,1368,89,0.0,1279
1673560,The Mysteries of Ranko Togawa: Murder on the Marine Express,16,0,4.99,16
1340640,HORROR TALES: The Wine,252,45,14.99,207
1492610,Moonshot - The Great Espionage,12,1,3.99,11
1187840,Vesper: Zero Light Edition,61,8,7.99,53
1530750,EVERSLAUGHT,248,44,19.99,204
1354230,Love Tavern,402,151,6.99,251
1659340,Be The ONE,10,0,1.99,10
1658050,Really Weird Pool,5,1,4.99,4
1696400,Movie Studio 18 Steam Edition,1,2,69.99,-1
1329510,Big Farm Story,773,207,19.99,566
1061100,Hunter's Arena: Legends,783,528,19.99,255
1123050,GRIME,2602,421,24.99,2181
985650,Olaguna Chronicles,97,19,14.99,78
1506510,The Ramp,889,37,5.99,852
1357430,Rocket Rumble,23,2,9.99,21
1228910,Ragdoll Party Online,17,8,4.99,9
1076620,Svoboda 1945: Liberation,112,2,11.03,110
1683510,Runes of Avalon 2,3,4,5.99,-1
925950,Here Comes Niko!,610,52,24.99,558
1113030,Stellar Warfare,145,26,19.99,119
1412190,BEACHED,1191,411,0.0,780
1695620,CHR$(143),27,0,3.99,27
1303950,Toodee and Topdee,410,15,19.99,395
1683320,Power & Revolution 2021 Edition,402,271,49.99,131
1576130,IdolDays,77,12,12.99,65
941460,Death Trash,2355,94,19.99,2261
811320,Jupiter Hell,1219,94,24.99,1125
1062000,Starmancer,480,253,19.99,227
1040420,Dreamscaper,2035,210,12.49,1825
1557420,SHIPS AT WAR,131,26,14.99,105
1422420,Dodgeball Academia,286,18,24.99,268
1549550,Haven Park,418,14,8.99,404
1290260,Dark Roll: Free Kick Challenge,67,16,0.0,51
1137750,Farmer's Life,559,129,14.99,430
956140,Lifeslide,228,5,9.99,223
1716660,Reflections of Life: Meridiem Collector's Edition,2,0,13.99,2
1701150,Cats - Classic Onet Connect,2,0,1.99,2
1698520,Simple Fish Adventure,164,18,3.99,146
1686870,中华富甲三国,18,7,9.99,11
1254120,Bless Unleashed,15047,14037,0.0,1010
1573540,Spaceship Simulator,15,2,6.99,13
1680050,DarkFighter,10,3,1.99,7
1400870,When The Night Comes,151,7,12.99,144
1696420,Movie Studio 18 Platinum Steam Edition,2,1,99.99,1
1273750,Button City,93,2,19.99,91
1667400,Cute Cats,122,10,0.99,112
1569150,Glyph☀️,91,4,19.99,87
1386780,City of Gangsters,661,215,29.99,446
514500,Atomic Society,368,164,14.99,204
1706890,Find Objects,1,0,1.99,1
1538570,Patron,1296,397,19.99,899
1377590,The Island,36,39,1.99,-3
1256670,Library Of Ruina,13330,1002,29.99,12328
1480560,Lawn Mowing Simulator,1069,372,14.99,697
1657900,Carrier Command 2 VR,65,58,29.99,7
1694960,Furry Feet,345,102,1.99,243
1566820,Cooking Trip New Challenge,8,1,9.99,7
1578390,My Garage,680,56,24.99,624
1489630,Carrier Command 2,1466,408,29.99,1058
1138660,Black Book,3507,218,24.99,3289
674930,Boyfriend Dungeon,1430,133,19.99,1297
1692580,Hidden Shapes Black Skull - Jigsaw Puzzle Game,29,1,1.99,28
1074070,Dust to the End,774,159,11.99,615
1031900,You Can Kana - Learn Japanese Hiragana & Katakana,101,0,9.99,101
1649830,Tales of the Mirror,114,98,7.99,16
1692210,Trump Loves Russia,34,8,0.99,26
1675480,Advent Crossroad,11,1,5.99,10
1654890,Sigma Impact,56,1,2.99,55
1190000,Car Mechanic Simulator 2021,13649,619,24.99,13030
1203220,NARAKA: BLADEPOINT,86893,24106,19.99,62787
1062140,Garden Story,545,47,13.39,498
1459960,Glitchpunk,97,73,5.99,24
1692280,- R E F L E C T E D -,18,3,0.99,15
1165450,OCO,63,9,4.99,54
1465890,武林志2 (Wushu Chronicles 2),326,386,19.99,-60
1378360,White Hell,118,4,14.99,114
1700940,Anime Zodiac,61,21,0.69,40
1322300,Tsugunohi,278,116,9.99,162
1576350,Blair Witch VR,83,34,29.99,49
1188900,Fire Tonight,49,11,5.99,38
1691860,Vizzle,8,0,2.99,8
1107750,Faraday Protocol,40,2,19.99,38
1710710,Another Dungeon,9,11,0.99,-2
1672960,Endorfire Tower Defense,13,5,9.99,8
1434310,PAW Patrol The Movie: Adventure City Calls,21,23,39.99,-2
768540,Dinosaurs Prehistoric Survivors,41,25,12.99,16
1504050,JAB!,5,3,4.99,2
1334730,Dread Templar,534,51,14.99,483
1575870,UpGun,576,89,0.0,487
1555110,Chasing Tails ~A Promise in the Snow~,536,29,7.99,507
1710140,Puzzle Light: Slide,29,1,0.99,28
414080,Life is Hard,370,189,9.99,181
1402420,Demon Strikes Back,35,18,7.99,17
1519490,The Doors of Trithius,31,1,14.99,30
1532360,Joyspring,98,21,0.0,77
1466640,Road 96 🛣️,8618,776,19.96,7842
752580,Imperivm RTC - HD Edition Great Battles of Rome,450,215,9.99,235
1690240,Emergency Crew Volcano Eruption,2,1,14.99,1
1606340,Conquest of Elysium 5,533,63,29.99,470
1713450,Cat Jump,3,3,0.99,0
1250760,Far Away,4130,55,9.99,4075
1003590,Tetris® Effect: Connected,3749,156,39.99,3593
1124300,HUMANKIND™,13419,6220,49.99,7199
1311070,Greak: Memories of Azur,608,157,19.99,451
1542810,Sunshine Heavy Industries,234,2,14.99,232
1063980,Hell Architect,234,78,24.99,156
949200,Ambition: A Minuet in Power,186,14,19.99,172
1691420,START AGAIN: a prologue,73,3,10.99,70
1638220,軒轅劍參外傳 天之痕,1229,85,9.99,1144
1110910,Mortal Shell,2328,792,29.99,1536
1208590,Temple Of Snek,120,2,11.99,118
1639790,Northern Journey,605,17,11.99,588
1551030,涨粉二维码,158,37,1.99,121
1647730,Zool Redimensioned,82,1,9.99,81
1368410,PSYCRON,78,0,6.99,78
304870,Stones of Harlath,8,1,9.99,7
1306720,Mayhem Brawler,280,33,19.99,247
1346460,Dungeoneers,35,7,14.99,28
1519350,Madden NFL 22,3272,3025,59.99,247
1097200,Twelve Minutes,4207,1548,24.99,2659
986310,Recompile,85,40,19.99,45
989790,The Vale: Shadow of the Crown,191,4,19.99,187
1346010,RiMS Racing,593,436,49.99,157
1169690,Shadowplay: Metropolis Foe,141,57,0.0,84
1278150,Nayati River,49,20,18.99,29
1612620,Never Return,1241,296,13.99,945
1712820,Brave Dungeon + Dark Witch's Story : Combat,18,1,13.99,17
1418020,Tavern of Gods,571,150,13.99,421
1548130,{Undefined},11,11,24.99,0
1520380,HALF DEAD 3,213,82,4.99,131
1694420,Card Survival: Tropical Island,166,3,16.99,163
1040460,Space Scavenger,185,25,12.99,160
1140170,Arietta of Spirits,218,24,14.99,194
951930,Typing Incremental,50,19,0.0,31
1557780,Help Me!,217,60,17.99,157
458660,The Slimeking's Tower,156,37,0.0,119
1349540,DPS IDLE,318,191,0.0,127
1598920,Farmer Life Simulator,78,95,14.99,-17
1707550,Granny 3,377,36,4.99,341
1699460,Jubilane,16,0,5.0,16
1054430,Fling to the Finish,589,98,5.99,491
1715950,Puzzle Box,4,0,9.99,4
1549970,Aliens: Fireteam Elite,11919,2804,39.99,9115
1715530,Medieval Wars,4,3,9.99,1
1131920,LABYRINTH OF TOUHOU - GENSOKYO AND THE HEAVEN-PIERCING TREE,231,23,29.99,208
1690990,NaGongGan Infinite,20,3,2.99,17
1499120,I Expect You To Die 2,769,29,17.99,740
1639920,Embraced by Autumn,17,2,18.99,15
1135300,King's Bounty II,2679,1522,49.99,1157
1716160,Photo Puzzles HD,6,0,6.99,6
1700680,Ki11er Clutter,4,0,9.99,4
607080,Psychonauts 2,7212,156,59.99,7056
726840,City Game Studio: a tycoon about game dev,807,99,15.99,708
1484900,Hoa,1532,165,14.99,1367
1613770,Cave Quest 2,30,2,11.99,28
1036740,METAL DOGS,529,93,19.99,436
930280,Murder Mystery Machine,44,37,11.99,7
1720370,My Life Changed - Jigsaw Puzzle,29,1,0.79,28
1593660,Crime District,13,1,7.99,12
1072640,Beat Blast,315,30,13.99,285
1070860,Serin Fate,388,99,19.99,289
1634150,Behind the Frame: The Finest Scenery,3247,116,12.99,3131
1611580,Behind Glass: Aquarium Simulator,114,3,9.99,111
1398740,The Chrono Jotter,1114,36,11.99,1078
1266820,Ultimate ADOM - Caverns of Chaos,215,151,9.99,64
1308500,Soul Elegy,156,73,18.99,83
1395760,Reshaping Mars,352,56,9.99,296
1562940,THE LEGEND OF HEROES: HAJIMARI NO KISEKI,442,108,35.99,334
1599880,Cats in Time,489,10,4.99,479
1634990,Mark Out! The Wrestling Card Game,45,2,14.99,43
1705870,CUBE-e 2,10,4,9.99,6
879000,Comanche,164,92,19.99,72
1721270,Farm Kitten - Puzzle Pipes,53,3,1.19,50
1614890,Baldo: The Guardian Owls,93,61,24.99,32
1367590,Tormented Souls,3229,224,19.99,3005
1291340,Townscaper,16306,556,5.99,15750
1371750,T-Minus 30,128,10,4.99,118
1641830,Axis Football 2021,76,42,29.99,34
1255560,Myst,767,93,29.99,674
1574250,SPOOKWARE,403,18,9.99,385
1456820,Marfusha,1538,102,7.99,1436
1382290,Betrayer: Curse of the Spine,7,1,9.99,6
843380,Super Animal Royale,29921,1820,0.0,28101
855740,Bum Simulator,1244,205,17.99,1039
1674170,Sprocket,4952,323,19.99,4629
1662840,PARQUET,1540,61,16.99,1479
1033950,Lamentum,292,37,15.99,255
1279270,7 Girls War,65,55,19.99,10
690120,Inked: A Tale of Love,147,24,9.99,123
1566390,Seed of the Dead: Sweet Home,1684,350,29.99,1334
1533590,Three Fairies' Hoppin' Flappin' Great Journey!,89,14,10.79,75
1005400,Star Drift Evolution,189,10,14.99,179
1708460,Obsideo,575,176,11.99,399
1720950,Zombie Killer Drift - Racing Survival,34,5,4.99,29
1565660,S.P.A.T.,28,12,11.99,16
1694820,The Stone of God,3,2,6.99,1
1716910,Foot Massage,10,14,4.99,-4
1624380,Horny Sekai,78,22,2.99,56
968550,Tinytopia,146,15,14.99,131
1188270,The Curse of Feldar Vale,32,3,4.99,29
1613220,World CHAMPIONS: Decathlon,5,0,8.99,5
1163870,Mecha Knights: Nightmare,710,62,15.99,648
1600720,A Curse From Beyond,22,2,4.99,20
1724440,Epic Fantasy Battle Simulator,215,25,9.99,190
1444020,Reactor Tech²,181,87,14.99,94
1330660,Train Life: A Railway Simulator,577,138,19.99,439
1712490,Station 17,2,0,4.99,2
1242980,KeyWe,597,50,24.99,547
1538680,Blake: The Visual Novel,35,1,7.99,34
1651680,The Colorful Creature,32,1,2.99,31
1479500,Rail of Möbius,306,9,12.99,297
1547300,Drawy,36,2,4.99,34
1527500,Pro Strategy Football 2022,69,7,19.99,62
1557350,Wanderlust: The Bermuda Secret Collector's Edition,5,3,13.99,2
1535610,Soul Nomad & the World Eaters,92,22,19.99,70
1504500,OPUS: Echo of Starsong - Full Bloom Edition,5266,143,24.99,5123
1139280,The Big Con,298,3,14.99,295
1612420,Suit for Hire,160,7,14.99,153
1363350,Monster Harvest,200,176,16.99,24
844260,Rustler (Grand Theft Horse),788,260,24.99,528
1586960,Cute Bite,65,6,14.99,59
1271280,Rift Wizard,674,37,14.99,637
1194590,Star Dynasties,253,82,29.99,171
1534180,Super Woden GP,203,16,12.99,187
1372320,Cloud Gardens,1603,64,17.99,1539
1118240,Lake,1786,253,19.99,1533
1213220,IRON GUARD VR,69,4,14.99,65
1682970,Uncrashed : FPV Drone Simulator,650,61,14.99,589
1722310,Spellarium 7 - Match 3 Puzzle,2,0,6.99,2
1554970,Rogue Spirit,96,25,19.99,71
1384170,天虹书店 Tian Hong Bookstore,11,2,3.99,9
1581040,El Shaddai ASCENSION OF THE METATRON HD Remaster,215,26,29.99,189
1697460,Coin Pusher World,33,1,8.99,32
1454400,Cookie Clicker,33473,871,4.99,32602
1155870,WW2: Bunker Simulator,148,39,11.99,109
1356280,Kitaria Fables,697,195,19.99,502
1700140,Hermes: Tricks of Thanatos,12,0,6.99,12
471710,Rec Room,37003,3304,0.0,33699
1729150,Mysterious warrior,12,3,10.99,9
1462810,WRC 10 FIA World Rally Championship,1024,438,49.99,586
1304770,The Magister,52,3,14.99,49
1648610,Malum,370,114,4.99,256
1184370,Pathfinder: Wrath of the Righteous,17093,3084,49.99,14009
1446650,BRAVELY DEFAULT II,948,176,59.99,772
1708710,Food Delivery Battle,13,0,3.99,13
1675920,Jewel Match Solitaire Summertime,5,1,9.99,4
1106340,Legend Bowl,543,54,24.99,489
774791,Surgeon Simulator 2,594,266,19.99,328
1099410,A Total War Saga: TROY,1419,551,49.99,868
1598730,Shanhe,399,97,6.99,302
1278170,Big Rumble Boxing: Creed Champions,52,31,39.99,21
1248450,Totemlands,29,0,9.99,29
1663170,Airplane Tycoon,3,6,4.99,-3
1727000,YuuYuu Jiteki no Yuukarin,176,11,15.99,165
1726730,You Must,132,32,1.99,100
1633020,Wood Brothers Flying Colours,5,1,5.99,4
1744430,Fairy Godmother Stories: Miraculous Dream Collector's Edition,2,0,13.99,2
1671420,Hidden Object: Detective Holmes - Heirloom,26,1,2.99,25
1301390,No Umbrellas Allowed,805,211,19.99,594
1556870,Golf Club Wasteland,443,73,9.99,370
1525420,Heads Will Roll,98,23,4.99,75
1292020,Armoured Commander II,341,6,9.99,335
1328190,BATTLESHIP APOLLO,91,100,0.0,-9
1729170,Eternal Warfare,14,0,11.99,14
1731490,Alien Hunt,0,5,4.99,-5
1689270,Raven's Hike,26,1,4.99,25
1699280,Hammerheart,30,2,10.99,28
420550,Super Arcade Football,123,51,9.99,72
1713620,Wolf Attack,8,2,9.99,6
1731870,Viral Firar,170,29,1.99,141
1564340,FGTeeV Goozy,39,3,7.99,36
1433010,Tennis Manager 2021,159,45,19.99,114
1246870,Harvest Moon: One World,30,16,49.99,14
1245370,Puzzle Forge Dungeon,28,2,14.99,26
1582990,Blon,13,1,4.99,12
1378710,Placebo Love,15,1,8.99,14
921800,Encased: A Sci-Fi Post-Apocalyptic RPG,2658,644,29.99,2014
1105590,Dream Cycle,121,29,19.99,92
1407420,Milo and the Magpies,1624,22,1.99,1602
976590,Bus Simulator 21,1785,836,34.99,949
1729790,Escape From School,102,32,0.0,70
1729080,Wavy Trip,1,6,0.99,-5
1709580,Tiny Robots Recharged,11,0,3.99,11
1713400,Chicken Cannon!,4,2,3.99,2
1173800,FINAL FANTASY IV,1188,157,17.99,1031
1676550,Dull Grey,38,2,4.99,36
1424300,Jester / King,44,2,19.99,42
1726050,Neon Depth,15,0,1.99,15
1638340,Cat Simulator : Animals on Farm,67,4,3.99,63
1465070,Legendary Tales,1202,256,34.99,946
1678950,Panda City,12,4,0.0,8
1390350,Webbed,7944,167,9.99,7777
1543430,Terrain of Magical Expertise,97,16,16.74,81
1265720,RICO: London,8,12,34.99,-4
1737480,Super,4,3,2.99,1
740130,Tales of Arise,21929,2286,59.99,19643
335210,Rift's Cave,35,31,0.99,4
1161170,The Rewinder,4328,123,14.99,4205
1661240,Bubble Shooter FX,9,3,1.19,6
1644960,NBA 2K22,18546,14194,59.99,4352
1364290,Animalia Survival,808,395,19.99,413
1122680,The Artful Escape,874,63,19.99,811
1229460,Dice Legacy,551,228,19.99,323
936790,Life is Strange: True Colors,9333,955,59.99,8378
1724020,Space Tower Defense,10,3,4.99,7
924070,Arboria,454,92,19.99,362
1499800,Geometric Sniper - Blood in Paris,50,15,1.99,35
1515420,The Vampire Regent,21,5,6.99,16
1384290,DinoScape,176,37,0.0,139
1736630,Minesweeper Ultimate,38,9,1.49,29
1462570,Lost in Random™,1197,115,29.99,1082
1722390,Osylla,9,2,1.99,7
1158220,Kraken Academy!!,394,22,17.99,372
1735470,Tax Fugitive,11,9,1.99,2
1562420,FOREWARNED,2758,283,12.99,2475
1497230,Cauldrons of War - Stalingrad,50,5,11.24,45
1268900,Nearly Dead,151,55,24.99,96
1404660,Psych,130,19,9.99,111
1672140,Bot Wars,430,24,14.99,406
1687060,Lord of the Click 2,17,3,10.99,14
1736260,Home Designer - Makeover Blast,9,3,4.24,6
1635800,Dungeon Warriors,12,10,5.99,2
1701830,Tangent Rush,16,0,3.99,16
1662340,Case 02: Paranormal Evil,25,1,5.99,24
1139940,ATOM RPG Trudograd,2334,363,10.99,1971
1252330,DEATHLOOP,16713,4896,59.99,11817
1630920,Bright Lights of Svetlov,647,50,4.99,597
1355650,Filcher,89,2,9.99,87
1725950,魔塔地牢,62,16,2.99,46
1634970,Idle Master Hunter Steam Edition,3,4,5.99,-1
991740,Era Of Newborns,35,37,13.99,-2
1523510,Cave Digger 2: Dig Harder,48,7,9.99,41
1517240,CHESS with LASERS,26,0,11.99,26
977920,Balsa Model Flight Simulator,166,34,18.99,132
1568720,Plague Breaker,17,1,11.99,16
1725680,YouRiding - Surfing and Bodyboarding Game,13,3,24.99,10
1444770,ASTRO ACE,38,2,2.99,36
841190,"Honey, I Joined a Cult",686,158,19.99,528
1614960,Miko Adventures Puffball,14,0,9.99,14
1741130,Pacific General,8,2,2.39,6
929490,RAM Pressure,397,436,0.0,-39
1237730,Catlateral Damage: Remeowstered,103,0,14.99,103
1490610,METALLIC CHILD,943,139,24.99,804
1709460,Hot And Lovely 4,121,32,1.99,89
737520,Flynn: Son of Crimson,252,48,19.99,204
1149620,Gas Station Simulator,11964,1829,19.99,10135
1062090,Timberborn,12042,739,24.99,11303
1392960,STORY OF SEASONS: Pioneers of Olive Town,698,111,39.99,587
1742120,Mary Knots - Garden Wedding,3,2,5.09,1
1741120,Fantasy General,38,2,2.39,36
993340,Virtual Surfing,85,47,29.99,38
1478050,Tomb Rumble,169,53,0.0,116
1477050,Grim wanderings 2,56,15,5.99,41
1694270,DOG'S DONUTS,24,2,1.99,22
1719880,Return home,13,2,5.99,11
1323900,Scrapnaut,378,145,13.99,233
1580150,Between Time: Escape Room,139,14,9.99,125
1477630,Swing Dunk,274,94,0.0,180
960040,Clash of Chefs VR,102,22,19.99,80
1580800,Erannorth Chronicles,143,18,19.99,125
1267540,WRC 9 FIA World Rally Championship,212,61,29.99,151
1630890,Rift Adventure,19,4,7.99,15
971030,SkateBIRD,401,73,19.99,328
1682410,寂寞神明的心愿手记,220,41,9.99,179
1735420,Fake Hostel,214,115,4.99,99
1662750,Wraiths of SENTINEL,9,2,5.99,7
977880,Eastward,10198,1700,24.99,8498
1669360,Socialism Simulator,97,3,3.99,94
917720,Gamedec,736,145,29.99,591
1741210,Speedway Challenge 2021,19,3,8.99,16
1711400,排球入门指南,78,1,0.99,77
1433860,The Amazing American Circus,146,95,7.99,51
1472560,I Am Fish,815,262,9.99,553
1598160,Bloodwash,681,62,7.99,619
1415320,PalmRide,85,9,3.99,76
1762450,Haunted Hotel: The Axiom Butcher Collector's Edition,5,1,9.99,4
1505010,Blockdown,8,2,0.0,6
1680400,Argus Panoptes,16,0,2.99,16
1558510,MECHANICA: A Ballad of the Rabbit and Mercury,519,17,19.99,502
1713190,Neko Candy Shop,109,23,0.49,86
1307580,TOEM,1125,16,19.99,1109
1227690,Severed Steel,1699,102,24.99,1597
1283410,Tails of Iron,4037,395,24.99,3642
1710290,Helper Cat,33,6,0.99,27
1738610,First Class Escape: The Train of Thought,140,62,6.99,78
1158370,Aragami 2,1559,564,34.99,995
1711910,Street Dreams,5,2,6.99,3
1740570,CURSED NIGHT - The House,12,2,7.99,10
1585700,Trap Genesis,235,8,9.99,227
1281400,Good Knight,69,0,14.99,69
1715130,Crysis Remastered,1455,793,13.49,662
1455900,Plunder Panic,240,66,9.99,174
1563700,当火车鸣笛三秒,244,45,9.99,199
1720600,I Love Finding Cats,15,0,6.99,15
1285040,D-Corp,46,7,19.99,39
1744200,City Legends: The Curse of the Crimson Shadow Collector's Edition,2,0,7.99,2
877010,Beyond Contact,222,87,14.99,135
1210320,Potion Craft: Alchemist Simulator,11636,826,14.99,10810
699130,World War Z: Aftermath,6988,1348,39.99,5640
1289380,Sheltered 2,773,742,19.99,31
1509770,Million on Mars: Space to Venture,9,3,14.99,6
852220,Accident,846,217,14.99,629
1571220,Chessplosion,97,3,11.99,94
1101670,ARISEN - Chronicles of Var'Nagal,41,0,15.99,41
938860,"Get In The Car, Loser!",246,54,9.99,192
1650250,ToruTaru,47,6,4.99,41
1672970,Minecraft Dungeons,4669,440,19.99,4229
757310,Sable,2154,351,24.99,1803
1727810,Diamond Hands: To The Moon,29,7,4.99,22
1699740,Dungeon Danger Traps,10,1,2.99,9
1444300,Teacup,255,3,9.99,252
1393370,Actraiser Renaissance,358,101,29.99,257
1352850,Citystate II,420,149,24.99,271
1062830,Embr,962,157,7.99,805
1752500,Badlands Racer,11,6,1.99,5
1577620,The Signal State,275,31,19.99,244
1129580,Medieval Dynasty,23908,2465,34.99,21443
1552550,Castlevania Advance Collection,879,62,19.99,817
1607170,Magical Girl Noble Rose,21,6,7.99,15
1734890,Visual Novel Sisters,17,2,4.99,15
1347600,Dad's Monster House,89,6,2.99,83
1563970,Surviving West,23,13,9.99,10
1628440,Trick & Treat Remake,34,0,1.99,34
1769630,Grim Tales: Crimson Hollow Collector's Edition,7,3,9.99,4
1727520,Yamafuda! 2nd station,93,1,12.99,92
1269690,Attack on Toys,253,22,6.99,231
1543830,The Addams Family: Mansion Mayhem,6,5,39.99,1
584640,SUPER CHICKEN JUMPER,2163,55,2.99,2108
959880,Dungeon Town,247,63,19.99,184
1142080,Pawnbarian,454,42,9.99,412
1618230,恋爱关系/Romance,1213,178,3.99,1035
654890,Grand Tactician: The Civil War (1861-1865),1107,284,44.99,823
1557200,My Eyes,13,1,9.99,12
523070,Black Forest,171,51,0.0,120
1728080,Roseblight,9,2,7.99,7
1611300,Happy Guy,412,109,2.99,303
625340,XERA: Survival,4527,2084,0.0,2443
1573720,Agatha Christie - Hercule Poirot: The First Cases,344,90,24.99,254
1393320,Keyword: A Spider's Thread,155,19,16.99,136
1156510,Peachleaf Pirates,33,6,2.79,27
1172730,The Handler of Dragons,17,5,11.99,12
977650,DwarfHeim,322,191,24.99,131
1740170,Tap Tap Builder,4,2,4.99,2
1334470,Mythic Archive,6,1,0.0,5
915600,Them and Us,539,128,39.99,411
1663730,SGS Afrika Korps: Tunisia,10,1,24.99,9
1063730,New World,154914,73900,39.99,81014
950180,Lemnis Gate,757,131,19.99,626
1597200,ConnecTank,9,1,29.99,8
1450330,Concordia: Digital Edition,81,9,18.99,72
1119980,In Sound Mind,1144,59,34.99,1085
1203710,UnMetal,1173,67,19.99,1106
226280,Warp Frontier,32,2,14.99,30
1521930,A Tale for Anna,64,6,10.99,58
1688580,A YEAR OF SPRINGS,290,3,4.99,287
1280300,Steel Assault,185,42,14.99,143
1709900,Tower Tactics: Liberation,363,21,10.99,342
1749380,Pieces of Beauty,17,0,1.99,17
750200,AWAY: The Survival Series,101,81,19.99,20
1277500,Skeletal Avenger,135,26,16.99,109
1252830,A Juggler's Tale,350,23,17.99,327
1742840,Puff Town,201,60,1.99,141
1131930,BARRICADEZ,109,29,18.99,80
1630960,Centipede: Recharged,46,11,9.99,35
1525330,Guardians of Hyelore,23,14,19.99,9
488860,MADNESS: Project Nexus,9459,279,24.99,9180
1585570,Workplace Rhapsody,503,70,6.49,433
1372280,MELTY BLOOD: TYPE LUMINA,4030,705,49.99,3325
1287530,Lords and Villeins,258,47,19.99,211
1069690,Rogue Lords,918,315,24.99,603
1252240,Aeon Drive,68,15,14.99,53
1147890,Bonfire Peaks,148,2,19.99,146
1121780,Astria Ascending,128,88,34.99,40
1687040,Toadomination,11,3,2.99,8
1487800,Little Hats,12,3,17.99,9
944430,The Last Friend,77,4,14.99,73
1172650,INDUSTRIA,828,254,13.39,574
1722620,Toree 2,477,8,0.99,469
1742500,My Dear Frankenstein -English Edition-,8,1,4.99,7
1706940,Junkyard Fury,14,1,4.99,13
1554600,Wife Quest,90,17,5.99,73
1182620,Impostor Factory,7498,278,9.99,7220
1742450,西游记2021,318,15,9.99,303
1271700,HOT WHEELS UNLEASHED™,2830,690,49.99,2140
1673190,Bahamut2-dragon's bride,313,8,9.99,305
1062110,UNSIGHTED,862,45,19.99,817
1737690,Yacht Dice 快艇骰子,42,12,0.99,30
1287030,Bubble Bobble 4 Friends: The Baron's Workshop,38,24,39.99,14
1525620,The Architect: Paris,158,37,17.99,121
1595640,Tres-Bashers,99,2,9.99,97
1438090,Hobo Cat Adventures,41,1,10.99,40
1517960,Rebirth:Beware of Mr.Wang,1318,644,8.99,674
1756710,Mistral,13,4,11.99,9
708890,BEATris,39,12,2.99,27
1506830,FIFA 22,69322,17807,59.99,51515
1777090,Halloween Stories: Horror Movie Collector's Edition,10,0,9.99,10
1751110,Jeebo & Jerbo vs. Life,7,0,4.99,7
1700800,Break Bounds: Exile 越界：流放者,26,2,9.99,24
1678860,TV Kid,50,2,9.99,48
1750640,Dear Agony Aunt,11,0,4.99,11
1584090,Touhou Mystia's Izakaya,8813,367,5.99,8446
1702450,Língua,22,1,5.99,21
1671350,Touhou Monster TD ~ 幻想乡妖怪塔防,470,49,18.99,421
1649920,Coronation,51,17,0.0,34
1389650,Escape Hospital-脫出 失憶病棟,21,0,12.99,21
1312150,Charlie | The Legend,43,56,0.0,-13
1667110,Metempsychosis,11,9,14.99,2
469600,Legion TD 2 - Multiplayer Tower Defense,7058,1183,19.99,5875
1696810,RAILROADS Online!,1961,353,34.99,1608
1017160,Gearshifters,40,9,24.99,31
1570760,Variables 2,366,36,14.99,330
1444480,Turing Complete,748,46,19.99,702
1330470,F.I.S.T.: Forged In Shadow Torch,4354,490,29.99,3864
763100,Lumberjack Simulator,112,54,17.99,58
658890,Arthurian Legends,283,18,11.99,265
1414850,Nickelodeon All-Star Brawl,3863,1201,49.99,2662
1316910,Super Monkey Ball Banana Mania,907,128,29.99,779
1732720,周松传,5,3,2.99,2
1762120,The Cruise,2,1,0.0,1
1760690,The Luffeltera Renovator,13,8,6.99,5
1106830,Rainbow Billy: The Curse of the Leviathan,108,5,19.99,103
985830,SUCCUBUS,2466,494,24.99,1972
1760160,Game Theory At Christmas,7,0,4.99,7
1765960,Chezzle,10,0,0.99,10
832360,Hotel Magnate,212,106,24.99,106
909660,Vagrus - The Riven Realms,632,114,29.99,518
1692620,Water Physics Simulation,19,5,2.99,14
1706810,ARC Alien Raid Combat,16,4,0.99,12
1410140,Load Roll Die,6,1,12.99,5
985780,Jack Axe,61,20,14.99,41
1728680,Legendary Tales: Stolen Life,18,1,6.99,17
1450180,Haunt Chaser,415,133,14.99,282
1581800,Slow living with Princess,383,30,11.99,353
1765810,Hidden Lands,0,9,0.99,-9
1687550,Bear's Restaurant,227,6,12.99,221
1722020,Old Coin Pusher Friends,276,33,3.99,243
1696200,Hell Blasters,18,1,14.99,17
1355760,投资模拟器：打工人,580,334,11.99,246
1546790,"Peace, Death! 2",583,15,4.99,568
1746120,Halloween Trouble 3: Match 3 Puzzle,1,0,8.99,1
1760020,GROUND-UNBOUND,48,1,4.99,47
1426450,Age of Darkness: Final Stand,3655,561,21.99,3094
1676870,ECO HOLE,26,0,8.99,26
990630,The Last Campfire,2558,62,5.99,2496
1710170,Blade of Darkness,1283,65,8.99,1218
1677740,Stumble Guys,28671,3498,0.0,25173
1263230,Cooking Companions,544,26,14.99,518
1517870,StalakMiner,8,0,9.99,8
1485650,Zen World,38,7,9.99,31
1388570,Seduction,27,24,7.99,3
1656640,四色跳跃/Four color jump,128,27,1.99,101
1766790,100 hidden birds 2,114,3,1.99,111
1276070,Manufactoria 2022,33,0,19.99,33
1345320,Deep Space Gardening,16,4,14.99,12
1520900,Castle Cardians,84,15,14.99,69
1783060,Chimeras: Mortal Medicine Collector's Edition,4,1,9.99,3
1744140,Conundrum,25,2,3.99,23
1431950,Decks & Daggers,40,13,12.99,27
1342040,Sylphy and the Sleepless Island,120,11,19.99,109
1696710,Inventory Manager,25,8,0.99,17
1718660,Shinobi Shift,15,0,9.99,15
1744050,Hidden Words,6,1,4.99,5
1743880,Andalia,7,3,11.99,4
1758910,Time Commando,26,1,5.99,25
1451230,Blood of Titans,28,24,0.0,4
1509510,Settlement Survival,3213,423,14.99,2790
1400910,Soundodger 2,78,0,19.99,78
1152340,Book of Travels,1181,225,29.99,956
1097130,Circuit Superstars,1269,172,19.99,1097
830370,Monster Crown,426,100,19.99,326
1721470,Poppy Playtime,30556,9015,0.0,21541
1736250,Code Dread,10,13,4.99,-3
1747800,Legendary Mahjong 2,2,0,7.99,2
924970,Back 4 Blood,24344,13661,59.99,10683
808010,Critadel,146,25,19.99,121
1758870,Edgar's Room,9,2,4.99,7
1285230,Ultimate Racing 2D 2,81,7,9.99,74
1765160,封神榜  伏魔三太子（重制版）,37,10,7.99,27
1745480,Phantom Project,138,20,4.99,118
1522280,Grim Nights 2 - Realms,135,34,9.99,101
1276750,Negative Nancy,63,3,14.99,60
1191120,Growing Up,1559,189,14.99,1370
1552350,The Jackbox Party Pack 8,850,87,29.99,763
1088790,Rebel Inc: Escalation,3559,692,14.99,2867
1762830,Death in the Family,11,7,3.99,4
1043260,Gladiator Guild Manager,1248,222,7.99,1026
1593350,Increlution,528,68,2.99,460
1266900,Operation DogFight,7,2,0.0,5
1444920,Doctor Who: The Edge of Reality,133,84,24.99,49
1126310,风信楼,2601,174,11.99,2427
1162700,Midnight Protocol,242,29,14.99,213
671970,Junkyard Simulator,524,415,16.99,109
1773890,100 hidden dogs,165,7,0.99,158
1753220,ANIME TETRIS,31,8,1.99,23
750520,Arcade Tycoon ™ : Simulation,302,62,9.99,240
1330000,Stolen Realm,722,79,19.99,643
780310,The Riftbreaker,10236,902,29.99,9334
1777750,Ninki Seiyuu: How to Make a Pop Voice Actress,80,2,39.99,78
1227280,Despot's Game: Dystopian Army Builder,1502,225,14.99,1277
1171120,Nira,59,32,9.99,27
1693260,Yugo Puzzle,144,3,6.99,141
366290,Carp Fishing Simulator,117,80,18.99,37
1505540,Get Together: A Coop Adventure,43,16,10.99,27
1703650,Hashi: Light,11,0,3.99,11
1702320,PIGGY: Hunt,926,168,0.0,758
1480830,Evil Tonight,175,21,14.99,154
1232150,A Little Golf Journey,52,3,19.99,49
1468380,The Sundew,41,5,14.99,36
1569520,IRMÃO Grande & Brasileiro 2,301,8,7.99,293
1449510,Henchman Story,152,3,14.99,149
1389850,Digital Janitors,14,0,4.99,14
1319420,Chasing Static,254,33,14.99,221
1731520,Ark Mobius: Censored Edition,734,43,4.49,691
589940,Eye of the Temple,261,12,13.99,249
1512240,记得我,100,18,2.99,82
1099220,The Alien Cube,168,28,19.99,140
1630780,Heartless Dark,16,0,11.99,16
1273220,Sphere - Flying Cities,72,49,12.59,23
1451080,DUNGEON ENCOUNTERS,274,139,29.99,135
1738150,Draft Day Sports: Pro Football 2022,14,6,24.99,8
697900,Bounty Below,89,18,0.0,71
1452500,The Good Life,167,38,29.99,129
1233040,Wardens,1,1,17.99,0
1732740,Sakura Hime,929,76,3.99,853
1490890,Demon Slayer -Kimetsu no Yaiba- The Hinokami Chronicles,11423,1516,59.99,9907
1755650,C.A.P.S. - Cyber Animal Planet Survival,11,0,13.99,11
1742230,Sandfall,1,3,6.99,-2
1511460,InfraSpace,606,82,24.99,524
1675270,Hanoi Puzzles: Flip Match,16,0,0.99,16
1774810,Laruaville 10 Match 3 Puzzle,1,1,6.99,0
1739340,Mr. Hopp's Manor Escape,28,2,3.99,26
1778210,King Boo,24,0,2.99,24
1764530,Sailwind,653,52,19.99,601
1540570,Fractal Block World,7,0,11.99,7
1662480,Nuclear Blaze,383,14,7.99,369
1729050,The Fox in the Forest,11,0,6.99,11
1031270,Farming Life,72,30,1.99,42
959510,The Master Club,8,1,4.99,7
900400,Sacred Fire: A Role Playing Game,236,13,17.99,223
617980,Summer In Trigue,13,4,17.99,9
361100,Dual Souls: The Last Bearer,31,2,5.99,29
1526490,Fear Surrounds,8539,1194,7.99,7345
1720210,BuriBoard,12,1,6.99,11
1617430,Bunhouse,319,16,19.99,303
1422410,Into the Pit,93,32,14.99,61
1779710,SEARCH ALL - ANIMALS,39,16,0.99,23
1762490,Color Guys,3,0,0.99,3
1101790,War Mongrels,614,315,44.99,299
1778770,Academy of Magic: The Great Dark Wizard's Curse,5,0,5.99,5
1092790,Inscryption,71542,2107,19.99,69435
1505910,Recontact London: Cyber Puzzle,15,10,11.99,5
1435790,Escape Simulator,6967,475,14.99,6492
1484720,Dead Estate,1867,101,14.99,1766
1150820,Delphyq,3,3,14.99,0
638990,UNDYING,624,84,19.99,540
1079230,Himno - The Silent Melody,189,16,9.59,173
1710970,Vacation Adventures: Park Ranger 12,1,0,6.99,1
1271110,Healing Spree,57,45,14.99,12
1588120,SwapOut,11,2,2.99,9
1305310,Drox Operative 2,178,18,19.99,160
1754840,Hacker Simulator,409,114,24.99,295
1300100,Spectacular Sparky,67,5,14.99,62
1239300,Gravewood High,150,9,19.99,141
1585440,They Always Run,381,67,14.99,314
1189190,Battle Map Studio,5,0,15.99,5
1436920,Tandem: A Tale of Shadows,137,12,7.49,125
1590750,JARS,39,6,4.79,33
1674470,ELYON,2394,1977,0.0,417
780290,Gloomhaven,9181,1349,34.99,7832
1069640,This Land Is My Land,2339,775,29.99,1564
1273260,Corpse Party (2021),384,20,19.99,364
1690880,Up All Night,18,1,6.99,17
1431780,The Black Heart,207,7,9.99,200
1592230,Cards of the Dead,40,10,7.99,30
1726190,No Straight Roads: Encore Edition,616,44,24.99,572
1749170,Human Madness,2,5,7.99,-3
1600930,Foul Play - Yuri Visual Novel,22,1,13.99,21
1624920,1001 Jigsaw. Home Sweet Home. Back from Vacation,3,1,4.99,2
1506980,葬花·暗黑桃花源,3431,114,9.09,3317
1287840,Disciples: Liberation,1794,532,39.99,1262
777670,Okinawa Rush,89,6,7.99,83
1543030,Sword and Fairy 7,8876,3545,29.99,5331
1596270,Neon Souls,20,1,4.99,19
1119840,Sands of Aura,133,36,24.99,97
1339000,Aquarium Designer,557,73,9.99,484
1694260,Moons of Ardan,39,2,14.99,37
1642940,Hidden Office,19,1,4.99,18
910490,Killsquad,2370,937,29.99,1433
1642620,COLLECTION of SaGa FINAL FANTASY LEGEND,46,12,19.99,34
1621420,After Shadows,6,4,14.99,2
1607040,Evertried,45,9,19.99,36
1709500,Adorable Witch 2,347,59,1.99,288
1281590,The Dark Pictures Anthology: House of Ashes,4251,545,29.99,3706
1767580,Twin Mind: Power of Love Collector's Edition,4,0,1.99,4
1662850,Renai Karichaimashita: Koikari - Love For Hire,165,7,29.99,158
1635590,My Friend Peppa Pig,420,61,39.99,359
1719660,My Cute Succubus,115,20,1.99,95
1379120,MechNest,8,4,24.99,4
1754760,Scarred Stars: Traumatic Edition,13,3,1.99,10
1755870,The Monster Within,35,4,14.99,31
1718920,Mega Monster Party - Multiplayer AirConsole,13,5,15.99,8
1737280,Bad animals - rabbit,9,1,1.99,8
1300700,Kingdom Wars 4,99,40,19.99,59
1698630,Sword of the Stars: The Pit 2,30,3,14.99,27
1054340,Logic World,197,16,12.0,181
1648560,Nursery Slime,67,6,13.99,61
1212410,Hourglass,196,7,19.99,189
1465510,DUSK '82: ULTIMATE EDITION,198,3,6.99,195
1678770,Ecstasy Elf Shotenken -Naruru's Sexy Adventure-,6,11,3.99,-5
1613960,The Death Into Trouble,15,1,4.99,14
1769470,Non-Euclidean Chess,6,2,7.99,4
1335530,Alisa,380,43,17.99,337
1690270,Amazing Superhero Squad,21,8,6.99,13
1730920,Hatch,41,18,3.99,23
1776350,Bear Adventures,8,6,0.99,2
1376580,Alien Dawn,41,17,13.99,24
1436990,Feign,1697,183,4.99,1514
1666070,Shoal,12,0,6.99,12
1593700,"You, Calligrapher",37,0,11.04,37
1386770,Particubes (Open Alpha),39,9,0.0,30
1567200,The Wolf,70,23,9.99,47
1719980,Creepy Mahjong,2,0,7.99,2
1456260,Flashlight,3,0,2.99,3
1465050,HaremKingdom,46,6,29.99,40
1756330,Secrets of Magic 5: Back to School,8,0,9.99,8
1538850,Grotto,97,7,5.19,90
1600450,Pride and Prejudice: Blood Ties,6,3,9.99,3
1788940,Shadows: Price For Our Sins,15,5,5.99,10
1088850,Marvel's Guardians of the Galaxy,21413,1098,59.99,20315
1764390,BAD END THEATER,3269,80,9.99,3189
1599000,ARK-ADE,63,1,19.99,62
1480040,Touhou Multi Scroll Shooting 2,13,1,11.99,12
1747670,Jewel Match Twilight 3 Collector's Edition,19,0,9.99,19
1395030,Kathy Rain: Director's Cut,314,17,14.99,297
1080010,Witchtastic,115,10,17.99,105
1502560,The Smurfs - Mission Vileaf,90,11,17.99,79
1225820,Hermitage: Strange Case Files,20,4,19.99,16
1361400,Moonglow Bay,205,90,24.99,115
1739000,Franchise Hockey Manager 8,127,28,19.99,99
1531250,Defend the Rook,120,28,17.99,92
1717410,Prince of Qin,46,8,9.99,38
1439300,NASCAR 21: Ignition,121,430,44.99,-309
1760040,Fleshport,13,0,8.99,13
1700130,Baking Bustle: Ashley’s Dream,7,1,6.99,6
1732190,FATAL FRAME / PROJECT ZERO: Maiden of Black Water,3283,884,39.99,2399
898750,Super Robot Wars 30,3857,480,59.99,3377
1681040,Murder Diaries 2,25,0,9.99,25
1393660,Rising Constellation,43,5,19.99,38
1760980,P.U.R.G.A.T.O.R.Y,13,6,2.99,7
1449500,Bassmaster® Fishing 2022,94,51,24.99,43
1568620,MetaPhysical,23,9,11.99,14
1113570,Voice of Cards: The Isle Dragon Roars,786,177,29.99,609
1775170,Hidden Investigation: Who did it?,0,1,9.99,-1
1358530,Saint Kotar,93,23,24.99,70
905970,Steel Crew,264,27,17.99,237
1617390,FLOW,3,5,0.0,-2
1151250,Horror Story: Hallowseed,142,40,19.99,102
1266100,Vampire: The Masquerade — Parliament of Knives,160,8,9.99,152
1466860,Age of Empires IV,30472,4748,59.99,25724
1159560,Ziggurat 2,953,69,24.99,884
1721620,George: A Horror Story,5,2,10.99,3
1652220,Adventurer Liz and the Erotic Dungeon,10,5,9.99,5
1750570,Subway Midnight,578,103,9.99,475
1665200,Printersim,12,0,9.99,12
314430,M.A.R.S.,468,321,0.0,147
1206060,Happy Game,1345,131,13.13,1214
1463420,INDICTED,14,8,2.39,6
1665500,Hypnagogia 無限の夢 Boundless Dreams,174,5,9.99,169
1361000,In Silence,8041,2117,9.99,5924
459840,Monster Bash HD,35,0,9.99,35
1677870,Gefragt Gejagt - Das Spiel,3,7,34.99,-4
1440500,東方剛欲異聞　～ 水没した沈愁地獄,523,112,19.99,411
1780270,Laptop Tycoon,130,47,7.99,83
1786670,仙绣剑缘录,571,93,19.99,478
1635600,PJ MASKS: HEROES OF THE NIGHT,8,5,39.99,3
1744910,[Chilla's Art] The Radio Station | 深夜放送,179,42,4.99,137
1757240,Ghost Case,9,2,0.99,7
1606770,Somniphobia,9,1,3.24,8
1442840,The Mole Men,28,1,11.99,27
1694430,Dynamic Dungeons Editor,55,19,29.99,36
953880,First Class Trouble,2205,591,14.99,1614
1790630,Astral Masters,31,2,4.99,29
1245540,Touhou Endless Dream,1547,63,7.99,1484
1592520,WitchSpring3 Re:Fine - The Story of Eirudy -,410,25,29.99,385
1715660,Angelic Waves,5,0,10.99,5
1741640,Shadows of Forbidden Gods,249,8,19.99,241
1767700,Kid Hallow,16,0,9.99,16
1781350,Fireboy & Watergirl: Fairy Tales,68,4,0.99,64
1135690,Unpacking,12760,1082,19.99,11678
1647740,1f y0u're a gh0st ca11 me here! 幽铃热线,76,3,6.99,73
492340,Pixel Cup Soccer 17,262,32,9.99,230
1406850,The Legend of Tianding,1797,68,19.99,1729
1597730,Dogs Organized Neatly,519,5,2.09,514
1557480,Project MIKHAIL: A Muv-Luv War Story,328,253,19.99,75
946720,To The Rescue!,847,390,19.99,457
1109160,Giants Uprising,102,40,19.99,62
1719390,Cards and Castles 2,30,6,19.99,24
1687190,Starlight Explorers,17,0,5.99,17
1559460,Hero's everyday life,14,4,0.0,10
1548750,Conway: Disappearance at Dahlia View,150,24,29.99,126
1702210,Piecewise: build chat bots with blocks,12,0,14.99,12
1576970,The Lost King of Avallon,15,7,14.99,8
1420510,Usurper: Soulbound,31,8,13.99,23
1358090,Open Hexagon,284,6,4.99,278
887450,Tunche,414,96,19.99,318
1125240,Ancient Dungeon,503,12,19.99,491
1301950,Time Loader,195,21,14.99,174
977400,Cell to Singularity - Evolution Never Ends,13520,1432,0.0,12088
1490840,Bloodshore,250,84,4.94,166
1584830,Duck Creator,165,8,0.99,157
1262040,Super Mombo Quest,173,2,14.99,171
1647700,Animal Defense Versus,12,3,0.0,9
1158980,Idle Big Devil,3154,617,0.0,2537
1783200,方块地牢,261,7,1.99,254
1560060,封神外传,61,2,4.99,59
1058800,Miner's Mettle,39,19,24.99,20
1668080,Flåklypa Grand Prix,140,129,34.99,11
842180,Prison Simulator,1224,174,19.99,1050
1570510,Undernauts: Labyrinth of Yomi,65,10,59.99,55
1492360,Recipe for Disaster,307,66,16.99,241
1380220,Starsand,434,140,19.99,294
1794740,Fears of Glasses  o-o,11,2,9.99,9
1788100,Saimin Gakushū: Secret Desire,171,49,19.99,122
1622830,Stardrytch,10,1,4.99,9
1491510,Recon Control,72,7,9.99,65
1793210,DayDream Mosaics,1,1,8.99,0
1736400,TramSim Munich - The Tram Simulator,251,112,34.99,139
1662270,Vandalhalla,6,4,5.99,2
1780990,Fallen Flowers,10,1,0.99,9
1325900,Demon Turf,239,31,24.99,208
1745620,The Oath of The Dark Magic Queen,13,4,4.99,9
1524530,Fantasy Town Regional Manager,56,15,9.99,41
1810430,Grim Tales: Echo of the Past Collector's Edition,4,0,13.99,4
1797610,Barro 22,66,10,0.99,56
1777930,School Trip,3,3,1.99,0
1683680,Longphort,4,3,7.99,1
1795340,Drynk: Board and Drinking Game,1,2,5.99,-1
1752090,Echoed Memories,10,0,7.99,10
1434320,Fast & Furious: Spy Racers Rise of SH1FT3R,9,9,39.99,0
1646180,Succubus Runa and the Erotic Dungeon,7,4,3.99,3
1693090,V.R.G.,11,1,10.99,10
1753100,舔狗模拟器,66,44,2.49,22
1055610,Deep Space Battle Simulator,278,52,9.99,226
1547890,Let's Build a Zoo,1776,192,19.99,1584
1133060,Anarchy: Wolf's law,263,45,14.99,218
1788980,Solitaire TED and PET,1,1,0.49,0
1568210,Mantle,16,0,3.99,16
1778090,Castle Life,6,11,0.99,-5
1631790,Dawnbreaker - Aeon's Reach,14,14,9.99,0
1708970,The Prince of Landis,9,0,7.99,9
1659210,Uninvited Guest,111,31,9.99,80
1802720,Sixtar Gate: STARTRAIL,668,39,24.99,629
1752610,Give Me More Pills,30,1,1.99,29
1748610,Evil God Korone,400,12,5.99,388
1404030,Fighting for Justice Episode 1,7,1,0.99,6
1773320,Coin Treasures,62,15,0.0,47
1423600,BLUE REFLECTION: Second Light,520,41,59.99,479
1551360,Forza Horizon 5,71315,10363,59.99,60952
1777830,Midnight: Submersion - Nightmare Horror Story,106,20,4.99,86
1569040,Football Manager 2022,15445,1289,54.99,14156
898920,Axis & Allies 1942 Online,2615,760,19.99,1855
1799570,Maverta,2,1,0.49,1
1722760,My Singing Monsters Playground,62,4,39.99,58
1244460,Jurassic World Evolution 2,11203,2330,59.99,8873
1712840,Tiny Tina's Assault on Dragon Keep: A Wonderlands One-shot Adventure,218,96,9.99,122
1156760,ParaLily,15,0,3.99,15
1793220,Airship Killer,9,2,10.99,7
1757680,Miner Gun Builder,23,3,5.99,20
1772710,Aeroplane Blaster,10,3,10.99,7
1525410,Wulin Chess,306,62,11.99,244
1793900,Spooky Mahjong,13,5,10.99,8
1192900,IRON REBELLION,168,39,11.99,129
1444190,Death Becomes You - Mystery Visual Novel,17,2,8.99,15
1173810,FINAL FANTASY V,855,135,17.99,720
766570,Russian Fishing 4,19370,5757,0.0,13613
897730,Among Trees,923,397,14.99,526
1392690,Gravitational,2,3,9.99,-1
1798160,Gaslamp Cases 2,3,0,5.99,3
1589490,MeiQi 2022,55,14,7.99,41
1286880,Ship Graveyard Simulator,573,220,14.99,353
1471410,SYNTHETIK 2,738,170,19.99,568
1066180,Crisis VRigade 2,197,38,19.99,159
1178830,Bright Memory: Infinite,27835,2135,19.99,25700
1547090,Fantasma,9,8,7.99,1
1412070,Siege the Day,14,7,12.99,7
750290,Slice of Sea,316,19,24.99,297
1804450,Kingdom of Maverta,4,7,1.99,-3
1470380,A Pretty Odd Bunny,9,1,4.99,8
1576060,Suspects: Mystery Mansion,686,136,4.99,550
1244630,House Builder,929,233,14.99,696
1541790,Punk Wars,63,31,19.99,32
1799560,Larry The Unlucky Part 3,16,3,1.99,13
1312960,Epic Chef,269,58,9.99,211
1780420,The Quiet Apocalypse,11,5,12.99,6
1269710,Kainga: Seeds of Civilization,254,53,19.99,201
1111460,小白兔电商~Bunny e-Shop,7804,343,10.99,7461
1798420,End of this World,11,8,9.99,3
1137460,ALTF4,6832,1418,2.99,5414
1585020,JUNKPUNK,288,74,15.99,214
1560450,the Sequence [2],19,0,4.99,19
1615930,[International] Absented Age: Squarebound,23,1,12.79,22
1785200,Сhick Boy Adventures,12,4,10.99,8
1604780,Lovely Planet Remix,25,0,6.99,25
1795980,Reborn Tribe,15,4,6.99,11
1493240,La Porte des Fauconniers : Guerre Médiévale,15,0,9.99,15
1799820,DayDream Mosaics 2: Juliette's Tale,1,0,8.99,1
1231460,Candy Disaster - Tower Defense,208,21,13.99,187
1413970,Fox Girls Never Play Dirty,127,18,19.99,109
1805490,问道仙途2,11,13,2.99,-2
1794950,LOST BUBBLES: Sweet mates,33,15,2.99,18
1543240,Gigapocalypse,108,6,4.99,102
1566540,New York Rat Simulator,74,14,2.99,60
1799160,Math+Sticks - Coffee Break Club,34,2,1.99,32
1101030,Noara: The Conspiracy,64,12,0.0,52
1195290,Moncage,3421,178,14.99,3243
1749350,Gobby McGobblenutz Presents: The Art of the Dad Joke: Chapter 1,120,10,1.99,110
1434610,Darkzone: Idle RPG,82,46,0.0,36
1609870,Pro Basketball Manager 2022,71,31,24.99,40
1304350,Urge,6,2,17.99,4
1137300,Sherlock Holmes Chapter One,1328,296,44.99,1032
939400,LoveChoice,8848,357,1.99,8491
1464290,Splash Cars,12,1,4.99,11
1240440,Halo Infinite,106133,38163,0.0,67970
1076610,Guardian of the future,24,5,6.99,19
1583320,Pro Soccer Online,2739,354,9.99,2385
1665210,Sakura Forest Girls 3,12,0,9.99,12
1492680,The Pathless,558,49,39.99,509
1525700,Tavern Master,3554,280,14.99,3274
1682070,ball heroes,7,0,9.99,7
1276790,Ruined King: A League of Legends Story™,7480,875,29.99,6605
684450,Surviving the Aftermath,2179,927,29.99,1252
1083870,CountryBalls Heroes,257,41,14.99,216
1487560,StarCrawlers Chimera,16,2,19.99,14
1266840,The Last Stand: Aftermath,2954,654,24.99,2300
846770,DYSMANTLE,1642,104,19.99,1538
1158420,SimCasino,445,109,16.24,336
1651960,Hextech Mayhem: A League of Legends Story™,1674,393,9.99,1281
1380420,Grow: Song of the Evertree,1159,167,24.99,992
895760,Ollie-Oop,9,0,12.99,9
1551160,Combat Mission Cold War,82,37,59.99,45
760650,Hammerting,1328,705,9.99,623
1638330,Darius Cozmic Collection Arcade,65,4,44.99,61
1078760,Motorcycle Mechanic Simulator 2021,634,225,19.99,409
1422430,Next Space Rebels,168,29,19.99,139
1174640,Arcadia Fallen,116,3,24.99,113
1475460,3 Minute Heroes,170,22,9.99,148
860890,Factory Town,3228,302,19.99,2926
1655190,AIKAGI,13,0,19.99,13
1592530,Blub Emporium,32,2,16.99,30
1516750,Alien Marauder,162,54,19.99,108
1364390,Animaze by FaceRig,1084,701,0.0,383
1794300,BLUE WISH DESIRE,27,0,9.99,27
1217060,Gunfire Reborn,70481,4046,19.99,66435
1337100,Warhammer Age of Sigmar: Tempestfall,113,53,29.99,60
1391540,Uberlaufer,51,7,18.99,44
1297800,ChronoBreach Ultra,27,2,2.99,25
1793240,Destroy The Cubes 2,11,1,0.99,10
1630690,Equin 2: The Warren Peace,13,0,9.99,13
1267910,Melvor Idle,5737,404,9.99,5333
1693070,THE MADHOUSE | Infected Mansion,5,2,9.99,3
1665250,Nightmare,10,4,9.99,6
1795750,Conquest,23,4,13.99,19
928990,Undungeon,206,67,19.99,139
1491400,Sucker Punch VR,9,0,19.99,9
1756160,Unsafe,101,50,11.99,51
1809040,Base Dune,9,4,1.99,5
1623690,异界转生 这次变成了传说中的勇者呢（受）,11,2,18.99,9
1807930,Railway Islands - Puzzle,122,6,2.99,116
1715780,The Crafter's Defense,6,1,14.99,5
1528810,Exodus Borealis,182,13,19.99,169
773370,Exo One,2741,264,16.99,2477
1286280,Pronty,467,21,17.99,446
1634450,B-17 Flying Fortress: World War II Bombers in Action,8,2,8.99,6
1251210,Dungeon No Dungeon,295,181,6.99,114
1740050,Hidden Objects - Sleeping Beauty - Puzzle Fairy Tales,25,1,2.99,24
1008950,Armored Front: Tiger Command,25,12,19.99,13
1787160,Cupid Nonogram,47,3,2.99,44
1414000,Obscurite Magie: The City of Sin,53,16,19.99,37
1784780,Hero of the Kingdom: The Lost Tales 2,373,34,6.99,339
1636850,CYBRID,53,8,14.99,45
1767310,Midnight Mahjong,123,59,6.99,64
1775470,Romino's Adventure,9,0,11.99,9
1426120,Re:DESTINY,214,83,1.99,131
1517290,Battlefield™ 2042,39121,106038,29.99,-66917
839330,Catch Me If You Can,16,1,4.99,15
1696090,HYPERBALL TACHYON,11,0,7.99,11
1716940,Ancient Gods,93,29,19.99,64
1808080,Te Encontré,11,1,3.99,10
1804280,Jo-Jo Fighter,13,2,9.99,11
1510580,Toy Tinker Simulator,133,70,3.24,63
1804360,Slot Idler,6,0,3.99,6
1732650,Robot88,80,27,5.99,53
1248130,Farming Simulator 22,28444,3500,49.99,24944
1559390,Fate Seeker II,10042,935,22.6,9107
1810870,Myths or Reality: Fairy Lands Collector's Edition,1,0,4.99,1
1802460,Pregnant,9,6,0.0,3
1691560,Mido and Di,144,114,0.99,30
1018800,DEEEER Simulator: Your Average Everyday Deer Game,2323,236,14.99,2087
1733610,Alpine - The Simulation Game,15,13,24.99,2
1361840,Tunnel of Doom,32,16,13.99,16
1383650,Drone VR,5,1,0.89,4
1781050,Robin Hood: Spring of Life,4,1,6.99,3
1187870,FORZA POLPO!,13,1,14.49,12
1585050,Cliffhanger: Challenger of Tomorrow,5,0,5.99,5
1814610,Middle Ages Jigsaw Puzzles,1,0,2.99,1
1762270,Obama Boss Fight,324,12,2.99,312
1802330,INVITATION To FEAR,76,34,4.99,42
1781840,里帰り | Satogaeri,18,6,2.99,12
1787790,Kirakira Monstars,171,148,18.99,23
1780290,Let's Puzzle,23,0,1.99,23
930230,King under the Mountain,92,26,24.99,66
1706870,Sven's SudokuPad,27,2,2.99,25
1788120,PCI Public Crime Investigation,28,1,19.99,27
1740000,Cute Honey: Bunny Girl,451,194,4.99,257
1815430,Cursed House 10 - Match 3 Puzzle,3,0,6.99,3
1787090,MyDockFinder,1248,416,3.99,832
1729780,Gladiator: about to die,8,4,19.99,4
1795620,DOOM DAY,6,1,9.99,5
1291220,Crash The Core,33,12,4.99,21
1805040,Implements of Hell,49,15,4.99,34
1704980,Jigsaw Puzzle - Jack and the Beanstalk,10,0,1.99,10
1817400,Mistake,15,4,0.99,11
1779200,Thrive,314,35,4.99,279
1706060,Cubic Dweller,1,1,0.0,0
1335830,Len's Island,1471,169,24.99,1302
1810960,Andy's Apple Farm,318,36,2.99,282
1648390,ScooterFlow,453,34,10.99,419
1818940,Typing Land,9,0,4.99,9
1646790,Striving for Light,24,3,7.99,21
1794780,SiNiSistar Lite Version,228,17,4.99,211
1025960,BURIED STARS,763,101,39.99,662
1391530,Mud and Blood,251,25,12.99,226
1318280,OverShoot Battle Race,18,1,9.99,17
1772380,飞机女孩,4,7,0.99,-3
1513860,Raptor Territory,33,8,0.99,25
1810410,DELUGE,18,0,4.99,18
1570020,World's End Club,78,32,29.99,46
1610470,MXGP 2021 - The Official Motocross Videogame,158,56,49.99,102
1400630,Afterthought,12,0,24.99,12
1432320,Liftoff: Micro Drones,99,16,14.99,83
792120,FIGHT KNIGHT,638,38,19.99,600
1600880,Madness Beverage,7,4,14.99,3
1756800,Casino Tycoon Simulator,8,7,14.99,1
1625670,AutoCube,3,0,4.99,3
1706090,Bean and Nothingness,67,1,11.99,66
1616540,Exodus H,2,7,24.99,-5
1552810,Twin Mirror,175,51,29.99,124
1487390,ANVIL,1220,709,24.99,511
1701380,Cricket 22,654,238,44.99,416
1723570,Quest of Wizard,11,0,2.99,11
1730840,Fantasy Gardens,8,1,3.99,7
1287920,Brass: Birmingham,187,106,18.99,81
1822450,The Slaverian Trucker,138,21,11.99,117
1798520,Froggerty Arcade 2,2,2,1.99,0
1269020,No Plan B,184,14,14.99,170
1549180,Propnight,7563,3622,19.99,3941
1515200,Mission in Snowdriftland,212,8,6.99,204
1527950,Wartales,5681,571,27.99,5110
1819340,SUL 3D - Schütze Unser Land,9,2,9.99,7
1338220,Forsaken Portals,13,3,18.99,10
1795110,150+ Card Games Solitaire Pack,5,2,14.99,3
841110,HOLY COW! Milking Simulator,3,0,0.99,3
1735950,Paper Bride,1070,95,7.99,975
1819870,Draft Day Sports: Pro Basketball 2022,11,5,24.99,6
1711530,Justice Chronicles,3,0,14.99,3
1745170,Primitier,63,7,19.99,56
1206560,WorldBox - God Simulator,11497,743,19.99,10754
1584900,Faerie's Bargain: The Price of Business,8,4,5.99,4
1296360,Archvale,1256,139,14.99,1117
1206610,Rubber Bandits,769,206,7.99,563
1265820,Fights in Tight Spaces,1838,119,24.99,1719
1820180,Color by Number - Monster Heroes,1,0,1.99,1
1809730,babyquick : Adventure of the Moon Dragon,14,3,4.99,11
1766550,A Visit to Friends,3,0,0.0,3
485400,Mechajammer,104,86,24.99,18
1241440,Elfin Clay,6,2,16.99,4
918570,Century: Age of Ashes,9516,3491,0.0,6025
1787820,Mirror Party,871,296,1.99,575
1197730,DelayedSun,18,14,4.99,4
1597550,Highrise Mogul,27,22,9.99,5
1153520,6Souls,15,1,4.99,14
1751230,Kingdom Traveler,13,1,7.99,12
1256830,Shelter Manager,191,84,14.99,107
1433340,Happy's Humble Burger Farm,762,59,19.99,703
1153640,Chorus,1407,223,39.99,1184
1721530,The Captain,185,13,19.99,172
1279260,Lelie Navigation!,184,18,14.99,166
1591900,My Universe - Interior Designer,2,2,24.99,0
1813140,Christmas Horror,10,9,0.99,1
1772350,重装燎原,9,2,0.99,7
1149460,ICARUS,15745,8427,34.99,7318
1296440,Gardenia,76,6,10.99,70
1820720,The Divine Deception,16,0,14.99,16
1801650,Lost: Find,1382,173,3.99,1209
1289810,Siralim Ultimate,1216,63,13.39,1153
1451950,Street Outlaws 2: Winner Takes All,17,7,49.99,10
1809930,Christmas With My Family - Jigsaw Puzzle,15,0,0.69,15
1377450,Knell of St. Godhrkar,756,51,0.0,705
1798930,SQUID GUYS,105,69,6.99,36
1602490,Waifus Smash,124,41,2.99,83
1808860,Pizza Man,7,1,0.49,6
1385940,Panty&Demons,23,5,6.99,18
1159860,Dash Dash World,121,30,24.99,91
891360,Hellcoming,436,105,4.99,331
1718160,Crimzon Clover World EXplosion,141,4,19.99,137
1696720,PsiloSybil,52,1,17.99,51
1604300,LOVE 3,51,1,9.99,50
1579380,Shadow Tactics: Aiko's Choice,2071,186,7.99,1885
1556650,Castle of Shikigami 2,28,1,19.99,27
1437750,Stellar Monarch 2,22,1,24.99,21
1823940,Defenders Glory,12,2,9.99,10
730430,This Is the President,120,46,14.99,74
1507780,Space Warlord Organ Trading Simulator,174,27,13.99,147
1492310,Asterix & Obelix: Slap them All!,59,37,24.99,22
1685460,A-Train: All Aboard! Tourism,68,26,59.99,42
1802080,SGS Operation Hawaii,8,4,9.99,4
1557860,Gear.Club Unlimited 2 - Ultimate Edition,32,19,34.99,13
1158890,White Shadows,207,53,13.99,154
1331210,Wolfstride,390,39,14.99,351
1624940,Restaurant Solitaire Delicious Lunch,1,1,0.49,0
1758370,18Korea,14,4,9.99,10
1580240,Rune Factory 4 Special,854,103,29.99,751
673210,Frontier Pilot Simulator,517,227,24.99,290
1826760,Among the zombies,12,7,10.99,5
1070820,RealFlight 9.5S,384,87,69.99,297
377300,Thunder Tier One,2561,812,19.99,1749
1138850,Heavenly Bodies,1308,64,19.99,1244
1819120,死亡编码-Death Code,6,2,2.99,4
1733500,Looking for Aliens,88,1,12.99,87
1747050,Sam & Max: Beyond Time and Space,143,3,19.99,140
1783750,Winds & Leaves,11,2,29.99,9
1821420,Battle Of The Robots,1,3,0.99,-2
1716120,Monster Rancher 1 & 2 DX,614,80,29.99,534
1053710,The Red Lantern,74,7,24.99,67
1815370,咸鱼的挂机游戏,26,2,1.99,24
1819370,Murder by Moonlight 2 - Crimson Night,7,2,5.99,5
1341300,Cocaine Dealer,58,9,3.99,49
1839260,Mystery Case Files: Incident at Pendle Tower Collector's Edition,3,0,13.99,3
1635980,Kubinashi Recollection,70,4,8.39,66
1826290,WWII Tanks: Battlefield,34,5,2.99,29
729000,Wytchwood,1018,54,19.99,964
493520,GTFO,33986,6189,31.99,27797
1203180,Breakwaters,485,290,19.99,195
1611900,Wandering Trails: A Hiking Game,6,5,4.99,1
1424910,KEO,198,215,9.99,-17
1243200,STUFFED,144,31,12.99,113
1789100,Roman Wars: Deck Building Game,5,0,2.24,5
1522930,Transiruby,122,9,14.99,113
1814010,Stuck In Time,454,82,7.99,372
1580300,Witchcraft U,5,3,4.99,2
1500800,Mr.Bottle and his dream,26,4,2.99,22
1806420,Do U Copy?,15,5,12.99,10
751630,After the Fall®,1205,371,39.99,834
1762010,Wrought Flesh,367,103,19.99,264
1775550,Gary Grigsby's War in the East 2,122,14,79.99,108
1668530,The Legend of Nayuta: Boundless Trails,20,1,39.99,19
1796410,The Touryst,26,4,19.99,22
1622970,Packing House,40,10,9.99,30
1189680,Degraman: Act I. Vincent,98,8,0.0,90
1521580,Perfect Heist 2,603,38,9.99,565
1524470,Strip Fighter 5: Chimpocon Edition,42,23,14.99,19
1515460,Prison Tycoon®: Under New Management,85,45,29.99,40
1674270,Cyberfrags '69,98,0,4.99,98
1069660,Ultimate Admiral: Dreadnoughts,1453,402,34.99,1051
1361230,Cleo - a pirate's tale,359,2,14.99,357
1534050,SCP: Breakout,12,11,11.99,1
1108750,Timerunner,64,10,6.39,54
1184760,Shovel Knight Pocket Dungeon,216,28,19.99,188
1846300,Mystery Trackers: Queen of Hearts Collector's Edition,2,2,9.99,0
1578270,Love Notes,3,4,19.99,-1
1646390,Spheriums,23,1,19.99,22
1808690,Jericho Dungeon,14,1,1.99,13
1540330,MUMBA IV: Egypt Jewels ©,12,1,2.99,11
897610,Scrapland Remastered,42,6,19.99,36
891370,The Last Hex,165,36,10.99,129
1702880,LinearShooter Remixed,11,0,2.99,11
1450060,Down and Out,6,7,14.99,-1
1776400,Shikkoku no Sharnoth,48,5,16.99,43
1517970,Aeterna Noctis,527,118,29.99,409
1833670,2048 3D,9,2,0.99,7
1608550,Firegirl: Hack 'n Splash Rescue DX,83,26,8.99,57
1632330,Calamity Eliminator,48,8,7.99,40
1814490,Scratch Girl,142,38,0.99,104
893720,One Hand Clapping,350,61,14.99,289
1468250,Kukoos - Lost Pets,20,1,29.99,19
494430,Praey for the Gods,1702,323,29.99,1379
1769420,Noble Fates,735,141,24.99,594
1623390,Unplugged,31,18,24.99,13
1481780,Dragon Fist: VR Kung Fu,178,6,29.99,172
1094520,Sands of Salzaar,16022,2971,14.99,13051
1814990,不充钱还想过关的坦克大战？,16,1,0.99,15
1825080,Explosive Snooker,12,2,0.99,10
1670010,Inverse Evolver,26,5,6.99,21
1836230,Evening Ecchi,4,4,1.99,0
1623700,Deiland: Pocket Planet,63,39,19.99,24
1597580,Clid The Snail,69,19,19.99,50
342080,Rogue Invader,24,1,14.99,23
1728830,Space Docker VR,54,1,12.74,53
1398280,Great Lakes Simulator,6,12,24.99,-6
1608270,FILMECHANISM,18,0,19.99,18
1714580,moon: Remix RPG Adventure,97,8,18.99,89
307880,Savage Lands,3636,2910,9.99,726
1819440,Block Line Engineer,8,3,4.99,5
1684480,Atelier Agnes,9,6,7.99,3
1132030,Trash Sailors,145,47,19.99,98
1449320,Alfred Hitchcock - Vertigo,127,27,29.99,100
1430970,Astatos,109,29,14.99,80
747660,Five Nights at Freddy's: Security Breach,31336,6049,39.99,25287
1683000,Geometric Sniper - Z,20,2,3.99,18
1461100,International Basketball Manager 22,140,21,24.99,119
1604000,Milk outside a bag of milk outside a bag of milk,5509,160,8.99,5349
1584840,AGAINST,190,51,13.99,139
1787810,Song in the Smoke,33,7,29.99,26
1635790,ChessCraft,13,1,3.99,12
898720,Kubifaktorium,474,110,19.99,364
1520370,Mon Bazou,4367,152,13.99,4215
1419150,Woodland Empire,11,0,4.99,11
1390700,The Crackpet Show,304,27,16.99,277
1758080,Empires of the Void II,2,6,9.99,-4
1830910,Cow Girls,99,26,0.99,73
1692700,SimplePlanes VR,105,25,9.99,80
1720090,Aspire: Ina's Tale,92,11,12.99,81
1794680,Vampire Survivors,112499,1252,2.99,111247
1695830,Baldur's Gate: Dark Alliance,435,76,29.99,359
848050,GP Bikes,160,8,24.99,152
1821090,Cinemoji: Series,15,0,0.99,15
1308700,Wizardry: The Five Ordeals,196,28,29.99,168
1203420,Miss Neko 2,1165,96,1.99,1069
1725440,House of Rules,92,10,7.99,82
1814200,He Will Shoot,10,12,1.99,-2
1197820,Craftlands Workshoppe,109,52,19.99,57
1521040,Nature Treks: Together,15,7,10.99,8
1836360,Catherine Ragnor and the Legend of the Flying Dutchman,5,1,5.09,4
1369670,Motor Town: Behind The Wheel,1540,81,14.99,1459
1144200,Ready or Not,55714,4487,39.99,51227
1680000,Rewrite+,168,17,49.99,151
1752150,Slobbish Dragon Princess 2,58,1,14.99,57
1788430,BOT.vinnik Chess: Late USSR Championships,15,2,0.69,13
1840490,Christmas Massacre,245,42,7.99,203
1734320,Brutal Orchestra,350,9,14.99,341
1781920,Nakornsampan,7,1,1.99,6
1794400,Plinko Panic!,19,0,7.99,19
1344530,vrkshop,119,24,19.99,95
1772480,Jelle's Marble League,65,24,9.99,41
788670,Waxworks: Curse of the Ancestors,25,21,14.99,4
1688390,Nightron Wars,1,2,10.99,-1
1712690,SourceWorlds,9,0,6.99,9
1758920,Witch Explorer,84,7,6.99,77
1788900,Argonauts Agency: Captive of Circe,6,0,0.59,6
1764240,Jewel Match Atlantis Solitaire 3 - Collector's Edition,10,0,8.44,10
1668720,The Cloud Dream of the Nine,31,3,19.99,28
1801220,God Damn The Garden,39,2,4.99,37
1363740,The Troop,177,18,39.99,159
1841850,Bear Adventures 2,2,2,1.99,0
1218140,Marble Computing,12,0,4.99,12
1702760,In Next Life,15,5,14.99,10
1707560,Lost Alone Ep.1 - Sorellina,58,12,5.99,46
825060,Watch Over Christmas,28,1,12.99,27
1693430,Dungeon Overseer,15,20,0.0,-5
1713100,江湖乐子人,6,10,0.99,-4
1765690,World Wide Hack,45,7,16.99,38
1730360,I'm on Observation Duty 4,385,6,4.99,379
1815020,CosmicBreak Gun & Slash,1,6,19.99,-5
956450,Rogue Fable III,518,33,9.99,485
1457510,The Legend of Heroes: Sen no Kiseki IV -THE END OF SAGA-,102,20,44.99,82
1775750,Gardener's Path,16,1,4.99,15
1808130,Mysteries Under Lake Ophelia,74,5,4.99,69
1341200,DYNASTY WARRIORS 9 Empires,595,628,59.99,-33
1827660,Loco Shortline Operations,13,1,14.99,12
1457520,The Legend of Heroes: Zero no Kiseki Kai,125,23,34.99,102
1831320,Rescue Team: Power Eaters,5,0,6.99,5
1404500,Dungeon Royale,70,13,0.0,57
645320,SCARF,135,18,14.99,117
1788920,New Lands,6,0,5.99,6
1757970,Oasis: Dark Forest,8,0,2.99,8
1720040,Meria and The Island of Orcs,10,0,5.99,10
1533120,Shonen Adventure : The Dual Blades Hero,8,2,13.99,6
1305130,The Lost Legends of Redwall™: The Scout Act 3,9,0,9.99,9
1830720,MOTHERED - A ROLE-PLAYING HORROR GAME,59,3,9.99,56
1695840,Fear Therapy,751,390,4.99,361
1799280,PABG: PLAYER ANIME BATTLEGROUNDS,31,12,1.99,19
1569470,TEOCIDA,58,2,9.99,56
1512940,Malody V,55,47,2.99,8
1825740,Fat Baby,65,9,5.99,56
934180,Trials of Wilderness,32,15,14.99,17
1791410,The rise of Tianling Sect,7,0,2.99,7
1838790,Angry Rocketeer Frenzy,11,4,24.99,7
1819090,Watermelon Wars,5,2,1.99,3
1577710,Human Guise: Chapter Ⅰ,13,0,2.99,13
1835840,Quarantineer,249,65,8.49,184
405010,Bitardia,674,89,5.99,585
1785440,Russian Train Trip,51,38,2.99,13
1814270,Metallophobia,13,0,4.99,13
1699530,HIDEAWAY,3,15,7.99,-12
1482320,琉隐,68,29,8.99,39
1818150,Pinecone Game,27,0,0.99,27
1699960,Falta,27,1,2.99,26
1652740,True Visions,6,3,9.99,3
1392150,Hover Attack,10,0,14.75,10
1848250,Dog Adventure,14,0,0.99,14
1737070,风起长安：驭骨人,162,21,13.99,141
616720,Live2DViewerEX,2480,188,4.99,2292
1815440,Chinese Driving Test Simulator,280,122,0.99,158
1449570,The Godkiller - Chapter 1,8,2,19.99,6
1796180,Peculiar Tales of Mid-Lake Pavilion,116,6,8.99,110
1591520,Clownfield 2042,3177,533,0.99,2644
1223020,Minnano Gensokyo Single,157,8,6.99,149
1546930,Angry Angry Shark,172,31,0.0,141
1734160,Search of Galaxy,13,6,9.99,7
1851640,Police Hot Pursuit,10,3,19.99,7
1857160,Ms. Holmes: The Adventure of the McKirk Ritual Collector's Edition,5,0,13.99,5
1728690,Legendary Tales: Cataclysm,10,0,6.99,10
1444150,BLINK: The Last Night,55,8,4.99,47
1720780,12 Labours of Hercules XIII: Wonder-ful Builder,2,0,11.99,2
1853270,Army To Army,10,4,24.99,6
1705220,烈山海贰,51,8,19.99,43
1784630,Alice!,25,3,9.99,22
1475430,天师,167,117,7.99,50
1515900,Heaven Dust 2,464,48,14.99,416
1788890,Argonauts Agency: Glove of Midas,4,2,0.59,2
1831980,Idle Superpowers,23,8,6.99,15
1796920,Sword of Elpisia,5,0,14.99,5
1818180,The RPG Engine,57,2,19.99,55
1788780,VenusBlood HOLLOW International,175,7,44.99,168
1826450,Idling Idol,13,3,5.09,10
1807750,封神榜2022,682,58,9.99,624
1763050,Fears to Fathom - Norwood Hitchhike,598,93,2.99,505
1324780,Easy Red 2,1564,227,7.99,1337
1314770,Three Kingdom: The Journey,28,10,12.99,18
1770390,Bound by Love,311,65,14.99,246
1825350,Haunted Hotel: Silent Waters Collector's Edition,7,2,9.99,5
1676380,Kingdom of Atham: Crown of the Champions,151,31,19.99,120
1455300,Glory of Rome,24,8,6.99,16
1792520,Rock Star Manager,12,4,1.99,8
1482640,Nurose,56,9,9.99,47
1807080,Ghost Exile,875,136,14.99,739
1684100,Halluci-Sabbat of Koishi,189,7,4.99,182
1794390,Drug Business,14,15,9.99,-1
588930,King 'n Knight,32,9,11.99,23
1846480,Refraction: Beyond the Mirror,11,2,7.99,9
1200220,Fishing Adventure VR,3,6,3.59,-3
1563180,Internet Cafe Simulator 2,4038,1709,19.99,2329
520010,Climbey,1008,99,7.49,909
1457650,幻想三国志4,21,15,5.99,6
1457620,幻想三国志,108,67,1.99,41
1457630,幻想三国志2,78,38,3.99,40
1457640,幻想三国志3,29,48,3.99,-19
1457660,幻想三国志4外传,30,13,5.99,17
1659180,TD Worlds,21,7,10.99,14
1591050,Help me please,15,1,9.99,14
1714590,Buck Up And Drive!,380,26,7.99,354
1689350,My life as an archeologist,219,29,4.99,190
970500,秦殇 (Prince of Qin),1197,420,0.99,777
1854740,HINA-CHAN's BIG TRADE! Millionaire Lunch,13,1,6.99,12
1844540,Word of the Law: Death Mask Collector's Edition,5,0,9.99,5
581660,Super Meat Boy Forever,295,289,19.99,6
1401170,World War 2: Strategy Simulator,20,34,0.0,-14
1852380,MAGICAL DEATHPAIR,26,1,7.99,25
1802860,大富翁少女/Rich Girls,209,59,2.99,150
1435970,Anomalous,53,5,4.99,48
1331390,sfäre,13,0,4.99,13
1544890,Ship Simulator Realistic,19,4,34.99,15
1621560,Black One Blood Brothers,254,85,17.99,169
1819980,Writer's Life,280,53,2.99,227
1543090,LiBER,52,11,8.99,41
1828740,My Nemesis and Hero - A Slice of Life BL/Yaoi Visual Novel,22,3,4.99,19
1446780,MONSTER HUNTER RISE,37494,5799,59.99,31695
1621070,DeadPoly,1212,245,19.99,967
1174030,Hero Lodge,16,0,9.99,16
1767220,The Kids We Were,69,7,15.99,62
1461920,The Legend of Heroes: Ao no Kiseki KAI,77,6,34.99,71
1852990,Disaster,14,5,10.99,9
1836120,QUICKERFLAK,97,6,0.49,91
1120480,The Anacrusis,412,413,29.99,-1
1086850,Garden of the Sea,421,35,24.99,386
1775520,The Soul Stone War 2,16,1,6.99,15
1725860,Keng's Little Universe,11,3,3.99,8
1622560,Interplanetary Gardener,7,2,0.99,5
1662570,Rescue Party: Live!,101,44,9.99,57
1862840,Bash the Teacher! - Classroom Clicker,25,12,0.0,13
1785680,SPECWAR Tactics,15,7,9.99,8
1410710,Democracy 4,2970,583,26.99,2387
1496250,Mary Skelter 2,72,8,34.99,64
1295900,Draconia,252,94,34.99,158
1778720,Blast Beat,38,1,15.99,37
1531620,reIterate(),40,1,5.99,39
1839700,Milk Bottle And Monster Girl,232,54,1.99,178
1804870,Dungeon Masters,6,1,1.99,5
338840,Hollow's Land,44,45,2.99,-1
1228330,The Last One Month,81,15,8.99,66
1012850,ANDERSON,20,10,4.99,10
1151530,Synthetic Lover,40,5,24.99,35
1383680,Isekai Succubus ~My Genderbent Saga in Another World~,75,8,14.99,67
1658870,New Home: Medieval Village,92,45,19.99,47
1674890,👑 Idle Calibur 👑（选王之剑）,875,116,7.99,759
285110,GearCity,996,137,19.99,859
1687940,Lolita Expedition,149,5,4.73,144
1593500,God of War,51719,1621,49.99,50098
1704830,DR4X,18,0,9.99,18
1522870,Supraland Six Inches Under,1580,46,19.99,1534
1811940,Archipelago,22,4,4.99,18
1287140,Sonia and the Hypnotic City,40,26,14.99,14
1456230,Cthulhu: Death Escape / 克苏鲁:死亡逃脱 Prototype,76,28,0.0,48
1846290,Avocado Love,13,0,1.99,13
1788910,Argonauts Agency: Missing Daughter,3,0,5.99,3
1637200,Mage Tower,21,10,9.99,11
1841390,100 hidden fish,135,4,0.99,131
1679830,Chernobyl inferno,17,2,4.99,15
1702180,Goat's Tale,230,43,0.0,187
1805390,Follow the Black Kitten,16,3,0.99,13
1367300,Blade Assault,1111,250,17.99,861
1256530,Sentimental K,231,41,24.99,190
1296830,暖雪 Warm Snow,15482,1681,17.99,13801
1733060,Ever Seen A Cat?,199,2,1.99,197
1859590,The Zombie Smasher,7,7,4.99,0
1571160,Lost Scavenger,112,54,14.99,58
1591150,Paranormal Detective: Escape from the 90's,36,5,11.99,31
1430750,Blacksmith Legends,59,48,17.99,11
1714080,---Red---Tether-->,32,0,12.99,32
1432050,Nobody Saves the World,2531,225,18.74,2306
1567520,Blackwind,29,24,24.99,5
1192440,The Monster Breeder,32,0,19.99,32
1264880,Watcher Chronicles,93,12,19.99,81
1668690,Alina of the Arena,1421,130,12.99,1291
1872790,Luckitown,123,17,4.99,106
1815030,G-MODEアーカイブス+ 弾幕検定死験-大往生編-,4,0,4.99,4
1641660,RPGolf Legends,11,4,29.99,7
1732330,Ys IX -Monstrum NOX-,119,12,38.49,107
1798780,Dimension Tripper Neptune: TOP NEP,219,10,4.99,209
1661640,Tough Law,35,1,0.99,34
1859650,Ryzer: The Reflectors Path,23,1,0.99,22
582330,Warriors: Rise to Glory,705,164,19.99,541
1611600,WARNO,2692,726,39.99,1966
1114290,Windjammers 2,377,49,19.99,328
1289990,Alan's Automaton Workshop,113,20,14.99,93
984600,Trinoline Genesis,15,1,29.99,14
1770830,Virtual Maid Streamer Ramie,29,0,12.99,29
1643820,Age of Jura,7,0,19.99,7
1808900,GRAND CROSS: ReNOVATION,55,0,14.99,55
964020,Make Your Kingdom,114,61,14.99,53
1028350,Pupperazzi,248,9,19.99,239
980640,Empire of Ember,90,37,24.99,53
1850150,守护者盟约,4,10,4.99,-6
987840,Expeditions: Rome,2709,341,44.99,2368
1574270,Sucker for Love: First Date,1536,18,9.99,1518
1832640,Mirror 2: Project X,35562,2331,1.19,33231
1045610,Startup Panic,80,58,14.99,22
1659040,HITMAN 3,3134,1362,59.99,1772
1836690,Red Bash,7,1,4.99,6
1109570,Word Game,3667,235,34.99,3432
1691270,Pizza Ghest,9,6,4.99,3
1451940,NEEDY STREAMER OVERLOAD,12903,678,15.99,12225
1751630,Hello Lady! - Complete Edition,192,26,29.99,166
1835870,The Black Cat Magician,171,15,3.99,156
1842480,NeuraGun,27,3,5.99,24
1817000,Zodiacats,108,0,1.59,108
1802430,A Maze Fox,13,0,2.99,13
1788840,Porcelana,9,0,8.99,9
1855030,Stairway to Heaven's Gate,13,0,1.99,13
1854090,Peach Territory,9,4,8.99,5
1786200,Wars and Roses,1093,1303,19.99,-210
1827730,Adarin Farm,6,2,5.99,4
1745710,"Cato, the cat",17,1,0.99,16
1574580,Strange Horticulture,3226,139,14.99,3087
1820320,神徒,32,9,3.99,23
1346770,YAKIMOCHI STREAM,74,5,24.99,69
1788880,Argonauts Agency: Chair of Hephaestus,4,0,5.99,4
1608290,GNOSIA,1219,83,24.99,1136
1845560,真 麻雀天下布武,6,5,2.99,1
1768400,アーキタイプ・アーカディア,2,0,29.99,2
1380520,Racing Outlaws,16,1,0.99,15
1413980,The Demon Lord is New in Town!,75,24,24.99,51
976890,Hidden Deep,1264,391,24.99,873
1803150,Void Slayer,15,4,4.99,11
1778960,Mystery of Fortune 2 Refine,72,26,0.0,46
1854290,Kakureza Library,14,3,9.99,11
1796210,Roads Of Rome: Portals Collector's Edition,6,1,5.99,5
1846330,Nope Nope Nurses,191,55,19.99,136
1792250,Serious Sam: Siberian Mayhem,2090,174,19.99,1916
1652490,Boxing Club Manager,34,23,39.99,11
1845480,Connected Hearts: The Full Moon Curse Collector's Edition,1,0,9.99,1
1720750,Kingdom of Assetia: The Clicker Game,5,6,0.99,-1
1855930,Recruit&Adventure,15,4,9.99,11
1875530,Grim Tales: Graywitch Collector's Edition,0,2,9.99,-2
1399690,Reverie Knights Tactics,35,27,18.74,8
1170950,Mortal Online 2,4754,3128,26.79,1626
1147550,Not For Broadcast,7156,377,24.99,6779
1520850,Mess Adventures 2,58,10,4.99,48
1448190,Fighties 2,4,2,11.99,2
1871780,Rorys Restaurant Origins,3,1,5.39,2
1268810,Doors of Insanity,145,48,16.99,97
616680,Monster Showdown,24,5,14.99,19
767490,Last Wood,368,158,14.99,210
1489300,Operation STEEL,36,2,14.99,34
992300,嗜血印 Bloody Spell,20260,2806,24.99,17454
1418630,Dread Hunger,21394,13558,29.99,7836
1873990,3D PUZZLE - Old House,20,8,0.99,12
1112110,Redemption Cemetery: Dead Park Collector's Edition,4,1,9.99,3
1836180,Turn off the light,7,1,2.99,6
1795410,JENTRIX,14,0,7.99,14
1736550,Deflector,96,15,14.99,81
1599560,Wanderer,366,68,39.99,298
1872130,Cat and fish,7,5,9.99,2
1403370,Zenith: The Last City,2737,523,29.99,2214
1733880,Gunvolt Chronicles: Luminous Avenger iX 2,223,84,19.99,139
1768880,KAMIMAHOU 神之国的魔法使,230,40,19.99,190
1743530,"Mireille and Amrita, the Forest of Illusions",3,1,19.99,2
1595280,卡牌缔造者-CardMaker,130,41,9.99,89
1689510,RPGScenery,10,4,6.99,6
1475850,Rugby 22,95,32,39.99,63
1726410,Seal of Evil,7,1,9.99,6
1595020,Otteretto,23,0,4.99,23
1822640,Rogue Dungeon,14,4,9.99,10
1843760,Rogue Tower,2622,538,14.99,2084
1536730,Chaos Chain,17,1,9.99,16
1816650,Nelson and the Magic Cauldron: The Journey,25,4,14.99,21
1332760,Nienix: Cosmic Warfare,49,5,14.99,44
1274710,Lullaby Days,58,8,19.99,50
1693250,Ancient Wars: Sparta Definitive Edition,100,30,19.99,70
1869890,DESTROY Simulator,16,3,0.99,13
1847750,Project Kunai,10,1,4.99,9
1853190,Life is Paine,6,1,3.0,5
1638300,Solargene,232,63,17.99,169
1428140,Riding Seas,25,0,12.99,25
725100,Exoblast,227,53,0.0,174
1855270,Pachillinko,22,11,1.33,11
1832260,Chromarena,3,0,2.99,3
1265920,Life is Strange Remastered,742,359,39.99,383
1751270,GunsBox VR,18,1,15.99,17
793830,Kharon's Crypt - Even Death May Die,87,0,14.99,87
1265930,Life is Strange: Before the Storm Remastered,304,253,39.99,51
1251250,Cock Soccer,7,0,14.99,7
816850,Stardust Origins,15,2,18.99,13
1604210,Grid Slayer,17,2,11.99,15
1581170,The Hundred Year Kingdom,47,12,12.99,35
1783740,Essence Of The Tjikko - Prologue,12,1,5.99,11
957710,The Waylanders,229,189,34.99,40
1341210,Afterinfection,220,101,8.99,119
1879720,AFTERLIFE: KILLING DEATH,8,6,4.99,2
1782860,Community College Hero: Fun and Games,10,0,3.99,10
534380,Dying Light 2 Stay Human,76662,21019,40.19,55643
1711740,Cheftastic!: Buffet Blast,15,0,10.99,15
1371880,Solar Echoes: The Star Legation,11,0,14.99,11
588120,Capsa,118,89,0.0,29
1880910,Zombie Good Guy,9,4,0.99,5
1813550,ARTISAN,7,1,9.99,6
1801470,Devil's Dungeon,181,32,1.49,149
1301000,MYSTERY of the Missing Brigantine,1,0,5.99,1
1861880,Air Traffic: Greenlight,23,2,4.99,21
1725880,Project SNAQE,9,1,1.99,8
1661920,Ancient: Legacy of Azul,40,9,4.99,31
1697720,The Heilwald Loophole,95,2,9.99,93
1855500,Neko Doll,51,12,1.99,39
1721350,Escape the Ayuwoki: Horror Night,68,48,4.99,20
1842610,Dungeon Wizards,31,4,6.99,27
1399750,Beholgar,73,23,8.99,50
1854980,Madohi Shiroki no Kamikakushi,250,10,29.99,240
1271260,Land of Screens,40,3,5.99,37
1551520,Kamikaze Kommittee Ouka 2,74,22,14.99,52
1738520,Bikini Armour Explorers,73,23,15.99,50
1883580,Cactus Simulator,137,10,0.99,127
1871230,Bitcoin Chill,9,0,2.99,9
1856860,Magic City Detective: Wings Of Revenge Collector's Edition,2,0,1.99,2
1807940,Mortals and Monsters: Blood Orc,9,3,0.0,6
1859280,7 Days to End with You,556,37,4.99,519
1863750,挂机神话,971,73,1.99,898
1677380,Astronium,20,0,2.99,20
1763830,My Truck Game,115,15,6.99,100
1431230,Gods of Sand,280,16,9.99,264
1876980,戛然而止的音符,12,6,0.99,6
1848890,Gordon Streaman 2,36,14,12.99,22
1190170,OlliOlli World,607,30,23.99,577
679110,Werewolf: The Apocalypse - Earthblood,156,68,29.99,88
1871510,Within Skerry,127,21,4.99,106
1164250,Model Builder,657,180,19.99,477
1413370,Power to the People,212,44,14.99,168
1492190,Orbi's chronicles,3,0,7.99,3
1826570,First Class Escape 2: Head in the Clouds,63,16,7.99,47
1863420,Crazy Cube Adventure,11,1,0.99,10
1896610,Edge of Reality: Lost Secrets of the Forest Collector's Edition,2,1,13.99,1
1607200,Cyanotype Daydream -The Girl Who Dreamed the World-,234,41,39.99,193
1032750,Zombie Shooter: Ares Virus,6,7,4.99,-1
1272320,Diplomacy is Not an Option,2601,414,24.99,2187
1033080,Letters - a written adventure,95,4,14.99,91
1885090,3D PUZZLE - Modern House,15,6,9.99,9
1856680,The Age of Navigation,63,44,5.99,19
1767160,I Love Finding MORE Cats,5,0,6.99,5
1871350,OS:Memories,9,3,6.99,6
1708820,Guardian Force - Saturn Tribute,7,3,17.99,4
1004620,KungFu Kickball,41,9,19.99,32
1885160,Tumblefire,14,2,9.99,12
1546280,Mad Pack,153,74,0.0,79
1859310,C.O.D.E.R.E.D,1,2,10.99,-1
1345860,Grapple Dog,195,19,14.99,176
1885640,Warehouse Simulator: Forklift Driver,28,10,2.74,18
1826910,Please Subscribe,77,11,9.99,66
685670,Know by heart,407,61,19.99,346
698700,Rise of the Third Power,225,20,19.99,205
1843920,Communist Clicker,8,1,2.99,7
1789620,Brimstone Manor,6,4,4.99,2
1882140,Decisive Campaigns: Ardennes Offensive,42,3,39.99,39
1587130,Blood West,928,70,14.99,858
1360850,Isles of Yore,69,23,19.99,46
1608040,Castle Morihisa,234,99,14.99,135
1149290,Derpy Conga,24,4,16.99,20
1298480,Kardboard Kings: Card Shop Simulator,207,68,19.99,139
1641890,Lust from Beyond: M Edition,96,43,17.99,53
1714190,Breakout: Recharged,29,1,9.99,28
1678430,PowerSlave Exhumed,348,28,19.99,320
1718910,Prose & Codes,65,0,9.99,65
1599340,Lost Ark,124308,44066,0.0,80242
1878070,Roma Invicta,106,21,5.99,85
1660280,H-Isekai Loves,821,132,2.99,689
887570,NEBULOUS: Fleet Command,905,61,19.99,844
1829650,Sekai to Sekai no Mannaka de,140,4,29.99,136
1799520,The Legend of Pomodoro,25,2,6.99,23
1878970,Boom Bears on Stream,13,0,5.99,13
1896620,Detectives United: Deadly Debt Collector's Edition,0,1,13.99,-1
1295700,Nitroverse,4,0,4.99,4
1881950,Reimei no Gakuen - Otome/Visual Novel,10,0,24.99,10
1600370,Not Tonight 2,157,20,19.99,137
1747430,Bomberpet,8,1,2.24,7
1891230,Hidden Tavern Top-Down 3D,13,7,9.99,6
1680270,SaberStyle,5,4,5.99,1
1835200,Titanic: Fall Of A Legend,29,8,5.09,21
1849890,Neko Maid,72,14,0.99,58
1492430,Rift World,7,1,4.99,6
1853200,TYRONE vs COPS,816,39,0.99,777
1672930,梅斯特姆,6,8,11.99,-2
1870910,Dimension Quest Pinball,11,0,3.99,11
1578330,Doki Doki Ragnarok,15,1,12.99,14
1884890,Pieces of Beauty 3,11,0,1.99,11
1089630,奇迹一刻 Surmount,1213,82,14.99,1131
1878530,升级打怪换装备,6,3,0.99,3
1690440,Another Tomorrow,25,2,11.99,23
1779790,Deadly Infestation,17,2,4.99,15
1035990,Dialtown: Phone Dating Sim,589,6,7.99,583
1702830,BLACKJACK and WAIFUS Hentai Version,83,17,0.69,66
1866780,Natural,2,0,3.49,2
1834620,The Shore VR,16,26,11.99,-10
374190,Infernax,814,66,19.99,748
1866710,Draft Day Sports: College Football 2022,8,4,24.99,4
1028590,The WILDS,30,8,9.99,22
1590160,Liberte,50,14,11.99,36
1399240,Yotsume God -Reunion-,165,2,29.99,163
1844060,Holy Purge,73,27,4.99,46
1651090,Crown of Pain,35,7,4.99,28
313700,Burger Patrol,15,0,2.99,15
1343670,Dealer's Life 2,1877,396,11.99,1481
1766750,Spelldrifter,5,2,19.99,3
1893460,Pick The Lock,3,3,0.99,0
1142710,Total War: WARHAMMER III,25545,18410,59.99,7135
1498570,THE KING OF FIGHTERS XV,3241,773,59.99,2468
1220010,Home Behind 2,5210,740,19.99,4470
1849440,Claire's Cruisin' Cafe: High Seas Cuisine,8,0,6.99,8
1247100,SpellMaster: The Saga,137,199,24.99,-62
1323470,GetsuFumaDen: Undying Moon,544,158,24.99,386
1885140,Guntech 2,8,2,14.99,6
1890340,drowning,10,3,0.99,7
1718870,Spaceflight Simulator,1189,50,11.99,1139
1843730,Last Group Out,37,6,9.99,31
1874660,浮生箓 Floating Life,69,38,2.99,31
809540,Mechs V Kaijus - Tower Defense,328,57,12.99,271
1332150,Zorya: The Celestial Sisters ™,25,8,0.0,17
1748660,Voice of Cards: The Forsaken Maiden,71,36,29.99,35
1890010,OOZEscape,10,0,4.99,10
1882730,Detective Agency 2,0,1,9.99,-1
1857550,Bad Credit,20,1,5.99,19
1855150,Helm or High Water,2,0,14.99,2
1732800,Cascade Tactics,15,3,7.99,12
1854270,風の祝子 ～早苗さんの妖怪退治～,5,0,2.99,5
1499240,Brookhaven Grimoire,89,35,11.99,54
1094960,Soul Scathe,41,10,19.99,31
1906670,Chimeras: Mark of Death Collector's Edition,1,0,9.99,1
1665490,Dead Survival,4,14,29.99,-10
1603720,Thy Creature,69,5,19.99,64
1887200,Mechaguard,17,5,24.99,12
1882420,Learn Programming: Python - Remake,12,7,2.99,5
1172800,Perfect Tides,104,1,14.99,103
1823020,Retro TV Game Collection,4,0,0.99,4
1782750,Hydra Lists,5,0,4.99,5
1889650,Jigsaw Bestiary,21,0,1.99,21
1887990,Deep Night Runner,12,2,24.99,10
1780370,Mr. Rainer's Solve-It Service,130,3,5.99,127
1559580,Gladihaters,5,1,11.99,4
1797680,Wee Tanks!,179,7,8.99,172
1839080,The Pointless Car Chase: Refueled,26,3,0.74,23
1900690,Mystery Solitaire. The Black Raven 2,4,1,4.99,3
787850,Heroine Anthem Zero 2 : Scalescars Oath,398,77,19.99,321
1860600,The World According to Girl,73,29,9.99,44
951570,Deadness,78,23,19.99,55
1766810,SnOut 2,28,0,4.99,28
1539620,MONARK,103,18,59.99,85
1757950,回家 - Homeward,11,0,7.99,11
872670,SCP: Pandemic,1210,333,19.99,877
1347550,Tiny Combat Arena,728,87,19.99,641
1523170,Aladdin : Save The Princess,17,2,0.99,15
1792820,Blade&Sword,297,163,5.99,134
1173820,FINAL FANTASY VI,1485,204,17.99,1281
1697700,Who's Lila?,453,18,11.99,435
1803550,MegaFactory Titan,46,4,19.99,42
1853140,Who Is Zombie,9,7,8.99,2
1869980,Grisaia Phantom Trigger Vol.8,42,4,29.99,38
1240480,-The Sacrificial Girl of the Fantasy 3 Kingdoms-,145,21,9.23,124
1886400,Golden Rails: Road To Klondike,12,0,6.99,12
1895040,Avatar Raiders,5,0,11.99,5
1635450,Longvinter,1560,755,16.99,805
1400940,Revolution Diabolique,2,8,7.99,-6
1891940,Dr. Science quest,10,5,24.99,5
1307710,GRID Legends,545,227,59.99,318
1609220,Cthulhu pub,13,1,9.99,12
515960,Martha Is Dead,1381,345,29.99,1036
1211930,Ghost on the Shore,86,10,19.99,76
1245620,ELDEN RING,460812,51238,59.99,409574
1792600,Dusk Diver 2,50,5,49.99,45
843810,A Perfect Day,993,188,19.99,805
1621310,Atelier Sophie 2: The Alchemist of the Mysterious Dream,1281,69,59.99,1212
1413960,Chevalier Historie,174,21,19.99,153
1901510,Zombies ate my dog,7,6,0.49,1
1836290,They Die Tomorrow,15,5,14.99,10
1797490,Showbiz Tycoon,15,5,10.99,10
1750600,Crate Mates,31,0,4.99,31
1036660,MiniGolf Maker,55,12,6.99,43
1687100,Era of Combat: Boxing,25,11,19.99,14
1784550,Demolition race,12,3,0.99,9
1883990,The Hepatica Spring,4,1,5.99,3
1808620,Dragon Evo,6,3,9.99,3
1767150,First Time in Paris,2,0,11.99,2
1783000,Diner Runners,23,25,1.99,-2
1872860,Conrad Stevenson's Paranormal P.I.,300,30,9.99,270
1847600,Kingdom's Life,109,39,6.99,70
1624960,Solitaire Bonbon,2,0,4.99,2
1571660,Au-Delà,10,1,4.99,9
1641300,Rhythium,9,4,3.99,5
1740850,角斗士学院（Gladiator School）,330,6,5.99,324
1724160,Heart & Soul,14,1,7.99,13
1909330,SEARCH ALL - SPIDERS,33,1,1.99,32
1846340,EEP 17 Rail- / Railway Construction and Train Simulation Game,2,1,79.99,1
1633640,Papertris,9,1,2.99,8
1818320,いせかいあどべんちゃー,15,7,7.99,8
1871880,Num One: Revised Edition,15,0,2.99,15
1209950,Race Condition,32,2,12.99,30
1802920,Tear of Time: Lost memory,6,0,3.99,6
1656780,Hero's Hour,2080,593,17.99,1487
1358710,Battle Cry of Freedom,1121,268,11.59,853
1771440,Bomb Club Deluxe,18,0,7.99,18
1570010,FAR: Changing Tides,1495,107,19.99,1388
1743080,Night Cascades,40,1,9.99,39
1036890,Shadow Warrior 3,1455,913,39.99,542
900040,ELEX II,2650,827,49.99,1823
1908740,Poly Puzzle: Birds,3,2,0.49,1
1476680,A World of Little Legends,49,7,19.99,42
1061880,Conan Chop Chop,280,124,9.89,156
980210,HordeCore,72,27,7.07,45
1635350,Leave No One Behind: Ia Drang,77,58,24.99,19
1742590,TEMPUS,29,9,9.99,20
915230,Zombie Rollerz: Pinball Heroes,164,19,14.99,145
1906150,Pixel Trouble,12,2,10.99,10
1651930,The Chronos Principle,8,0,2.99,8
1893330,Zadel Princess,10,5,10.99,5
1428100,Instruments of Destruction,476,14,19.99,462
1671590,Paladin's Oath,47,3,14.99,44
1906800,Legend of Radiance,8,0,4.99,8
1722520,FIND ALL 2: Middle Ages,98,0,1.99,98
1674840,My Universe - Puppies & Kittens,2,4,24.99,-2
1693480,Queenchantment,15,1,19.99,14
1886850,Horror In Valkeala,17,16,0.99,1
1729420,PaintballX,56,36,0.0,20
1737330,雾尽时分,12,1,9.99,11
889750,BABYLON'S FALL,181,230,59.99,-49
1840510,Legend of Ixtona,8,5,14.99,3
1908460,Dead Profit,9,7,1.36,2
1529160,Gunborg: Dark Matters,28,1,11.99,27
1570070,Beholder 3,655,343,14.99,312
1543380,I Fetch Rocks,44,1,14.39,43
1901010,Blob Boy,3,0,12.99,3
1623210,Soulash,246,73,14.99,173
1836160,PANELKI,186,12,6.99,174
1910400,Monsters and Warriors - Onet Match Connect,0,1,1.99,-1
1466930,Survival Quiz CITY,115,73,19.99,42
1877440,The Battle Never Ends,16,0,0.89,16
1721170,What Lies in the Multiverse,190,4,14.99,186
1714050,SOKOBOT,22,0,9.09,22
1482970,Limb Hunter,11,0,4.99,11
1822710,Automon,90,6,7.99,84
1190150,Paint Warfare,263,54,0.0,209
1806700,Monster Girl Manager,37,2,14.99,35
1922120,Mystery Solitaire. Powerful Alchemist 2,2,0,4.99,2
1914970,"Help Me Remember, Satori-sama!",337,34,6.99,303
1842220,3D  Lover,46,16,9.99,30
1902240,Furry Hentai Quest,11,0,2.99,11
982290,Airborne Kingdom,832,122,24.99,710
1730540,Alchemistry,10,5,5.99,5
1148560,Buccaneers!,142,38,17.99,104
1903600,Zombie VS Police,10,7,0.99,3
1911960,DarkSpar,11,8,4.99,3
1740720,Have a Nice Death,3276,526,14.99,2750
1851910,A Flicker of Light,61,3,4.99,58
1372730,Phaseshift,17,0,12.99,17
1913360,Frog Fall Down,8,2,0.99,6
1787920,万界之门,73,11,15.99,62
1733890,"Warhammer 40,000: Battle Sister",154,70,19.99,84
1894320,Dr. Professor Scientist's Weapons Testing Facility,54,7,4.99,47
1669170,Northend Tower Defense,171,34,4.99,137
1788930,New Lands 2 Collector's Edition,4,0,5.99,4
1196030,The Mystic,3,0,18.99,3
1898670,All the Words She Wrote,19,1,12.99,18
1430760,"Aquarist - build aquariums, grow fish, develop your business!",201,44,9.99,157
1621690,Core Keeper,12552,1342,12.99,11210
1841080,Galactic Racing Online,5,0,12.99,5
987480,花落冬陽 Snowdreams -lost in winter-,203,1,17.99,202
1115050,Will You Snail?,1740,33,14.99,1707
1449070,Divinity Chronicles: Journey to the West,414,97,14.99,317
1846170,Iron Lung,3665,260,5.99,3405
1913940,Underground Dungeon,7,1,2.99,6
1550740,Ignited Steel: Mech Tactics,47,9,14.99,38
346330,BrainBread 2,3255,1269,0.0,1986
1083300,Drill Deal – Oil Tycoon,84,10,11.24,74
1780450,Buggy Game,12,0,3.99,12
1614270,Submerged: Hidden Depths,136,9,29.99,127
1910610,Pixel Artist,14,1,6.49,13
978700,Ironsmith Medieval Simulator,64,118,9.99,-54
1915450,Death Damnation,13,2,11.99,11
1914700,Elteria Hunter,1,0,8.99,1
1914630,Draft Day Sports: College Basketball 2022,7,2,29.99,5
1927380,TEMPLE of RUBBO,4,1,4.99,3
1531540,Distant Worlds 2,1328,671,49.99,657
1255630,WWE 2K22,4253,1657,38.99,2596
1650550,Workshop Simulator,134,66,19.99,68
985900,Young Souls,270,55,24.99,215
1085070,Strawhart,12,0,19.99,12
1247360,Grand Mountain Adventure: Wonderlands,81,5,19.99,76
1825880,作死吧！UP主！,39,8,4.99,31
1863080,Beat Invaders,99,2,9.99,97
903630,The Last Cube,87,3,19.99,84
1690650,Zombie Survivors,41,12,2.99,29
1886830,The Legend of The Sacred Stone EX,219,14,7.99,205
1894230,Afterlife Work,50,31,9.99,19
1658930,Blazing Aries,170,13,18.99,157
1907900,Halftime Heroes,175,50,2.99,125
844390,Deadly Flare,78,30,13.99,48
1875140,黎明为歌 - Melody before the Dawn,41,2,4.99,39
1890520,Tide Up,119,11,7.99,108
1155580,Drone Wars,82,19,0.0,63
1770400,Re:BF,172,33,19.99,139
1913190,Paranormal Motel,8,10,0.99,-2
1245430,Golden Light,1584,123,19.99,1461
1461600,Project Sparrow,965,84,12.99,881
1835360,Panacle: Back To Wild,9,2,3.99,7
1855660,我有一座冒险屋 I have an adventure house,31,21,9.99,10
1899990,GEHENA,6,2,19.99,4
1836220,Frigore,160,88,1.99,72
1893200,Travelers in Space Crack,11,6,2.49,5
1900340,Ten Trials of Babel: The Doppelganger Maze,2121,170,2.99,1951
1840380,Chester,14,3,2.99,11
1922140,1001 Jigsaw. Cute Cats,4,1,4.99,3
1903530,Heart attack,24,8,4.99,16
1822910,Capybara Spa,597,16,7.99,581
1811070,Fritz 18 Steam Edition,3,4,79.99,-1
1849820,Telepath Tactics Liberated,62,4,24.99,58
1930070,Mahjong Business Style,1,1,4.99,0
1256230,Hyperbolica,687,136,16.99,551
1896880,Dungeons of Dreadrock,122,3,4.99,119
1465640,Dead Man's Rest,32,0,11.99,32
1526350,Harlow,19,0,12.99,19
1282760,Mad Streets,111,11,14.99,100
1914200,Cosmoblaster Exodia,9,1,10.99,8
1424930,DMM Connect Chat,13,9,0.0,4
1717570,Pompom,49,3,14.99,46
1725640,Sudocats,132,2,1.99,130
1935790,Haunted Hotel: The Thirteenth Collector's Edition,2,0,9.99,2
1914190,Sharp Trouble,9,2,10.99,7
1424330,Wobbledogs,3845,80,19.99,3765
1092050,Fire On Fight : Online Multiplayer Shooter,12,3,13.99,9
1889330,Hypermind,11,4,19.99,7
1864630,Virago,13,8,9.99,5
1565450,STERN,9,0,9.99,9
671640,Deadburg,56,3,7.99,53
1745510,Lunacid,460,22,6.99,438
1921160,TINY ISLANDS,13,6,10.99,7
1289520,SHMUP Creator,34,2,69.99,32
1477950,Lazy Galaxy 2,105,23,7.99,82
1360720,Aethernaut,10,1,19.99,9
1510730,Auto World Tycoon,3,5,9.99,-2
1642170,Dawn of the Monsters,60,5,29.99,55
1807690,Roxy Raccoon's Pinball Panic,13,0,4.99,13
1602010,Persona 4 Arena Ultimax,1650,399,29.99,1251
678390,Office Management 101,49,8,19.99,41
1916950,GoodNight,12,3,9.99,9
553420,TUNIC,4217,349,29.99,3868
1917970,Laruaville 12,3,0,6.99,3
1368030,ANNO: Mutationem,2235,758,24.99,1477
1592110,Spirit of the Island,390,124,24.99,266
1830980,VRkanoid - Brick Breaking Game,9,2,4.99,7
1874170,Shredders,886,38,29.99,848
789660,Buggos,300,43,14.99,257
1773560,The Tree,13,4,4.99,9
1322100,Battle Bands: Rock & Roll Deckbuilder,102,13,17.99,89
1896160,Warplan Pacific,25,0,39.99,25
1269300,This Means Warp,169,20,19.99,149
1472660,No Place Like Home,2152,446,19.99,1706
1802520,Snow Scout,2,0,14.99,2
1917410,Elemental Angel Ⅱ,13,1,3.99,12
1374930,Black Geyser: Couriers of Darkness,358,137,29.99,221
1920440,Big Tower Tiny Square 2,3,1,4.99,2
1688100,Cat Museum,313,19,4.99,294
1908320,物质与魔法,17,9,8.99,8
1610460,Monster Energy Supercross - The Official Videogame 5,147,94,49.99,53
1676910,Onde,91,4,13.99,87
1787630,Jump Challenge!,10,0,2.99,10
1919070,Iron Age,12,4,24.99,8
1843880,Tumblebugs,9,0,19.99,9
1890120,9-nine-:NewEpisode,187,7,9.99,180
1815970,A Clockwork Ley-Line: Daybreak of Remnants Shadow,9,0,24.99,9
1716690,Click and Slay,7,21,7.99,-14
1843090,[Chilla's Art] The Closing Shift | 閉店事件,857,147,5.99,710
1924310,Pixel Pirate,11,0,24.99,11
1864580,Dinosaurs A Prehistoric Adventure 2,6,4,0.99,2
1084220,Cavity Busters,73,1,13.99,72
1798640,Melodier,15,0,0.99,15
1628130,Who Pressed Mute on Uncle Marcus?,204,61,5.97,143
1721870,Neon Sundown,216,14,3.99,202
1410640,Syberia: The World Before,1273,100,39.99,1173
1836680,Slidetracked,13,0,4.99,13
1046790,Eternal Threads,163,9,19.99,154
941890,Mini Matches,17,0,14.99,17
1922000,Towerland,3,0,2.99,3
1885980,Lost Souls,7,1,6.99,6
1927710,Supreme Race on Highway,3,2,4.99,1
1132910,ITORAH,201,47,9.99,154
1167680,Orbital Bullet – The 360° Rogue-lite,337,41,8.49,296
1834920,Countryball: Europe 1890,50,1,3.99,49
1681580,Draken - Escape from Vampire Lair,11,14,19.99,-3
674690,Project Xandata,75,36,0.0,39
1429820,Neko Nyaa~,4,1,0.79,3
1863460,Pixel Art School - 今から始めるドット絵入門 -,1,2,11.99,-1
1404960,The Last Sunshine: Rekindled,13,1,9.99,12
1693970,PARTY RUSH!!,10,6,9.99,4
1717770,The Upturned,336,1,9.99,335
1921940,Hero Ring,1,3,0.49,-2
1827960,Saint Maribel,5,2,19.99,3
1769170,Shattered Pixel Dungeon,456,23,9.99,433
1393570,Superbugs: Awaken,154,9,14.99,145
1616280,Chronicles of Tal'Dun: The Remainder,54,0,19.99,54
1919460,Seraph's Last Stand,1798,117,0.99,1681
1239320,Animal Shelter,851,130,15.99,721
1882200,Krek Da Frog,4,2,1.59,2
1836030,只兔：不灭的勇者,69,18,7.99,51
1229810,Slender: The Eight Pages REMAKE,22,10,2.99,12
1221250,NORCO,611,29,14.99,582
1093320,Devil's Deck,185,80,14.99,105
1489970,Highrise City,217,81,24.99,136
1745400,League Manager 2022,533,160,24.99,373
1247570,Expedition Zero,81,40,19.99,41
1533680,Dead Grid,181,14,8.99,167
1475810,Ghostwire: Tokyo,6039,1397,59.99,4642
681640,World of Contraptions,67,5,9.99,62
749960,Townsmen VR,251,69,31.99,182
1035660,Chromosome Evil,154,23,14.99,131
1523990,Vampire: The Masquerade — Sins of the Sires,37,54,9.99,-17
1653100,Heliotropism,53,4,4.99,49
1389990,Oblivity - Find your perfect Sensitivity,547,134,9.99,413
1284190,The Planet Crafter,10841,417,19.99,10424
1900400,Mixed Feelings: While You Were Away (Yaoi BL Visual Novel),10,0,4.99,10
1220100,Tentacular,39,1,19.99,38
1911560,Class Escape,34,1,6.99,33
1785120,Forsake,39,18,3.99,21
1904330,The Tribe Game,18,6,19.99,12
1247290,GameGuru MAX,95,23,49.99,72
1829980,Café Stella and the Reaper's Butterflies,1417,26,34.99,1391
351160,Poop Clicker,50,18,0.49,32
1229390,TOMOMI,51,0,7.99,51
1848220,Amelite,13,0,7.99,13
1452280,Devastator,13,2,6.99,11
1233530,Knights of the Chalice 2,61,14,44.99,47
1916850,Doomed to Hell,64,9,11.99,55
1856900,Andro Dunos II,55,2,17.99,53
1920320,Parasite,16,2,5.99,14
1882580,FALL GIRLS,63,27,6.99,36
1755300,Smart Factory Tycoon,92,29,3.74,63
1917350,Mysterious Island - A Hidden Object Adventure,13,9,1.99,4
1859360,Dungeon Village,222,30,8.99,192
1674780,Lone Fungus,74,3,19.99,71
1847240,Game Dev Story,314,36,8.99,278
1859370,Dream House Days DX,131,22,6.92,109
1823710,Hot Springs Story,90,8,8.99,82
1842690,Station Manager,118,17,8.99,101
1916630,THE_ABYSS_HAS_WALLS,15,14,0.99,1
1664670,Refactor,317,36,4.99,281
1051690,Nightmare Reaper,2205,133,24.99,2072
1855610,Happy Island Life,13,2,2.99,11
1378470,Now There Be Goblins,30,0,17.99,30
1907150,Barbarous 2 - Tavern Wars,10,1,12.99,9
1768730,Alien Extraction,14,1,10.39,13
683770,Rover Builder,49,15,9.99,34
1078370,Succubus x Saint,47,17,14.99,30
1201830,For The Warp,218,75,14.99,143
1164690,Wigmund,58,22,14.99,36
1482820,Void Marauders,31,6,11.99,25
1337840,Klondike Solitaire Collection,1,0,7.99,1
1904530,Forgotten Realms: The Archives - Collection Three,17,2,4.49,15
1904580,Dungeons & Dragons: Dark Sun Series,17,4,7.49,13
1315210,Ikai,124,25,14.99,99
1796550,Lawnarchy,21,1,5.99,20
1922870,Shady Business,9,1,10.99,8
1246490,Domino Simulator,51,8,9.99,43
1713260,Relash,12,0,4.99,12
1720850,A=B,317,11,4.99,306
1882240,Forgotten Realms: The Archives - Collection One,53,6,7.49,47
1882280,Forgotten Realms: The Archives - Collection Two,67,6,9.99,61
1904650,Dungeons & Dragons - Stronghold: Kingdom Simulator,8,1,4.01,7
1904610,Dungeons & Dragons: Krynn Series,29,3,7.49,26
1838970,Crush the Castle Legacy Collection,38,4,9.99,34
1674820,TFC: The Fertile Crescent,64,5,14.99,59
1522080,Jitsu Squad,137,13,19.99,124
1847110,Satan's puzzle 666,14,5,1.99,9
1904560,Dungeons & Dragons: Ravenloft Series,15,1,7.49,14
1260520,Patrick's Parabox,1336,9,19.99,1327
1766390,FORWARD: Escape the Fold,393,55,9.99,338
1815530,Dungeon Defenders: Going Rogue,94,82,14.99,12
1849570,恋~一些小清新的猎奇故事~,106,23,1.99,83
1719690,MerFight,16,0,11.99,16
1724120,ASTRONAUTILUS,29,1,9.99,28
1642580,明星志願2000,96,22,7.99,74
1353920,High School Odyssey,170,22,8.99,148
1611410,Stardom 3,786,58,12.99,728
1901560,Rescue Team: Heist of the Century,6,3,6.99,3
1640160,G-Darius HD,53,2,29.99,51
1850570,DEATH STRANDING DIRECTOR'S CUT,4075,370,39.99,3705
1930920,Warplanes: Battles over Pacific,52,11,13.49,41
1638390,Indies' Lies,273,55,14.99,218
1642560,Stardom MiniGames,4,1,4.99,3
1417890,Catie in MeowmeowLand,50,2,14.99,48
1512720,Stardom,45,2,4.99,43
1542280,明星志願2,176,40,7.99,136
1875560,Mare,15,2,11.99,13
1453640,Valthirian Arc: Hero School Story 2,19,7,11.99,12
1929360,Tumbleweed Destiny,238,13,2.99,225
1637730,Crystal Project,919,80,13.99,839
539320,Picontier / ピコンティア,76,31,24.99,45
1320490,Princess Farmer,80,2,14.99,78
1670120,Turn the Line!,70,3,13.99,67
1711120,Taxi Simulator,14,12,10.99,2
915810,Midnight Ghost Hunt,3169,765,19.99,2404
1916340,Digital Diamond Baseball V10,12,0,24.99,12
1659410,Dungeon Lad,22,0,4.99,22
1889640,The Backrooms: Survival,446,65,6.99,381
1588530,Dungeon Alchemist,842,34,44.99,808
1927140,start;again,27,1,5.99,26
1891640,AZUR BEAM,73,13,1.99,60
1097350,Weird West,1360,451,39.99,909
1924020,QUIJOTE: Quest for Glory,9,1,1.49,8
1910680,Orb of Creation,522,26,4.99,496
1696220,FixFox,121,6,10.04,115
1909810,Seventh Lair,134,4,7.99,130
1218210,Coromon,1870,318,19.99,1552
1491490,Cosmonious High,111,5,29.99,106
1918920,Chinese Train Trip,2,6,3.99,-4
1928460,Permanence TD,2,1,1.99,1
1138100,Touhou Ibunseki - Ayaria Dawn: ReCreation,1152,227,18.99,925
1684410,Seal World,204,0,1.99,204
1486790,Portal Mortal,9,0,9.99,9
1829910,Cute Cats 2,29,1,0.99,28
1358490,Ash & Rust,13,2,24.99,11
1750740,战棋三国英雄,55,7,16.99,48
1303010,Vincemus - Air Combat,21,4,14.99,17
1333750,Right Way,8,4,1.99,4
1918130,Grim Quest - Old School RPG,47,3,7.99,44
1661360,The Book of the Game (Adventures in Leman),17,5,24.99,12
1655890,Sokobos,42,0,4.99,42
1882040,Craft Hero,228,26,4.99,202
1911390,Knightfall: A Daring Journey,4057,381,5.99,3676
1617030,tERRORbane,159,14,15.99,145
1919920,眼球大師 Eyeball Master,9,0,1.99,9
1916970,Tree Simulator 2023,199,3,3.99,196
665560,Skyward,3,3,13.99,0
1917320,A Slit of Joy,6,3,2.29,3
1930170,1001 Jigsaw: Earth Chronicles 7,1,0,4.99,1
1931090,Hexagonal Tower,22,23,7.99,-1
1795430,Sakura Succubus 5,49,4,9.99,45
1860870,ShapeGrid,14,0,1.99,14
1717020,Ed-0: Zombie Uprising,55,26,19.99,29
1814570,Transcendence Legacy - Voidswept,28,7,4.99,21
1650150,Island of the Ancients,7,3,12.99,4
594220,The Living Remain,102,32,19.99,70
1917560,Milk Bottle And Monster Girl 2,172,18,1.99,154
1776600,Clutter 12: It's About Time - Collector's Edition,6,0,9.74,6
920210,LEGO® Star Wars™: The Skywalker Saga,26627,2212,49.99,24415
1861870,Shadow Fate,22,1,14.99,21
1231970,Police Response VR : Disturbance,70,6,4.99,64
1921850,Lenin Simulator,14,5,4.99,9
1785000,Mokoko X,83,6,7.49,77
1419040,Road Maintenance Simulator,42,43,24.99,-1
1772950,Outbreak: Contagious Memories,12,2,29.99,10
1133760,CHRONO CROSS: THE RADICAL DREAMERS EDITION,706,585,19.99,121
1590910,Forgive Me Father,1107,155,19.99,952
928960,Godfall Ultimate Edition,725,466,39.99,259
1776170,Barton Lynch Pro Surfing 2022,14,1,39.99,13
1684670,Best Forklift Operator,88,10,14.99,78
1800570,Pet Vet 3D Animal Hospital,4,3,11.99,1
1137320,Screeps: Arena,51,8,19.99,43
1515260,Circle Empires Tactics,19,12,14.99,7
1827740,Kombinera,8,0,14.99,8
1625340,United Assault - Battle of the Bulge,15,7,9.99,8
1938200,Desktop Dog,23,4,2.99,19
1172190,Chinatown Detective Agency,67,26,24.99,41
1823600,Power & Revolution 2022 Edition,164,107,49.99,57
1837750,Demeo: PC Edition,191,44,29.99,147
1895860,Monster Girls and the Mysterious Adventure 2,144,12,17.99,132
1588410,Hot Spring Hero,92,9,18.99,83
1739070,Bone's Cafe,89,2,9.99,87
640340,Serious Sam: Tormental,137,28,11.99,109
1927250,Happy Mining,13,5,5.99,8
1756840,边缘项目 / Living Island Project,9,0,9.99,9
1720240,Animation Studio Manager,8,2,3.99,6
1789650,NEKO-MIMI SWEET HOUSEMATES Vol. 1,163,5,15.99,158
1760340,ReFactory,46,13,11.99,33
1898830,VBridger,18,7,9.99,11
1915460,Retro three kingdoms : Special edition,7,8,4.99,-1
1944240,Touch Some Grass,259,4,1.99,255
1920010,Mad Murder's Mystery Pie Shop,9,1,0.99,8
1832050,All Quiet Roads,34,0,9.99,34
1797510,Tower of the Sage,10,1,4.99,9
1901370,Ib,1166,9,12.99,1157
1550760,Blast Brigade vs. the Evil Legion of Dr. Cread,133,7,19.99,126
552080,IronWolf VR,919,37,19.99,882
1787320,The Atlas Mystery: A VR Puzzle Game,36,5,11.99,31
1280930,Astral Ascent,521,36,24.99,485
1508530,Epiphany City,145,8,9.99,137
1640320,B.I.O.T.A.,84,10,9.99,74
724000,Uragun,72,7,14.99,65
1248840,Sephonie,140,10,29.99,130
1631210,Be My Girlfriends,276,81,1.99,195
1728660,Rush Rally Origins,79,4,14.99,75
1949340,飞机大战坦克,6,8,0.99,-2
1769320,Athanasy,171,3,7.49,168
1941400,Tonikk Tycoon,7,2,9.99,5
1433570,Car Detailing Simulator,309,86,15.99,223
1432680,Mechanic 8230: Escape from Ilgrot,33,3,9.09,30
1713810,Lumencraft,398,100,11.99,298
1494910,pemsa,70,8,0.0,62
1910320,TAPE: Unveil the Memories,59,1,19.99,58
1950140,SAVE THE SCHOOL FLOWER ACTION,3,3,0.99,0
1116880,The Heroic Legend of Eagarlnia,1174,191,12.99,983
1790490,Regular Factory: Escape Room,77,1,9.99,76
1679700,Suhoshin,73,5,18.99,68
1911050,Reversilly,5,0,2.99,5
1504570,Cultivation Tales,4959,8060,19.99,-3101
1730140,LIGHT：Black Cat & Amnesia Girl,39,3,9.99,36
1917920,Polda 7,378,21,34.99,357
1689910,Dōkyūsei: Bangin' Summer,850,47,19.99,803
1354830,Cat Cafe Manager,641,143,19.99,498
906870,FurryFury: Smash & Roll,815,187,0.0,628
1485140,Ultrawings 2,50,8,24.99,42
1548940,RUN: The world in-between,89,3,9.99,86
1671480,ABRISS - build to destroy,249,27,16.99,222
1477590,EZ2ON REBOOT : R,3724,563,44.99,3161
1783280,Ghostlore,128,12,19.99,116
1491710,CRIMESIGHT,443,95,19.99,348
1747890,Demon Turf: Neon Splash,67,2,4.99,65
1943880,Forty Thieves Solitaire Collection,2,1,7.99,1
1849760,Siege of Treboulain,17,0,5.99,17
1413990,The Heart of Darkness,164,26,19.99,138
1892030,Dummynation,80,41,9.59,39
1215390,Animal Revolt Battle Simulator,3154,110,14.99,3044
1930030,Trash Pit,10,0,4.99,10
1491150,100 Worlds - Escape Room Game,3,5,9.99,-2
1403990,Paths & Danger,16,12,14.99,4
1340360,Polycalypse: Last bit of Hope,12,12,0.0,0
1708200,On Your Hands,15,0,5.99,15
1953020,Lab Remnants,14,2,1.99,12
1941760,Irritability & Mood Swings,8,3,1.99,5
1945220,Rhythm Journey,52,14,4.79,38
1930100,Solitaire Match 2 Cards. Thanksgiving Day,1,0,4.99,1
1895560,1001 Black Raven Jigsaw,3,1,4.99,2
1947660,LiMiT's Escape Room Games,34,5,3.99,29
1888660,Mini Pipes - A Logic Puzzle Pipes Game,33,0,0.99,33
1417880,Winter Ember,43,27,29.99,16
1714420,Fursan al-Aqsa: The Knights of the Al-Aqsa Mosque,83,6,14.99,77
675110,KILL YOUR FRIENDS,6,2,9.99,4
1706920,Firekeep,19,2,13.99,17
1957330,VTuber Plus,82,1,4.99,81
1578880,Grammarian Ltd,14,1,9.99,13
1219540,Last Slice,35,2,0.0,33
1608470,Warstride Challenges,125,8,14.99,117
1759640,Underground Life,15,5,7.99,10
699330,The Iron Oath,278,53,19.99,225
1220840,Retirement Simulator,1480,2588,13.99,-1108
707030,POSTAL 4: No Regerts,5998,1856,39.99,4142
1677400,Black Lotus Motel,10,1,2.99,9
1918300,Fishing Vacation,81,2,1.99,79
1450300,Battleships: Command of the Sea,11,3,4.99,8
1174680,Ashland Dossier,8,2,10.99,6
1952760,RGB Rush,58,2,5.99,56
1257880,Glover,94,62,15.99,32
1135230,Ember Knights,862,69,14.99,793
1182110,Weed Shop 3,2158,136,19.99,2022
1748390,Rocket Bot Royale,374,63,2.99,311
1021100,Aircraft Carrier Survival,420,242,19.99,178
886200,EndCycle VS,68,2,29.99,66
1381650,ACTION SANDBOX,413,64,7.99,349
1915210,The Mensional,36,1,4.99,35
1811750,VELONE,9,15,8.49,-6
1124080,Active DBG: Brave's Rage,151,10,9.99,141
1710580,MotoGP™22,392,126,49.99,266
1582680,"Trolley Problem, Inc.",354,169,10.99,185
1167630,Teardown,43963,1906,19.99,42057
1244800,Terraformers,581,86,19.99,495
1851280,Samurai Bringer,654,90,9.99,564
1432910,Godlike Burger,264,86,11.99,178
831110,Unconventional Warfare,32,6,9.99,26
1938330,Into The Dark,9,0,24.99,9
1291010,Warpips,2350,303,6.79,2047
1844170,Galactic Wars EX,20,1,7.99,19
1930960,Jewel Match Origins 2 - Bavarian Palace Collector's Edition,11,1,9.99,10
1701670,Hats Are Not Allowed,22,0,6.99,22
1573390,Lila’s Sky Ark,35,5,14.99,30
24010,Train Simulator Classic,16408,7387,24.99,9021
1859290,Crypto Miner Tycoon Simulator,57,8,19.99,49
1297210,Tandis,86,1,14.99,85
1953220,Gem Tower Defense 2,2,2,2.99,0
1223870,Sakura Hime 2,376,39,3.99,337
1889320,Timeline,19,1,11.99,18
867960,Remorse: The List,97,18,14.99,79
949290,Winkeltje: The Little Shop,1047,97,14.99,950
1497640,Traitors in Salem,434,135,3.99,299
1856910,Ganryu 2,48,16,17.99,32
1920400,Bunny Girl Story,59,7,0.99,52
1423080,异世界无厘头生活2,127,20,1.99,107
1971880,Whispered Secrets: Tying the Knot Collector's Edition,1,0,13.99,1
1550840,RATUZ,130,15,5.99,115
1962540,Still Heroes,15,4,4.99,11
1280210,Void Arena,10,0,24.99,10
1328350,Turbo Overkill,820,46,17.99,774
1935100,Nightfall Comes,15,0,10.99,15
1739010,Out of the Park Baseball 23,363,77,39.99,286
1944250,Hana no No ni Saku Utakata no,296,6,21.59,290
1500940,Far Lands,24,10,15.99,14
1953170,Rose Action,9,14,4.99,-5
1782010,Serendipity Hotel,4,6,3.99,-2
1960790,Battle of Heroes 3,1,2,6.99,-1
1218640,Draco Knight,11,1,14.99,10
1420810,Touhou Kaeizuka ～ Phantasmagoria of Flower View.,98,0,14.99,98
1652520,Dungeon Tactics,3,0,19.99,3
1279310,RESEARCH and DESTROY,15,1,19.99,14
1732340,DEMON GAZE EXTRA,25,7,49.99,18
1958600,Barro F22,28,4,0.49,24
1296610,Peglin,3162,881,19.99,2281
474020,Ragnorium,385,165,24.99,220
1453790,The Serpent Rogue,69,27,19.99,42
1689090,CITY WARS: TOKYO REIGN,16,5,12.99,11
1605220,Dune: Spice Wars,4166,987,29.99,3179
1157390,King Arthur: Knight's Tale,2703,582,44.99,2121
666150,Prehistoric Kingdom,973,230,29.99,743
1079200,Piko Piko,81,27,14.99,54
721700,Holomento,75,25,19.99,50
1681970,神都不良探 Underdog Detective,1296,640,6.39,656
1393580,The Amulet of AmunRun,9,11,11.99,-2
1584690,TrinityS,76,12,14.99,64
1831630,建筑吧公司,210,33,3.64,177
1728700,Terranova,8,0,20.04,8
1683100,Ultra Age,141,17,24.99,124
1703340,The Stanley Parable: Ultra Deluxe,13374,912,24.99,12462
1695150,末路希冀,12,3,3.99,9
1805240,Layer Section™ & Galactic Attack™ S-Tribute,19,8,29.99,11
1926170,Forgotten Hill Tales,26,4,2.99,22
1761380,Otherworld Legends 战魂铭人,216,282,7.99,-66
1201230,Immortal Life,1296,369,16.99,927
990920,Sea of Craft,318,77,14.99,241
1231880,"Haiku, the Robot",861,56,19.99,805
1955330,Save Room - Organization Puzzle,560,13,2.99,547
1944560,Vacation Adventures: Park Ranger 13,1,0,6.99,1
1694600,THE HOUSE OF THE DEAD: Remake,620,246,24.99,374
1929870,Nomad Survival,833,66,2.99,767
1253920,Rogue Legacy 2,8447,998,24.99,7449
1455840,Dorfromantik,15920,490,13.99,15430
1963900,Knotwords,38,4,11.99,34
1301430,Dragon Extinction VR,15,9,19.99,6
1042920,Unsouled,153,21,19.99,132
1742610,Spirits of the Hellements - TD,199,9,11.99,190
1690040,Metavusking,5,4,0.99,1
1399700,Kapital: Sparks of Revolution,97,55,24.99,42
1491200,Few Nights More,40,3,19.99,37
1296540,Flatworld,648,19,14.99,629
1626530,Facteroids,24,1,14.99,23
1226510,Trigon: Space Story,581,300,19.99,281
1805360,Bounty game,1517,300,16.99,1217
1756180,CARNAGE OFFERING,88,10,11.24,78
1938850,Temp Zero,92,3,4.99,89
1508400,Kaiju Wars,112,11,19.99,101
1918450,HunterX,182,37,14.99,145
1644080,Rock 'n' Roll Will Never Die!,11,0,17.99,11
1892640,Marble Ball Friends,6,4,3.99,2
1920540,Dreamin' Her - 僕は、彼女の夢を見る。-,57,1,24.99,56
674140,Bugsnax,1497,27,24.99,1470
1755740,侵入：源代码,29,5,4.99,24
1373930,Dino Nest,173,11,14.99,162
1908250,雪之本境S Conspiracy Field: Snow Trap,323,13,5.94,310
843020,Hipster Cafe,20,2,24.99,18
1615290,Ravenous Devils,3771,290,4.99,3481
1297430,Deadly Dozen Reloaded,15,11,29.99,4
1789670,Me and my eldritch parasite,5,0,2.99,5
1833380,Izmir: An Independence Simulator,17,1,1.99,16
1912930,Cursed Blood,13,8,0.99,5
1966260,Idle Business Tycoon - Build Simulator,2,5,1.99,-3
1512480,Gunlocked,126,7,3.99,119
1942540,No Cat Fights Here,25,1,1.99,24
1087760,The Gunk,211,33,19.99,178
1965130,Key Puss,17,7,0.99,10
1465440,Obscurant,17,1,14.99,16
1651030,Dandy & Randy DX,7,1,4.54,6
1819860,Thalamus,14,3,6.99,11
1805590,Sacred Valley,10,4,1.99,6
1557990,Retail Royale,1146,406,0.0,740
1918880,Tales of Autumn,13,0,7.99,13
1944000,THE DREADFUL SPACE,21,0,0.99,21
1820710,VR Dodgeball Trainer,1,0,7.99,1
1956300,Beer Break,2,3,4.99,-1
1735930,SICK,13,13,9.99,0
1885670,SAOMI,42,0,2.99,42
1646810,NARGUL - Humans are among us,5,1,18.99,4
1901030,Dungeon Reels Tactics,23,1,14.99,22
1808780,祖玛少女/Zuma Girls,373,69,2.99,304
1965840,Mini Mecum,18,1,4.99,17
1937980,DUST - A Post Apocalyptic RPG,1,1,4.99,0
1732480,Takkoman -Kouzatsu World-,16,1,9.99,15
1947530,Fidget Spinner RPG,96,8,1.99,88
1945980,The Rusty Sword: Vanguard Island,11,6,0.99,5
1371500,Cargo Company,31,20,9.99,11
1908500,RUNES Magica,12,3,15.99,9
1921140,Into The Underdusk,16,5,8.49,11
1954750,Acquitted,703,15,7.95,688
1950620,Mystery Solitaire. The Black Raven 3,1,0,4.99,1
1959880,Rogue Door Defense,8,1,8.99,7
1971820,Miner of Minerals,12,11,9.99,1
1494260,Loot River,188,73,17.49,115
1836940,Aria and the Secret of the Labyrinth,14,1,19.99,13
1031120,Bakery Simulator,358,96,15.99,262
776150,M1 Tank Platoon,3,1,9.99,2
1949840,Disharmonia,2,2,9.99,0
1967360,2Week : Death World,7,2,6.29,5
1848450,Nightmare of Decay,1547,32,3.99,1515
1422570,EchoBlade,16,1,19.99,15
1348690,Oaken,96,14,17.99,82
1768300,Grid Miner,25,7,2.99,18
1185490,Dark Quest: Board Game,60,15,16.19,45
1968650,DesktopMMD4:Born to Dance,109,22,3.99,87
1326270,Festival Tycoon 🎪,109,24,12.99,85
1944210,Infindustry,21,8,17.99,13
1288610,Wildcat Gun Machine,55,21,8.99,34
1663380,Cat Powered UFO,12,0,4.99,12
1826410,Runnyk,9,0,4.99,9
864700,Dinosaur Fossil Hunter,317,112,19.99,205
1551220,King and Kingdoms,20,18,0.0,2
1939810,Sanctum Breach: Rebirth,16,5,19.99,11
1578650,Citizen Sleeper,1361,56,19.99,1305
1553120,The Inheritance of Crimson Manor,137,17,19.99,120
1309610,Line War,372,78,19.99,294
1807330,Tough Love Arena,9,0,11.99,9
1879380,Paper Bride 2 Zangling Village,430,41,9.99,389
1545830,Yaengard,80,15,24.99,65
1707870,RiffTrax: The Game,93,5,8.99,88
1838820,Life of a Space Force Captain,26,4,5.99,22
1403020,SCP Strategy,310,33,6.99,277
1873920,Fracked,29,12,29.99,17
1967550,Heroes of Rome 2 - The Revenge of Discordia,1,0,9.99,1
1945750,Tearstone: Thieves of the Heart,12,2,14.99,10
1389020,The Cleaner,52,22,9.99,30
1954880,剑冢 Swords Tomb,21,2,4.99,19
1914740,A HERO AND A GARDEN,30,2,4.99,28
1370050,Trek to Yomi,752,338,19.99,414
1611910,"Warhammer 40,000: Chaos Gate - Daemonhunters",4545,1284,40.49,3261
1957990,Tile Cities,213,7,2.99,206
1946620,Dino-D,10,1,24.99,9
1239690,Retrowave,7631,398,2.99,7233
1961300,Is Simon There?,112,9,4.99,103
1873570,Everblade,15,4,14.99,11
1125910,Crowns and Pawns: Kingdom of Deceit,185,21,15.99,164
1772720,Village of Zombies,29,5,4.99,24
1970440,Forlorn,8,5,8.99,3
1949270,Light Of The Past,12,2,24.99,10
1786790,Magical Girl Celesphonia,865,35,19.99,830
1063020,Elemental War 2,10,4,19.99,6
1712110,Deep Space Outpost,4,0,7.99,4
896440,Eternal Edge +,221,74,7.49,147
1913490,Adorable Witch 3,303,35,2.99,268
508550,Sneak Thief,1048,331,14.99,717
1944440,The Farmer's Story of Slow Life,5,0,24.99,5
1942440,最后的仙门 The last Practice Sect,275,186,3.99,89
1935800,Absolute Tennis Manager,7,2,19.0,5
1904040,Fantasy Fishing Town,40,4,5.59,36
1928120,Swords & Bones 2,7,0,4.99,7
1978010,Red Valley,24,6,1.99,18
1973130,Island of Aito,12,1,5.99,11
1978790,Naxos,14,0,4.99,14
1736980,BounceShot,19,1,4.99,18
1654520,Ergo,9,0,6.99,9
1972740,Lit Up,29,0,1.99,29
1843940,Brigandine The Legend of Runersia,458,59,39.99,399
1732060,Makai Kingdom: Reclaimed and Rebound,57,7,19.99,50
1341290,We Were Here Forever,4639,542,17.99,4097
867210,Songs of Conquest,2967,421,29.99,2546
1732070,ZHP: Unlosing Ranger vs. Darkdeath Evilman,23,4,19.99,19
1945560,World of Mines Creator's Edition,10,1,4.99,9
917940,LEMURIA,20,4,8.99,16
554710,Spell Cast,20,4,2.99,16
498310,RPG in a Box,111,9,29.99,102
1658290,Eiyuden Chronicle: Rising,693,88,14.99,605
1889440,The Unfamiliar Story of Grandfather's Heritage,3,2,1.99,1
1875810,Slashers,48,24,4.99,24
1959780,七月-July,11,4,4.99,7
1608700,Soundfall,544,130,29.99,414
1952910,Social Moth,23,0,0.99,23
1958460,New Yankee: Battle for the Bride,6,0,6.99,6
1603410,Lost Nova,162,4,14.99,158
1765310,Halloween is Crazy as Hell,12,0,9.99,12
1315610,Source of Madness,421,85,14.99,336
1916450,Summer With You,16,5,3.99,11
1576370,REPLIKATOR,58,5,11.99,53
338820,Retro Commander,48,13,0.0,35
1836860,Neptunia x SENRAN KAGURA: Ninja Wars,449,99,49.99,350
1195070,Ninja JaJaMaru: The Great Yokai Battle + Hell,24,3,12.9,21
1579300,Birb Café,10,0,9.99,10
1468720,Ultimate Epic Battle Simulator 2,1692,206,19.99,1486
1875280,Miner Ultra Adventures 2,155,45,9.99,110
1972440,Shotgun King: The Final Checkmate,1392,109,5.99,1283
1314000,Achilles: Legends Untold,223,95,15.99,128
1933050,Omega Pilot,42,5,14.99,37
690370,Cantata,51,7,24.99,44
1553080,Nikola Tesla: War of the Currents,12,1,6.99,11
1588340,Riftbound,35,2,19.99,33
1515320,Harvest Days: My Dream Farm,48,26,11.24,22
1875950,Gilded Shadows,80,2,29.99,78
1966870,Cyber Car,42,26,19.99,16
1612780,The Centennial Case : A Shijima Story,372,110,49.99,262
1315980,Tin Can,575,67,19.99,508
1382190,Killer in the cabin,50,20,4.99,30
1237780,AREA MAN LIVES,6,5,19.99,1
1419070,Mython Island,25,7,14.99,18
1850550,I'm on Observation Duty 5,223,9,9.99,214
1975180,The Night of the Scissors,105,4,2.99,101
1737760,Platonic,23,0,19.99,23
1627850,Deadly Broadcast,70,56,3.99,14
1946590,Strategy,10,6,2.99,4
1964690,Dwarfenstein,16,1,5.99,15
1528020,Afterlife VR,71,9,12.59,62
1342060,The Dead End,78,36,14.99,42
1970520,Brave Survivor,9,1,24.99,8
1899400,Rolling in the Maze,193,71,1.59,122
1972830,Molecule Make Lab,16,2,0.99,14
1080700,Swordbreaker: Origins,25,1,9.99,24
1765990,PuckOFF,8,2,24.99,6
1082450,Gold Hunter,156,138,34.99,18
334540,Vox Machinae,959,107,29.99,852
1693780,Orbital Combat,7,9,4.99,-2
1640810,Maybe Immortal,28,9,1.99,19
1980980,The Backroom Project,64,18,9.99,46
1594940,Little Witch in the Woods,3761,345,15.99,3416
1948290,Before The Last Hour,30,7,24.99,23
1297790,Sunday Rivals,158,13,19.99,145
1743820,Orph - The Lost Boy,16,6,3.89,10
1922560,Plants vs. Zombies™ Garden Warfare 2: Deluxe Edition,4447,547,29.99,3900
1976800,不可能犯罪事件簿-Impossible Crime Book,4,4,9.99,0
1107860,Dofense,4,0,12.99,4
1408680,Nine to Five,1412,1706,0.0,-294
1454160,One More Island,118,33,19.99,85
1977230,Ralph's party RPG,2,1,4.99,1
1937620,Tennis Manager 2022,60,17,39.99,43
794260,Outward Definitive Edition,15038,5272,39.99,9766
1779460,My Name is Mayo 3,64,1,1.99,63
1870320,World Seed,219,66,0.0,153
1874880,Arma Reforger,3670,2670,29.99,1000
1604030,V Rising,38828,5034,19.99,33794
1844680,Satama Puzzle,8,0,6.99,8
1967950,Moi Mei: Hidden Objects,14,0,9.99,14
1982810,Amanda's Magic Book 4: True Love,2,0,5.99,2
1837330,Gibbon: Beyond the Trees,163,10,12.99,153
1964750,DOLPHIN HUSTLE,11,2,24.99,9
1834120,Icemaze Cave: Skate Escape,18,1,5.99,17
597180,Old World,906,259,39.99,647
1921570,GrumpyTunez,2,0,7.99,2
1504320,GOC Royale,4,0,11.99,4
1561890,Recursive Ruin,86,12,14.99,74
1983000,HAYAI,111,0,1.99,111
1723260,真探,711,31,9.99,680
1923790,Linelith,250,2,2.99,248
1895410,Desktop Mars,23,2,1.99,21
1969740,Aqorel,6,10,2.99,-4
1884390,Frequency Dissonance,19,2,3.99,17
1644490,Occult,670,210,4.99,460
1492620,Jelly Is Sticky,51,0,14.99,51
1990740,Barro GT,23,2,0.99,21
1151050,Golf Gang,366,40,6.99,326
1928710,Cooking Festival,10,2,9.99,8
1989200,Space Crafting,11,9,9.99,2
1702260,DEADCRAFT,56,23,24.99,33
1621760,Decision: Red Daze,179,93,19.99,86
1671280,Prognostic,250,12,5.52,238
1816890,TENDY: Robot Gardener,19,2,3.99,17
1984110,Goetia 2,6,7,9.99,-1
1957080,Our Fate Forsaken - Yaoi BL Visual Novel,1,0,4.99,1
1390190,APICO,422,31,19.99,391
1108120,The Unseen Fears: Stories Untold Collector's Edition,1,0,13.99,1
1885690,Virtual Circuit Board,72,3,14.99,69
1899810,Dread X Collection 5,126,23,9.99,103
1921390,Build Lands,17,1,3.99,16
1786690,Pinballer (3D Pinball),4,0,4.99,4
1962570,STOLEN CITY,13,8,14.99,5
1892620,CEO,42,8,17.99,34
1986070,Cook OL,4,3,4.99,1
1945590,Linguist FPS - The Language Learning FPS,63,26,19.99,37
1554050,Ad Wars,13,0,2.99,13
831050,Dolmen,121,81,39.99,40
1671180,Ricochet Ranger,12,0,2.99,12
1736270,They Are Coming!,12,11,9.99,1
1939940,Roll Player - The Board Game,25,5,14.99,20
1068350,Battle Life Online,4,4,14.99,0
1483370,The Use of Life,184,10,17.99,174
1975360,DRAINUS,379,14,14.99,365
1168870,Mists of Noyah,442,162,19.99,280
1921780,The Sushi Spinnery,139,2,7.91,137
1923670,Venture Towns,71,4,7.91,67
1918520,Ninja Village,120,0,8.99,120
1442040,我反对这门亲事-I'm against this marriage,40,2,5.99,38
1638520,Hyperglide,22,8,2.99,14
1191260,Touken Ranbu Warriors,80,8,59.99,72
1636250,Toaster Defense,12,0,9.99,12
1592670,Soda Crisis,1726,136,10.99,1590
1770230,SudoKube,26,1,1.99,25
747200,Keplerth,2529,397,14.99,2132
1745380,UNDER the WATER - an ocean survival game,17,19,9.99,-2
1887360,FACTOR D,5,0,2.99,5
1983600,TYPER GIRL,27,8,0.99,19
1700630,天下镖局,79,43,17.99,36
1345900,Space Defense Grid,3,3,5.99,0
704920,Magic Rampage,312,31,0.0,281
1893530,Call of Senpai: Waifu Warfare 2,5,14,2.99,-9
1072190,Crossfire: Legion,226,122,29.99,104
1740680,Voodoo Detective,79,0,14.99,79
1923820,Meowtopia: Expedition,15,0,6.99,15
1970980,Warlord: Britannia,525,66,19.99,459
1188130,Among Walls,8,12,0.0,-4
1373260,Obsidian Prince,92,17,14.99,75
1161580,Hardspace: Shipbreaker,11983,1507,26.24,10476
1990900,方境战记BlockFight,99,20,4.99,79
1057800,Floppy Knights,127,16,15.99,111
634410,A Story Beside,158,3,14.99,155
1273440,OverDrift Festival,224,52,21.89,172
1448840,Very Very Valet,10,0,14.99,10
1838340,Uninvited,30,2,6.99,28
1047170,Forgotten Fables: Wolves on the Westwind,33,1,19.99,32
1477980,Freud's Bones-the game,35,3,13.99,32
1970700,CowboysShowdown,10,0,24.99,10
1955390,Playable Mockup,32,0,4.99,32
1755350,BBQ Simulator: The Squad,331,66,2.99,265
1432390,Sonority,59,2,15.99,57
1914580,Spirit Hunters: Infinite Horde,580,229,4.99,351
1732390,Nayuta no Kiseki: KAI,33,3,27.99,30
1813270,Poptropica,28,16,19.99,12
1985930,The Backrooms 1998 - Found Footage Survival Horror Game,303,50,9.99,253
1084600,My Time at Sandrock,7193,1095,24.99,6098
1029690,Sniper Elite 5,4194,1379,39.99,2815
1707650,Swords and Sandals Immortals,290,24,17.99,266
1304090,Cannibal Crossing,135,61,19.99,74
1761390,Hatsune Miku: Project DIVA Mega Mix+,4530,520,39.39,4010
1957480,Card Girl Army Ⅱ,2,0,3.99,2
1926560,Freshman Magic: Spellbooks and Tangled Sheets,3,1,5.99,2
1145290,Out There: Oceans of Time,89,64,24.99,25
1941660,Spider Solitaire Collection,2,2,7.99,0
1843710,KeepUp Hunter,8,3,13.99,5
1608450,Hellslave,324,94,19.99,230
1484620,Arcade Spirits: The New Challengers,64,5,19.99,59
1993510,Spellarium 8 Match 3 Puzzle,3,0,6.99,3
1299620,Fabled Lands,206,40,13.29,166
1967320,Fairy Biography,355,96,2.99,259
1579020,Golfie,72,13,17.99,59
1972820,Suicide Guy Deluxe Plus,60,6,8.99,54
1909150,Yosemite Forest Ranger,10,0,8.99,10
803020,Manny Boxing VR,12,10,14.99,2
1132690,Knights of Messiah,64,52,19.99,12
1600780,MY LITTLE PONY: A Maretime Bay Adventure,200,55,39.99,145
1800010,Ruin or Victory,1,0,24.99,1
1370140,Kao the Kangaroo,314,54,29.99,260
1118310,RetroArch,2743,309,0.0,2434
1880230,Trigger Witch,8,0,14.99,8
704020,Master Arena,96,41,0.0,55
1153210,Bartender Hustle,51,12,19.99,39
1559570,Hellstuck: Rage With Your Friends,51,5,4.99,46
1917450,fault - StP - LIGHTKRAVTE,218,30,17.99,188
1095040,Unexplored 2: The Wayfarer's Legacy,127,36,24.99,91
1266120,Unoccupied,15,12,0.0,3
1964440,Tower Of Wishes 2: Vikings Collector's Edition (Match 3),1,0,7.99,1
1997790,Soul Night,9,1,24.99,8
2000360,CORGI,14,3,10.99,11
1989920,白娘子,7,6,0.99,1
1982670,Mystery Solitaire Cthulhu Mythos,0,1,4.99,-1
1995110,Slime Dungeon,8,2,24.99,6
1904160,Trainz Plus,7,1,7.99,6
1469620,Epic Battle Fantasy Collection,111,5,7.99,106
1994110,Fiefdom,17,6,4.99,11
1817940,Love Delivery,1512,58,14.99,1454
1799380,MAGLAM LORD,27,16,39.99,11
1975290,Tomorrow for Mar,13,0,2.99,13
1996420,I commissioned some bees,59,1,1.99,58
1972710,Ever Seen A Cat? 2,98,1,1.99,97
1784570,Trainz Railroad Simulator 2022,20,16,69.99,4
1929770,Xpraize Beta,1,0,14.99,1
1944780,Jewel Match Solitaire X Collector's Edition,6,2,12.99,4
1999700,Something Strange,17,1,0.99,16
1879640,甜點王子2 典藏版,68,12,9.99,56
1828270,Total Anarchy: Pavilion City,0,1,4.99,-1
1836280,Billy 101,13,0,2.99,13
1915550,Nemesis: Lockdown,200,60,19.99,140
1132760,Dwerve,336,110,19.99,226
1069190,Flight Of Nova,53,4,29.99,49
1414250,CORPSE FACTORY,195,30,19.99,165
1594320,Captain of Industry,1598,133,29.99,1465
1921130,Disinfection,7,2,10.99,5
1999170,Insect Swarm,284,52,9.99,232
1773700,Hack and Slime,75,3,4.99,72
1279240,Police Shootout,125,61,14.99,64
1325890,SILT,161,55,14.99,106
1986940,Forward Defense,5,3,6.99,2
1964140,Erroneous,6,1,4.99,5
906930,LEAP,122,108,29.99,14
1903730,IT Simulator,49,5,4.99,44
1909420,Tinyfolks,438,20,3.99,418
2003200,Castle Reborn,2,7,9.99,-5
1591690,DEATHRUN TV,41,4,14.99,37
1781030,Fishing Paradiso,97,7,14.99,90
1393420,TOKOYO: The Tower of Perpetuity,316,31,11.99,285
1835490,SLAYER - Survive & Thrive,12,0,2.99,12
1989130,The Otherwilde,7,2,3.99,5
1983780,Chronicle of Forgotten Times: Pawn of the Gods,4,0,9.99,4
1984610,Barbaria,50,2,14.99,48
1516820,春秋,132,77,17.99,55
1905430,Gravitar: Recharged,15,1,9.99,14
1892950,The Golden Rose: Book One,81,8,9.99,73
1419160,Souldiers,803,510,19.99,293
1489470,Do You See the Waving Cape,28,2,7.99,26
1991830,Click Lovers,2,8,1.99,-6
1682320,Barn Finders VR,3,0,15.99,3
1997300,Pretty Girls Escape,12,2,4.99,10
1755100,The Last Clockwinder,187,4,24.99,183
1994960,Survive 10 Minutes Please,12,0,3.0,12
1840860,Nova Odessa - The Demon Trainer,7,1,4.99,6
1941110,Higurashi When They Cry Hou - Rei,43,1,5.39,42
1906020,Drums Rock,91,2,19.99,89
1371720,Card Shark,991,92,19.99,899
1347080,Girls Overboard,42,10,1.99,32
1677580,My Master's A Moron,23,1,14.99,22
1951140,Kaiju,6,0,2.99,6
2002320,Little Town Shooter VR,1,3,2.99,-2
2004810,Panda Run,10,0,24.99,10
1390120,Nodes,25,11,5.99,14
2001570,Yakiniku simulator,185,9,4.99,176
1032700,Bus Driving Sim 22,77,34,15.99,43
1935460,EMPYRE: Dukes of the Far Frontier,6,5,19.99,1
357330,Space Beast Terror Fright,1232,104,14.99,1128
1779560,Donut Dodo,64,0,4.99,64
1798740,"TEN - Ten Rooms, Ten Seconds",8,0,3.24,8
2004940,Crazy Zoo,10,1,24.99,9
1478350,Game Dev Masters,88,13,14.99,75
2004800,Ink World,10,1,24.99,9
1259140,Ashina: The Red Witch,47,1,4.99,46
1958970,Idle Galaxy,2,9,2.99,-7
1704080,Bean Stalker,122,18,19.99,104
1882820,My Little Dictator,13,0,17.99,13
1980350,Run Build Pew!,188,58,2.99,130
398990,The Last Taxi,8,3,20.99,5
1966900,20 Minutes Till Dawn,9280,692,2.99,8588
1383640,Attack at Dawn: North Africa,23,0,29.99,23
1488560,Football Simulator,95,13,19.99,82
2000540,Chance at Life,24,5,3.49,19
2002380,Over City,10,1,24.99,9
1251930,My Lovely Wife,246,82,14.99,164
1579780,Brave Deeds of Rescue Team,5,3,8.99,2
868270,The Cycle: Frontier,16916,10569,0.0,6347
1673630,Eternal Evil,107,27,19.99,80
1979460,Sinister Night,85,48,9.99,37
1980490,Speedway Challenge 2022,19,3,9.99,16
1707610,Imperium BCE,5,2,24.99,3
1120320,Builder Simulator,513,146,19.99,367
1984710,Synthwave FURY,4,1,2.99,3
1359980,POSTAL: Brain Damaged,2403,91,19.99,2312
1767560,Pro Cycling Manager 2022,220,56,39.99,164
1577120,The Quarry,3653,1168,0.0,2485
1819160,Meteor World Actor: Badge & Dagger,157,6,17.99,151
1412850,Spacelines from the Far Out,122,29,14.99,93
853450,Nevergrind Online,375,38,19.99,337
1782330,Green Hell VR,305,117,19.99,188
1767570,Tour de France 2022,38,28,39.99,10
1524550,Madshot,69,10,19.99,59
1640300,Project Warlock II,208,34,16.99,174
1070790,Freshly Frosted,90,0,9.99,90
585020,Big Bia,995,219,14.99,776
1292040,STRIDE,1640,266,19.99,1374
1488200,Symphony of War: The Nephilim Saga,2370,76,19.99,2294
1383250,Please Fix The Road,95,10,8.49,85
1637230,METAL MAX Xeno Reborn,177,76,39.99,101
366000,Rogue System,169,71,0.0,98
1342070,The Triumphant Return of Diabolos,34,9,19.99,25
1513250,溪风谷之战(roguelike moba game),4,3,0.99,1
1582290,LumbearJack,48,1,12.99,47
1271100,Deadly Premonition 2: A Blessing in Disguise,122,25,27.99,97
1778630,Bee: The Knight,25,0,7.99,25
2009770,Eternal Pinball RPG,9,2,4.99,7
1110890,MY WOLF - Desktop Wild Pet,139,39,3.99,100
1921760,Pocket Academy,77,3,8.99,74
1975570,Cricket Captain 2022,9,5,29.99,4
1824220,Chivalry 2,9944,2192,39.99,7752
1842910,Groove Fit Island!!,2,0,29.99,2
2003740,茶叶蛋大冒险,24,2,3.99,22
1989560,Endless waves survival,76,15,0.49,61
2013650,Logicality,20,4,7.99,16
1570330,West Hunt,57,9,9.99,48
600610,The Hand of Merlin,184,47,24.99,137
2011470,大侠请重来,1729,478,1.99,1251
311260,The Guild 3,3474,2218,29.99,1256
1518690,Nevermore: The Chamber Door,42,2,5.59,40
1960950,Monsterlands,13,2,4.99,11
2010600,Pirates Things,10,2,7.99,8
1782150,OVERLORD: ESCAPE FROM NAZARICK,212,126,29.99,86
1996760,Penitence,16,0,3.99,16
1547410,DnD Adventure: Wizard's Choice,18,0,4.99,18
1197160,Code 3: Police Response,15,10,14.99,5
2013300,Alien Shooter 2 - New Era,60,59,9.99,1
1963660,Neodori Forever,33,6,9.99,27
2007840,Desert Things,9,2,7.99,7
1965800,Dice Tribes: Ambitions,30,1,9.99,29
1998590,Russian Hunter,14,6,2.49,8
2008060,99 Fails Lite,33,2,11.99,31
1574240,Dread Delusion,267,14,19.99,253
1743710,100 Doors - Escape from Prison,1,1,9.99,0
2009340,Defend The Bits TD,23,4,12.99,19
1232100,BroodStar,57,1,10.99,56
2012020,Dis Pontibus 2,1,0,6.99,1
1614360,Super Ember Kaboom,47,2,6.99,45
1343620,Nemesis: Distress,124,59,14.99,65
1974040,The Questing,2,1,0.99,1
1321450,American Theft 80s,273,74,19.99,199
1819180,Oxide Room 104,58,19,19.99,39
1925320,Escape Memoirs: Mansion Heist,26,5,7.99,21
1891090,Final Vendetta,83,15,24.99,68
1650590,Nightmare Frames,88,3,12.99,85
1772620,Bad Guy: Neighborhood,2,0,24.99,2
1571460,Zorro The Chronicles,18,4,29.99,14
1931240,MOTHERGUNSHIP: FORGE,76,4,19.99,72
2017370,Trash Horror Collection,44,3,5.99,41
2017270,Pixel Samurai,35,0,2.99,35
1597290,Swarm the City: Zombie Evolved,97,25,14.99,72
1533420,Neon White,5091,83,24.99,5008
1131240,Dungeons of Edera,635,186,14.99,449
1815230,Summum Aeterna,88,7,14.39,81
514130,European Air War,10,1,4.99,9
1559680,Amazing Frog? V3,49,21,19.99,28
1361510,Teenage Mutant Ninja Turtles: Shredder's Revenge,6356,508,24.99,5848
1134100,Frozenheim,1735,678,19.99,1057
1799930,Redout 2,392,124,29.99,268
1389360,Mech Armada,264,46,19.99,218
1202130,Starship Troopers: Terran Command,4090,580,29.99,3510
1776970,Tsuki ni Yorisou Otome no Sahou,977,16,39.99,961
1462040,FINAL FANTASY VII REMAKE INTERGRADE,5510,657,69.99,4853
1413020,Superfly,341,54,14.99,287
1803960,Demon Sword: Incubus,55,22,19.99,33
1709240,Strange Investigations: Becoming Collector's Edition,2,0,9.99,2
1946810,心Soul,10,0,4.24,10
2001050,三国英雄坛,3,2,0.79,1
2020380,Astrocat: Skylar´s Memories,21,0,0.99,21
2007410,Strange Investigations: Two for Solitaire Collector's Edition,1,0,13.99,1
1924820,StudioS Fighters: Climax Champions,10,0,9.99,10
1841320,PAIN,29,0,4.99,29
1774890,Bocce Time! VR,27,0,8.09,27
1996710,Sokolor,21,0,1.99,21
979480,Born Punk,67,6,19.99,61
1826160,The Asmodian Princesses and the Witch in the Forest,18,6,24.99,12
2008560,วีรบุรุษไร้พลัง ไข่ต้ม,6,0,6.99,6
2016650,Hot Speed,1,1,4.99,0
1365600,REPTRAILS,16,1,0.0,15
1660860,The Harem Life of Peerless Swordsmen,86,29,7.99,57
1946300,Masks Of Deception,97,26,13.99,71
1648470,谜语女孩,64,9,1.99,55
1831870,The Hotel,37,3,1.39,34
1921560,Flowers -Le volume sur hiver-,297,34,19.99,263
1837820,Faded Stories: Greenberg,14,0,5.99,14
2055270,Tile Tale,21,6,4.99,15
2002720,CubeShooter,5,0,1.99,5
1952740,Infinite Turtles,20,0,7.99,20
1641670,EdgeOfTheAbyssAwaken,378,130,18.99,248
1562700,SANABI,792,20,14.99,772
1818690,Grindstone,54,2,19.99,52
1898610,Hands of Necromancy,33,1,12.99,32
1681840,Summoners Fate,100,10,19.99,90
1702220,Cool Animals,12,1,0.49,11
1961380,Taiga,1,1,4.99,0
648800,Raft,182819,13311,19.99,169508
1987080,Inside the Backrooms,635,122,4.99,513
418430,Miolhr,15,13,14.99,2
1917860,Visionarium 2 - The Descent,15,2,14.99,13
1680670,Mango Mischief,9,1,9.99,8
1880490,Meet me at NooN,50,0,9.99,50
1649730,xiuzhen idle,529,84,3.59,445
2005150,Tiny Robo Puzzles,1,1,2.99,0
619390,Oddworld: Soulstorm Enhanced Edition,76,36,39.99,40
2000280,I’m going to die if I don’t eat sushi!,55,0,3.99,55
2051440,Guardener,33,2,4.99,31
1886290,Slot Shots Pinball Collection,12,0,9.99,12
911430,Good Company,972,333,24.99,639
1962560,Grim Horde,29,7,2.99,22
826470,Nummels,14,0,12.99,14
1732750,Havsala: Into the Soul Palace,355,12,11.99,343
1857980,The Paper Game,5,0,7.99,5
1956400,PISTOLA,16,3,2.99,13
1938290,Vactics,9,0,9.99,9
980170,Tenko's Magical Sword Quest,7,0,2.99,7
1098280,Mago,272,13,14.99,259
1990820,Z-Warp,13,0,6.99,13
1828700,Celestial Project,12,6,9.99,6
1989680,Airport Service Simulator,0,6,9.99,-6
1587540,Anvil Saga,382,91,13.99,291
1266630,懒人修仙传2,338,73,7.99,265
1995030,Lord of Darkness: Prologue,3,0,0.99,3
1794960,Sonic Origins,991,727,39.99,264
1359920,Last Days of Lazarus,49,3,17.99,46
1761290,Japanese Rail Sim: Journey to Kyoto,27,5,59.99,22
1029650,יום פתוח (Open Day),61,0,14.99,61
1933740,The Caligula Effect 2,147,10,49.99,137
1852940,Highline Volleyball VR,6,4,24.99,2
1065520,Autobahn Police Simulator 3,42,65,29.99,-23
1860700,Outmode,12,3,10.99,9
1884300,Deathsmiles I・II,24,0,39.9,24
1593170,Veil of Dust: A Homesteading Game,16,0,9.99,16
1370690,How I learned to Skate,16,1,7.99,15
2014370,魔塔三国之群雄争霸,27,2,0.99,25
1303050,Ruggnar,7,0,13.99,7
2024230,Project Lazarus,415,42,2.99,373
1678420,Blade Runner: Enhanced Edition,65,77,9.99,-12
1486280,The Backrooms: Mass Extinction,18,5,19.99,13
1443850,Social Services of the Doomed,6,1,7.99,5
2027220,Perfect Jump,1,0,19.99,1
981430,Gordian Quest,3839,341,19.99,3498
1685750,Capcom Fighting Collection,307,27,39.99,280
1286680,Tiny Tina's Wonderlands,2337,760,59.99,1577
1481600,Fake Racing,8,0,9.99,8
1947670,polyemisokos,3,0,3.99,3
1645820,SurrounDead,344,42,15.99,302
1449200,AI: THE SOMNIUM FILES - nirvanA Initiative,1058,98,59.99,960
1941550,The Coven of Calahree,1,2,9.99,-1
2050680,Warbox Sandbox,27,4,4.99,23
1965390,Online Sparkler,23,2,4.99,21
1812620,DSX,197,39,2.99,158
1410980,Serafina and the Key to the Egg,53,10,16.99,43
1306570,Fadeout: Underground,125,22,0.0,103
1355440,开局一把剑,23,5,1.99,18
1216060,DNF Duel,1936,901,49.99,1035
1665130,PAC-MAN MUSEUM+,129,16,19.99,113
2023810,Island Idle RPG,15,7,2.99,8
1926440,Twin Edge,16,1,9.99,15
1854580,In The Space - Escape Room,9,2,9.99,7
1205970,MX vs ATV Legends,269,217,39.99,52
871940,BrawlQuest,54,13,0.0,41
1883260,Little Noah: Scion of Paradise,598,41,14.99,557
1749750,Disgaea 6 Complete,107,57,69.99,50
1904280,Feartress,22,8,6.99,14
2026370,A game that saves the muscles caught in the ceiling of the gymnasium,35,0,1.99,35
1631830,Squish,12,0,14.99,12
1516330,Acolyte,31,1,10.99,30
1298140,Fobia - St. Dinfna Hotel,495,51,29.99,444
1315410,Mini Maker: Make A Thing,16,0,9.99,16
1335400,Rangers,4,1,5.99,3
1867810,Mercenaries Rebirth: Call of the Wild Lynx,18,8,19.99,10
1687470,Stolen Crown,10,0,9.99,10
1755580,The Jackbox Party Starter,23,4,19.99,19
1981480,Thrill Penguin,15,0,3.99,15
1993030,Clown For Speed,34,2,0.99,32
1982310,NeoPiano,10,0,9.99,10
664130,僕と彼の危険な同居生活,9,14,18.99,-5
1602880,The Lord of the Parties,21,7,15.99,14
1949300,EXIT - The Curse of Ophir,7,1,7.99,6
1871310,Hook 2,193,2,1.99,191
1684750,I deserve a happy ending,5,0,3.99,5
2005660,Ukraine Defense Force Tactics,94,0,2.99,94
597060,Numina,13,2,16.99,11
1998300,Where's Oswald,4,3,1.99,1
1881200,TRYP FPV : The Drone Racer Simulator,176,17,13.99,159
1949330,Jigsaw Savant,2,0,19.99,2
1736680,Xio: Survival,9,6,19.99,3
919360,Alaloth: Champions of The Four Kingdoms,298,101,24.99,197
1995870,Pixel Survivors : Roguelike,48,12,1.99,36
1717260,My Universe - Green Adventure - Farmers Friends,1,1,29.99,0
1692250,F1® 22,4849,2467,59.99,2382
1971770,Wandering in space,41,9,14.99,32
2061260,发现姐姐是妹控的我今后该如何是好,15,5,0.99,10
1929850,散落之瓣：華 - Falling Petals: Bloom Edition,10,1,5.99,9
1986840,POPGOES Arcade,472,7,4.99,465
1970300,Whisper Books,23,4,5.99,19
1977900,Bonza Boom,5,1,0.99,4
1701740,Noctem,31,8,11.99,23
2062330,Omega Squad,6,0,9.99,6
1078360,To Your Stations!,9,0,0.0,9
2050430,Starting Life In Another World Naked,4,1,19.99,3
2009670,Moontrain,1,2,14.99,-1
1945190,Heroes Rally,1,2,12.99,-1
1933980,Pool Slide Story,69,6,10.99,63
1952170,Cafeteria Nipponica,49,4,8.99,45
1923680,Mega Mall Story,42,3,8.99,39
1958130,The Backrooms: Found Footage,19,3,5.99,16
1995890,Aerofly FS 4 Flight Simulator,49,13,59.99,36
446530,One Last Crane,3,2,14.99,1
1511780,Last Call BBS,273,4,19.99,269
2060480,PomoFarm,40,1,4.99,39
1999360,Placid Plastic Duck Simulator,959,24,1.99,935
2019650,The Snow Fable: Mystery of the Flame,2,0,6.99,2
1933490,Let's Play! Oink Games,12,7,24.99,5
1960800,Overrogue,8,6,14.99,2
1609730,Aliens vs. Ghosts,69,2,4.99,67
1996000,Grid Words,1,0,1.99,1
1969080,A Building Full of Cats,352,3,1.99,349
1711950,GWENT: Rogue Mage (Single-Player Expansion),335,238,9.99,97
1987160,The Kobolds Left Behind,7,2,5.99,5
1918680,Sword and Fairy Inn 2,760,905,19.99,-145
1926220,Ludo XXL,1,2,17.99,-1
1986010,灵墟,113,26,10.99,87
2022380,The Secret of Rooms,5,0,2.99,5
1946430,Garage: Bad Dream Adventure,55,1,19.9,54
1953490,Seven Deadly Dates,16,1,6.99,15
1730680,Klonoa Phantasy Reverie Series,764,20,39.99,744
1897250,The Sword of Rhivenia,25,10,6.99,15
1543360,StarFlint the BlackHole Prophecy,23,28,24.99,-5
553150,VR Dungeon,5,6,4.99,-1
1268420,Britannia,11,1,17.99,10
1670870,MADiSON,578,90,34.99,488
1345760,Matchpoint - Tennis Championships,52,27,39.99,25
1843860,The Redress of Mira,9,2,9.99,7
1921180,Escape Game - FORT BOYARD 2022,3,1,24.99,2
1701560,RUINSMAGUS,86,18,34.99,68
876160,Occupy White Walls,1080,82,0.0,998
2051420,Beltex,24,1,4.99,23
1928370,Exodemic,30,1,4.99,29
1163930,Dragon Forge,50,40,19.99,10
1868060,Who Shuffled My Shapes?,3,0,7.99,3
2054150,Tower Defender: Hero Wars,2,1,12.99,1
2056880,Mystery of Mortlake Mansion,10,2,5.99,8
1460650,Lodestar,31,11,29.99,20
1730060,Deep Space Salvage Crew VR,9,5,18.99,4
1909020,三国記II,4,0,17.99,4
1251040,Aegis Descent,13,3,19.99,10
1342120,Castaway of the Ardusta Sea,44,9,14.99,35
2022110,Candy Girlfriend,5,8,1.99,-3
1733840,Yurukill: The Calumniation Games,20,6,39.99,14
1814460,ゆうしゃvsドラゴン,9,3,4.99,6
2013740,Underwater World - Idle Desktop Colony Building Simulator,10,2,3.99,8
1960170,ALUMNI - Escape Room Adventure,10,2,8.99,8
2062940,Territory,3,0,12.99,3
1957910,Farmland Realm,16,0,4.99,16
1848580,WAVECADE,13,0,9.99,13
1401560,Kilta,39,14,12.99,25
1649860,Krut: The Mythic Wings,6,2,9.99,4
2015700,东方心之解束~Saving from the devil,35,0,4.99,35
2066530,传颂的种族 The Celebrated Race,4,0,2.99,4
2052170,In to the 029,21,4,5.99,17
1877780,Shibainu - VR Katana Simulator,16,8,11.99,8
1858120,Generic RPG Idle,4,0,2.99,4
1961390,Sakura Succubus 6,23,0,9.99,23
2006390,Valand,6,4,7.99,2
1360660,Neon Blight,21,25,19.99,-4
1485070,Esse Proxy,61,13,19.99,48
1305820,Lunar Axe,61,4,7.99,57
1712750,PIXELS: Digital Creatures,18,6,19.99,12
1707540,Escape From Monster,98,59,3.99,39
1893620,Circadian Dice,202,8,5.99,194
1907000,Gloomgrave,57,5,3.99,52
1927570,Tilefinder,6,0,11.99,6
1717510,Time on Frog Island,56,13,19.99,43
2067170,Caged Beast,13,1,24.99,12
2054740,Cozy Time,27,0,2.99,27
1927720,Monument Valley: Panoramic Edition,408,9,7.99,399
1870490,Prop Hunt 2.0,9,2,7.79,7
1683340,Kayak VR: Mirage,317,30,22.99,287
1986880,Growing My Grandpa!,26,2,4.99,24
1927740,Monument Valley 2: Panoramic Edition,140,12,7.99,128
1674640,XEL,66,38,14.99,28
1998170,Second Thoughts,14,2,1.99,12
2069110,I commissioned some bees 3,6,0,1.99,6
1846870,Super Kit: TO THE TOP,7,2,14.99,5
1989140,Tower of Spirit,6,0,2.99,6
1907230,An Uninvited Guest,4,0,7.99,4
1471180,梦江湖,420,408,19.99,12
1879330,WARRIORS OROCHI 3 Ultimate Definitive Edition,494,68,39.99,426
2013150,BUBBLE NIGHT,1,0,1.99,1
1969320,Elena's Journal - Unfinished Expedition,3,0,12.99,3
1614990,Grid Leaper,7,0,7.99,7
1702330,Rune Factory 5,427,89,59.99,338
1844330,Profession investigator,7,0,12.99,7
1724000,Time Lock VR-2,44,1,9.99,43
1812090,Escape Academy,116,15,19.99,101
1982900,Coding Learn,16,3,1.99,13
1949190,Necrosmith,1385,231,2.99,1154
916140,The Tale of Bistun,88,8,17.99,80
1975810,Girls' civilization 3,2,2,18.99,0
1997920,Isolania,5,0,4.99,5
1650810,Loopmancer,281,98,24.99,183
1411740,Urbek City Builder,314,28,16.99,286
1277870,SUPER UFO FIGHTER,9,0,11.99,9
1885130,The Future You've Been Dreaming Of,14,20,17.99,-6
1191620,Spidersaurs,8,3,19.99,5
1157960,Blackout Rugby Manager,59,26,0.0,33
1290000,PowerWash Simulator,23136,545,24.99,22591
1646120,Citizens: Far Lands,33,1,11.99,32
1062520,Dinkum,2696,145,19.99,2551
1755030,Mothmen 1966,68,6,8.99,62
1829420,Before The Night,94,2,13.99,92
1368850,Cursed Treasure 2 Ultimate Edition - Tower Defense,34,15,8.99,19
1700870,Clanfolk,473,59,19.99,414
1508980,Cheese Runner,7,0,2.99,7
1533410,Mollycoddle Mayhem,11,0,13.99,11
1904860,Legends of Kingdom Rush,298,180,14.99,118
2022410,RoadRace,5,0,0.99,5
1392560,Serious Fun Football,15,1,9.99,14
1948930,Ambitious,2,5,0.99,-3
1425830,Halley's Dream,4,0,9.99,4
1039360,Eyes in the Dark,42,12,14.99,30
1946550,Toilet Chronicles,338,34,4.99,304
1631350,Fight of Steel: Infinity Warrior,36,2,12.99,34
1966130,Strategic Command: American Civil War,30,5,39.99,25
1788850,你已经猜到结局了吗,53,4,7.99,49
2065110,Alexander the Great: Secrets of Power,2,0,5.99,2
1985260,Kinkoi: Golden Time,125,2,29.99,123
1731200,TRATRITLE,193,20,19.99,173
611790,House Party,10473,1403,24.99,9070
700310,Music Racer 2000,5,7,9.99,-2
2015860,江湖百异图,11,13,13.99,-2
1646090,Tokyo Rogue,12,0,12.99,12
2059390,The Patient: After Hours,7,0,4.99,7
1900020,PunjiVR,9,0,19.99,9
1812970,Immortal Tactics: War of the Eternals,68,5,14.99,63
2020630,廃村巡り | Haisonmeguri,35,12,2.99,23
1491460,Tor Eternum,21,5,12.99,16
1891920,Sandream,5,0,11.99,5
1990260,Phantom Tentacle,94,8,1.99,86
1383570,Ballex²: The Hanging Gardens,11,0,14.99,11
1900930,DANGO!,113,85,4.99,28
1922060,BrVR Backrooms Virtual Reality,14,0,4.99,14
1577690,Video Game Fables,9,0,19.99,9
2063010,SUSHI ALONe,3,0,4.99,3
1412950,Dark Romance: Vampire Origins Collector's Edition,1,0,9.99,1
1111650,Never BreakUp,17,8,8.99,9
1967450,捉妖物语/Monster Girl,85,6,1.99,79
2073470,Kanjozoku Game レーサー,392,57,5.99,335
1743570,RFVR,9,2,29.99,7
2051820,Yakuza Undisputed,2,1,9.99,1
1678320,Heat Death,4,0,9.99,4
2074490,MOAR - Appeteaser,4,0,12.99,4
1936360,Escape From Mandrillia,26,0,12.99,26
2054100,chessVR,6,5,9.99,1
1094920,Hazel Sky,42,7,22.49,35
1818750,MultiVersus,9490,831,39.99,8659
1965560,Rogue Warlords,2,2,8.99,0
1332010,Stray,39381,912,29.99,38469
2062160,Hold Controller,1,0,3.6,1
1341820,As Dusk Falls,178,27,29.99,151
2056990,尋找自我 MastEr,0,1,5.99,-1
2059760,Elden Gunfire 2,5,1,7.64,4
615120,COMPOUND,1232,31,19.99,1201
898890,Endling - Extinction is Forever,204,10,29.99,194
1903170,The Quest For Excalibur - Puy Du Fou,1,0,26.99,1
1990880,Leave No One Behind: Ia Drang VR,3,1,22.49,2
1924010,Shapebreaker - Tower Defense Deckbuilder,15,2,2.99,13
1395920,GrappleWell,2,0,6.29,2
1715980,Bail or Jail,37,8,15.99,29
1864710,Coin Operated Carnage,1,1,10.19,0
1165470,TombStar,34,10,13.49,24
1409760,Gardens Of Celestial Globes,1,0,4.68,1
1878110,Victorian Debutante,2,0,4.24,2
1167150,Zombies and Keys,12,0,2.69,12
1013220,River City Saga: Three Kingdoms,63,22,29.99,41
490280,Realms of Magic,394,80,13.99,314
1889930,Baldur's Gate: Dark Alliance II,112,46,29.99,66
1691970,Danganronpa S: Ultimate Summer Camp,77,66,19.99,11
787510,Muv-Luv Alternative Total Eclipse Remastered,35,2,35.99,33
1249480,Ex-Zodiac,167,0,8.99,167
1088750,Soda Story - Brewing Tycoon,23,1,17.99,22
2055730,미연시 시뮬레이터 : 미소녀 게임의 주인공을 조종하는 게임,4,0,2.66,4
2059790,再刷一把 PlayAgain,1701,575,6.29,1126
889910,Hell Pie,259,9,22.49,250
1995800,Zodiac fantasy,39,20,1.79,19
1565090,GearHead Caramel,2,0,7.69,2
2067730,Daybreaker VR,5,2,17.99,3
1932690,Liar Moon Shangri-La,3,1,33.74,2
1936300,Target:Summit(目标：登顶 ),2,0,1.59,2
965620,Wings of Glory,22,0,14.99,22
1572150,The Monster Mole,2,3,2.24,-1
1066680,Fleet Commander: Pacific,3,0,24.99,3
2076240,Elementals: The Magic Key,2,0,4.49,2
2073970,Brave Heroes,4,0,4.49,4
1928850,STAR MATH: Interstellar Rogue 2,1,0,10.79,1
1319400,The Sunny Life,4,1,9.99,3
1856090,World of Haiku,14,4,24.99,10
1692290,INHUMAN,22,8,3.59,14
1448610,NERO,113,16,17.99,97
1887020,Raubritter,57,29,19.99,28
1883320,剑与桃花 the sword and peachblossom,14,0,3.19,14
1975890,Alone,2,0,9.89,2
1824110,HOSTLIGHT,1,0,11.99,1
2011860,Refund Me If You Can,28,9,3.99,19
1707850,Cheaphaven,3,0,7.99,3
1868000,Resist the succubus—The end of the female Knight,332,76,14.44,256
2074960,PAWN SHOP SIMULATOR,1,4,4.24,-3
1746560,Blacken Slash,14,0,4.49,14
1980890,Sky in your eyes,19,1,3.95,18
2071460,Agile firefighter,4,0,1.19,4
1709180,Solitaire Expeditions,24,1,9.59,23
1694150,Crate Knight,1,0,3.49,1
1921770,The Manga Works,50,6,8.99,44
2001460,国際指定怪異123号 廃村,9,2,3.99,7
1739880,Blood And Zombies,123,32,10.04,91
2079800,你与月光同罪-As Guilty As the Moon,0,1,7.99,-1
1060230,Sapiens,311,56,22.49,255
1428710,The Tarnishing of Juxtia,56,25,22.49,31
2012610,Age of Undead,11,0,26.99,11
1546140,Soccer VR Football,1,1,3.19,0
1565890,RaceLeague,66,33,22.49,33
2082480,露娜传,67,3,20.99,64
1730750,Hunkenstein,0,1,9.74,-1
2059810,Richman 4,235,202,5.09,33
1840350,Koi-Koi VR: Love Blossoms,12,2,47.99,10
2063480,Voltage High Society,10,1,3.59,9
1811950,The Legend of Heroes: Kuro no Kiseki,161,22,44.99,139
1952930,Soul Wargame,27,8,7.19,19
799640,Dungeon Munchies,3806,83,19.99,3723
2057710,Sweet Office,49,8,2.69,41
1899290,Gems of Destiny: Homeless Dwarf,6,0,6.99,6
2086460,Idle Factory,6,1,3.49,5
2067300,Crossfar,2,0,44.99,2
1960330,Alchemia: Creatio Ex Nihilo,3,0,16.19,3
2050720,隐秘的原罪8,18,0,7.19,18
1519310,AI Dungeon,59,67,23.99,-8
1850740,Ghost Watchers,936,294,11.99,642
1632590,The Silent Sky Part I,2,1,12.59,1
2063050,TVs: The Awakening,3,0,4.99,3
871980,Digimon Survive,558,150,59.99,408
1663990,The Dragon and the Djinn,5,1,4.79,4
1907720,Autonauts vs Piratebots,86,5,17.99,81
2066420,这里有妖,4,2,2.69,2
362670,Curse of the Deadwood,3,3,24.99,0
1943980,FITRIZ,1,0,2.79,1
1741160,Catch Me!,7,0,4.79,7
1811600,Vestaria Saga II: The Sacred Sword of Silvanister,34,5,19.99,29
1652120,Find the Cats,3,1,3.99,2
1428770,Kingdom Gun,45,22,9.99,23
1612770,Sweet Transit,119,36,19.79,83
2080100,Ruadh: Warbands,7,0,9.59,7
287310,Re-Volt,286,28,5.39,258
1419750,Apostle: Rebellion,43,7,17.99,36
2016220,EarthRoyale,13,0,5.94,13
2005320,Illusion 幻覚,6,0,3.19,6
1070260,Graduated,99,21,12.59,78
1869560,Yoko Redux: Dreams of a Blue Planet,4,0,19.99,4
2006730,Godumas,4,5,4.49,-1
1097430,Book of Yog Idle RPG,49,23,0.0,26
1989640,From Within,1,0,6.29,1
1516680,De'Vine: Heavenly Acres,5,2,13.49,3
1777000,Cut to the Core,11,0,2.99,11
1952400,New Horizon,6,1,5.99,5
1990050,Creature Creator,50,1,0.99,49
1556490,Retreat To Enen,77,64,19.99,13
1891210,Quest: Escape Dungeon,13,0,1.19,13
2057070,Voxrush,9,0,2.69,9
1745520,REDSHOT,7,0,13.49,7
1633370,Boat Crew,6,0,15.99,6
2073110,PlayWith,1,0,6.99,1
1975160,Be,10,1,11.69,9
1998030,Bug Dolls: Soviet Project,11,1,7.49,10
2056490,Forrader Hero,7,1,2.54,6
1295920,The Mortuary Assistant,677,106,22.49,571
1575470,Frogun,113,10,11.99,103
1493960,Move 78,8,0,19.99,8
2074040,Third Wild,4,3,7.19,1
1681310,In Your Books,4,1,7.19,3
1673020,All Ashes and Illusions,3,0,11.69,3
1912630,Champs TD,7,0,8.49,7
1866180,Hooked on You: A Dead by Daylight Dating Sim™,2492,268,9.99,2224
1655940,Earth's Shadow,22,2,13.49,20
1950820,Mechabot Defender,4,1,3.39,3
1817560,VOIDCRISIS,45,42,24.99,3
1822230,Kokoro Clover Season1,6,0,17.09,6
1811040,South of the Circle,122,22,11.69,100
1958620,Aznak,0,1,5.99,-1
1941740,The Adventures of Poppe,7,1,6.99,6
1324350,Turbo Golf Racing,121,12,16.19,109
1282410,Hard West 2,334,118,26.99,216
2092700,江湖群雄传,1,6,9.99,-5
615530,"Love, Money, Rock'n'Roll",1351,267,19.99,1084
1528680,Inn Mage,3,1,5.39,2
1247580,The Dark Heart of Balor,5,0,12.74,5
1599600,PlateUp!,210,11,14.39,199
1968520,Unknown,1,0,0.99,1
1174270,IKO 39,4,0,14.39,4
1860960,Eira,13,1,19.99,12
2087180,都市媚影-CityFascination,1,0,11.89,1
2078120,Hot And Lovely 5,35,5,1.99,30
1949440,Burrow of the Fallen Bear: A Gay Furry Visual Novel,1,0,16.99,1
2069960,ROGUELINE,2,0,2.99,2
1903400,Bicycle Rider Simulator,12,1,3.99,11
1944570,Boneraiser Minions,168,1,1.59,167
1944140,Lys and Ruka's Magical Bag,12,10,13.49,2
2092410,Pink Explorer,8,0,1.49,8
2095450,Tiny Tactics,17,1,8.49,16
1989650,Hearts United,1,0,6.29,1
2088680,天香与小百合 - Tinheung & Sayuri,5,0,0.89,5
2018130,Desktopia: A Desktop Village Simulator,36,13,8.99,23
1489110,Zapling Bygone,50,0,12.79,50
1981780,FAMILY BATTLE タッグアリーナ,2,2,7.99,0
2050740,Hidden Objects with Edgar Allan Poe - Mystery Detective,10,0,2.69,10
1662140,Real estate tycoon,146,7,9.89,139
2020510,風色幻想4:聖戰的終焉,14,1,3.19,13
2020520,風色幻想5:赤月戰爭,43,6,4.79,37
1713140,Arctictopia,5,0,4.49,5
2020550,風色幻想XX:交錯的軌跡,15,2,4.79,13
2020530,風色幻想6:冒險奏鳴,32,4,4.79,28
1958810,My Bunny Girl,18,9,0.84,9
1949420,Ren's Demons I,2,0,3.59,2
2093650,NEAVE 2,1,0,2.69,1
2020540,風色幻想SP:封神之刻,27,9,1.59,18
1044720,Farthest Frontier,1886,372,29.99,1514
2092260,Pinch of Fighting Girls,10,3,10.39,7
2090160,Sissa's Path,11,0,1.39,11
1649080,Two Point Campus,656,108,39.99,548
2090580,Matcha,3,0,2.99,3
1897320,Garden Guardian,24,0,3.99,24
2082560,Mutagenic,3,0,3.49,3
1695260,Timothy and the Tower of Mu,5,2,11.99,3
1978580,SGS Operation Downfall,4,0,14.99,4
1651610,Last Night of Winter,20,0,8.49,20
2073530,Stereo Boy,3,0,5.99,3
1862520,Just Go,271,30,8.99,241
1880020,Kojimachi,4,1,4.49,3
2072080,Super Demon Survivors,11,1,2.99,10
2052680,Colorful Recolor,13,0,7.49,13
1684010,Sail,6,1,14.99,5
1328840,Lost in Play,181,1,19.99,180
1891140,Tightrope Theatre,5,0,4.49,5
1968500,Super Asqr,1,0,2.69,1
1893080,Scare Train VR,2,0,3.99,2
2090500,"DON'T STOP, YOU'LL DIE!",3,0,1.79,3
1943950,Escape the Backrooms,625,223,8.99,402
2086730,Fruit Girl Kiss,0,4,1.39,-4
2070030,Super Kenney,1,0,2.39,1
946030,Axiom Verge 2,41,18,17.99,23
1772910,Dead District: Survival,19,18,6.74,1
1313140,Cult of the Lamb,7555,985,24.99,6570
1969530,Paranormal Preparatory School,7,1,3.95,6
2079710,Fantôme,6,1,2.99,5
2013870,Idle Hero,1,4,1.69,-3
2066210,War Dots,1,0,4.99,1
2004980,Revenge of the Orcs: Flag of Conquest,9,0,11.99,9
2007080,AsteroIdle,1,3,2.69,-2
1844400,Rasetsu Fumaden,13,1,16.19,12
2085270,Arcade Waifu,1,2,0.79,-1
1875670,Gigant,6,0,3.59,6
1960400,SokoChess,21,0,4.49,21
1972190,Animal Trail ☆ Girlish Square,4,0,13.49,4
759080,City Eye,10,25,8.49,-15
1952780,Spider Slingers,8,0,4.79,8
1767170,Super Bullet Break,64,14,17.99,50
1833560,Witchhazel Woods,5,0,7.99,5
2053580,Nonozle,2,0,3.99,2
1985240,Putinist Slayer,4,0,4.99,4
1417750,Moondrop,1,0,8.99,1
1817070,Marvel’s Spider-Man Remastered,11105,437,59.99,10668
1319460,Fashion Police Squad,178,12,17.99,166
1737730,Neko Journey,22,4,6.99,18
1964330,Madcap Mosaic,2,0,6.29,2
1970580,Backpack Hero,727,59,15.29,668
1407450,大江湖之苍龙与白鸟,1004,882,17.99,122
2075250,ESCAPE IT,8,4,3.99,4
1548680,Untitled Crossing Record,38,15,7.99,23
1780480,One by One,17,0,7.99,17
2086280,Deus Novum,4,0,19.99,4
1412890,Frail Hearts: Versicorae Domlion,32,0,8.49,32
1288320,Way of the Hunter,1321,582,39.99,739
1185290,Cahertis,2,0,8.49,2
1109680,Regiments,527,61,25.49,466
1054350,Lost and Hound,19,0,19.99,19
1488070,Vesper: Ether Saga - Episode 1,1,0,17.99,1
1294420,Rollerdrome,361,18,19.79,343
2100810,cheesequest,6,0,2.99,6
957660,Catizens,97,11,15.99,86
1590190,Self-Delusion,39,1,8.99,38
2093100,异世界的回响千雪之歌,11,1,8.09,10
1191800,City Block Builder,4,3,19.99,1
2051450,"Don't Die, Mr. Robot! DX",1,0,5.39,1
1140150,东方光耀夜 ~ Lost Branch of Legend,85,23,26.99,62
2098820,Galaxy Survivors,6,0,2.69,6
1514950,Neodash,171,21,14.39,150
2108420,Climb Challenge - Castle,8,1,8.39,7
1681890,Little League World Series Baseball 2022,1,8,39.99,-7
2091000,黄金矿工大冒险,1,4,4.99,-3
1995760,Dream magic will,5,0,4.49,5
2085800,Kalinur,50,0,1.19,50
1919740,Silent Love,42,11,5.99,31
2095350,NONOGRAM - KAWAII CUTIES,0,1,1.79,-1
1550730,Ikonei Island: An Earthlock Adventure,17,0,13.49,17
1784180,Fragment Hunters,1,0,9.99,1
1343240,Thymesia,1000,197,22.49,803
2099220,Mobmania,5,1,4.99,4
1027810,ZooKeeper,8,4,7.99,4
1726120,Cursed to Golf,111,20,17.99,91
2052640,Anomalous Zone ███,5,2,5.27,3
1819660,Eyes Over Us,2,0,2.54,2
1552620,Expedition Agartha,179,42,19.99,137
1968730,Bounty of One,73,7,3.99,66
1240590,Sir Whoopass™: Immortal Death,74,11,14.44,63
1425630,Space Crusaders,7,1,1.79,6
2087470,I commissioned some bees 5,1,0,1.69,1
1155900,Treehouse Riddle,2,1,13.49,1
1643850,Slaycation Paradise,13,0,11.99,13
1879750,YONESAWARA HOSPITAL,3,1,11.04,2
1957170,The Unsettled,1,2,6.99,-1
2080640,First Date : Late To Date,15,0,2.39,15
1950570,The witch of the Ihanashi,3,0,17.99,3
2057170,Happy's Clocks,2,0,1.79,2
1848860,Ember Crusade IV,1,1,6.79,0
1919240,Spelldash,2,1,4.24,1
2014930,A Last Will and TESTament: Horror adventure,7,1,0.89,6
2010830,Your Love Story 被你忘记的那个夏天,3,0,1.79,3
1858550,Grand Hike,8,3,2.39,5
1434910,Last Visit,2,0,9.99,2
1873750,Periphery,1,1,4.99,0
1945880,Financial freedom for the few,2,1,5.99,1
1853120,Cannon Canines,1,0,3.99,1
2004440,Pocket City,12,0,3.99,12
2104790,Griddy,35,0,1.79,35
1461030,Carnivores: Dinosaur Hunt,15,5,14.99,10
2075120,A Clumsy Flight,19,2,4.34,17
1746700,The Alchemist Shop: An Apprentice's Life,13,0,2.54,13
782250,Hush Hush - Only Your Love Can Save Them,157,8,17.99,149
2107060,Deathrun Guys,1,0,1.19,1
1937750,Prime of Flames,142,42,8.99,100
2100200,Idle Zombies Clicker,2,3,2.69,-1
1666500,Write 'n' Fight,5,9,0.0,-4
1136380,Ultimate Fishing Simulator 2,227,92,16.99,135
1459660,Become a Gladiator VR : 1v1 PVP,3,9,0.0,-6
1969720,Delta Manifold,16,0,7.79,16
1247860,藏梦 Hidden Dream,22,0,11.69,22
2055220,Desktop Girlfriend,326,64,1.55,262
1521160,Are You Smarter Than A 5th Grader,10,1,29.99,9
1682060,Warriors of the Nile 2,210,65,13.49,145
2023050,Lighthouse Keeper,113,9,9.59,104
2068710,Hot Lap League: Deluxe Edition,22,2,9.89,20
1390410,Midnight Fight Express,314,60,19.99,254
1927600,Descentium,2,1,5.99,1
1284210,Guild Wars 2,1323,223,0.0,1100
2051530,Quick Tower Defence Ultimate,2,0,5.99,2
1997800,Delusional,2,3,5.99,-1
1842890,矿老板模拟器,6,0,4.99,6
1947750,Queen's Wish 2: The Tormentor,6,1,21.24,5
1131670,Justin Wack and the Big Time Hack,26,0,19.99,26
1473480,A.V.A Global,1102,1151,0.0,-49
1611430,The Bridge Curse Road to Salvation,327,37,17.99,290
2109800,My Dear Sister,4,0,5.99,4
2113990,山海长歌,2,1,3.39,1
2075230,Witch girl got killed.,1,0,2.99,1
2066300,Escape: The Endless Dogwatch,4,0,4.79,4
1934930,Conquest Emperor,6,14,0.79,-8
824550,SD GUNDAM BATTLE ALLIANCE,1281,892,59.99,389
2086810,Golden Rails: World’s Fair,2,0,5.94,2
1896720,Dumb Little Robots,1,0,1.99,1
2106660,Mirror Beauty,0,1,1.39,-1
1777620,Soul Hackers 2,352,93,59.99,259
1729410,Earthling's Undertaking,192,41,14.39,151
1957680,Mount Wingsuit 2,5,1,14.99,4
1923720,Wildlife Planet: The Incremental,4,4,2.69,0
1859470,PAC-MAN WORLD Re-PAC,125,6,29.99,119
1957590,Armored Lab Force VULVEHICLES,5,0,8.49,5
1786480,Like No Other: The Legend Of The Twin Books,33,1,16.14,32
2084410,SONOHIGURASHI VS. TOUHOU UNIVERSE2,2,0,8.99,2
1775080,Animal Simulator,5,1,19.99,4
1994400,MAGITERRA,1,0,7.99,1
2096400,TAMAKAGURA: Tales of Turmoil,1,0,15.99,1
1766010,Force Reboot,55,2,2.69,53
1578500,Starless,6,0,7.99,6
2094620,Noblesse Oblige,3,0,3.99,3
2114020,山间有点田-Sweet In the Mountains,1,0,9.59,1
949480,BROK the InvestiGator,63,0,17.99,63
1821340,Hole in the Clouds,1,0,4.49,1
2093020,Lonely White,4,0,2.69,4
1945230,小虎传：大菠萝深渊,9,0,5.39,9
1681880,NHRA Championship Drag Racing: Speed For All,6,27,44.99,-21
2124770,Tuin,5,1,4.99,4
2093420,Making Lovers After Stories,14,0,16.19,14
1948780,First Time in Rome,1,0,5.59,1
2107810,Marine Survivors,4,1,0.89,3
2106820,Picot Ether,0,1,6.29,-1
1198850,How to Build a Magnificent Kingdom,34,12,22.49,22
1588700,Race me now,5,2,9.59,3
2114370,Takoyaki Party Survival,25,2,2.69,23
1841070,Bhop Craze,9,0,5.59,9
2105460,Scorphius,1,1,9.99,0
1796200,Who's Who?,84,25,4.99,59
2069710,Finding Ice,3,0,8.49,3
1685940,Highway Rampage,4,0,4.19,4
1890610,Headpunk: The Comic-Style Battle Chaos,4,0,2.99,4
1933780,My Divorce Story,5,1,7.19,4
1973620,Go To Heck,2,0,4.49,2
1266700,Destroy All Humans! 2 - Reprobed,446,83,39.99,363
1970060,Tomboy Adventure,20,2,11.99,18
1972910,修仙者黎明,3,7,1.94,-4
2074440,Master of the Tattooverse,4,0,11.99,4
1469170,Commandos 3 - HD Remaster,40,29,17.99,11
2079020,Sippin Hot Blickety Block N Bop Those Bad Battle Boys Down To Size Supreme,7,0,4.24,7
1866420,La Pucelle: Ragnarok,18,3,19.99,15
1866430,Rhapsody: A Musical Adventure,15,1,19.99,14
1071140,ORX,164,34,17.99,130
2118570,Hear Your Path,10,2,0.79,8
1838740,Doxxed,9,2,2.99,7
1350200,IMMORTALITY,116,30,17.99,86
1599020,Tinykin,246,4,22.49,242
2093900,Island Cities - Jigsaw Puzzle,26,1,1.39,25
2083280,FAST FOOD SHOP ONLINE,2,3,2.54,-1
1465610,World Fighting Soccer 22,6,0,5.99,6
1708520,F1® Manager 2022,1894,782,54.99,1112
2096710,"I Can't Hear Your Words, So I Want To Listen To Your Heart",4,0,4.49,4
1888100,Cleaning The System,6,0,2.99,6
1659600,Teenage Mutant Ninja Turtles: The Cowabunga Collection,132,32,39.99,100
1162990,ZOR: Pilgrimage of the Slorfs,11,0,14.39,11
2054060,徹夜報告書 | Midnight Report,2,0,5.39,2
1726760,Curse Crackers: For Whom the Belle Toils,19,0,14.99,19
2083580,Oblige Of CHAOS,1,0,19.99,1
1763180,Wormatozoa,1,0,5.59,1
1979320,Amber City,12,0,12.59,12
2121840,江山如画,2,0,6.0,2
1972360,Cryptr,2,0,9.99,2
1154830,Scathe,59,42,22.49,17
1409530,Neophyte,112,5,2.99,107
1960270,Lootun,43,0,4.99,43
1842510,Mechanibot,19,1,2.99,18
1408610,Call of the Wild: The Angler™,1014,1397,29.99,-383
1934180,Hot“Sento Girls”and love,5,0,12.79,5
1771360,Gerda: A Flame in Winter,18,0,17.99,18
1372110,JoJo's Bizarre Adventure: All-Star Battle R,1267,247,49.99,1020
2123030,Idle magic herb,2,5,3.49,-3
2104780,Spooky Mansion Manager,6,0,9.99,6
2026880,Deadly Night,26,3,8.99,23
2123020,Across The Globe,1,0,12.59,1
2116850,Another Farm Roguelike,6,0,2.54,6
1117350,GALAHAD 3093,16,4,21.24,12
1969820,Legacy of Sin blood oath,14,0,19.99,14
1934700,Drifting Kings,3,0,11.99,3
1748230,RESTLESS SOUL,7,2,11.99,5
2123800,TheTravelGame,4,0,0.99,4
1547860,EBOLA 3,38,8,12.74,30
1500280,Spellbound : The Magic Within,1,0,18.99,1
1463010,Tank Mechanic Simulator VR,5,1,17.99,4
1590010,Re-Spawn Tournament,2,0,7.99,2
1454730,Chenso Club,24,2,15.99,22
2013330,BTank,9,1,1.19,8
1960570,Plank Road,2,0,4.79,2
2096560,The Top,1,0,4.99,1
2106770,Morris Cave,14,0,0.79,14
1592360,Kitten Burst,3,0,22.49,3
1944670,WorldMaker,6,0,7.99,6
1324340,Made in Abyss: Binary Star Falling into Darkness,175,143,59.99,32
1982130,Kraino Origins,2,0,9.99,2
2124810,İfrit,1,0,10.19,1
2069160,Platfuzzles,2,0,5.99,2
1918540,The Ramen Sensei,22,1,8.99,21
1609780,Invader TD,21,1,3.49,20
1650860,Chambers of Devious Design,39,4,10.79,35
1150760,Gloomwood,1658,105,17.99,1553
2113580,Haste-Miner 2,0,1,1.59,-1
2122640,a survivor girl,0,3,2.79,-3
2114810,Tetris Girls,5,4,1.49,1
2125400,Snuff,7,0,10.79,7
1705180,"Gunner, HEAT, PC!",608,58,26.99,550
1944790,Train Sim World® 3,303,70,39.99,233
1967510,Railbound,146,8,11.69,138
1401590,Disney Dreamlight Valley,1071,73,29.99,998
1988540,The Zachtronics Solitaire Collection,65,2,9.99,63
2110510,DREAM LOGIC,31,3,4.49,28
1123360,In Retrospect,10,0,3.59,10
1494280,Beat Stickman: Beyond,7,1,5.99,6
2122190,From atom to modern,4,0,3.99,4
1664220,TRAIL OUT,387,103,17.99,284
1848590,Kaichu - The Kaiju Dating Sim,17,0,8.49,17
2116930,Mozart Requiem,1,3,29.99,-2
2103640,Axis Football 2023,65,5,19.99,60
1897740,Chrono Survival,9,3,2.69,6
938710,SKYRAID,2,0,17.99,2
1994720,Escape From Meat City,8,0,4.96,8
1595050,PBA Pro Bowling 2023,7,2,29.99,5
1904730,Adventure Academia: The Fractured Continent,5,15,35.99,-10
914890,Nine Noir Lives,13,0,19.99,13
1615740,Machina Blade,17,5,10.79,12
1111590,Linked Mask,8,9,8.79,-1
2099400,Odd Guy Meets Odd Farmers - Comedy BL Yaoi Visual Novel,1,0,3.99,1
2123320,ClearIt 13,1,0,3.59,1
1919590,NBA 2K23,583,852,59.99,-269
1283400,Steelrising,582,238,49.99,344
1884570,The Gallery,6,2,14.99,4
1141580,Taiji,109,4,19.99,105
2009420,Zaxterion: Space Frenzy!,1,0,8.09,1
1156380,One Dreamer,61,2,13.59,59
1293730,Broken Pieces,50,4,19.99,46
2026290,Military Attack,0,1,2.24,-1
1528330,Mages Defense,4,0,10.79,4
2114830,Belt Colony,1,1,15.99,0
1962030,Blade Jumper,3,1,6.99,2
1827690,Chemists: Area of infection,9,1,11.99,8
2074560,Mr.Brocco & Co,21,0,4.79,21
2133950,Living Legends: The Blue Chamber Collector's Edition,1,0,13.99,1
1823190,A Violent Revelry,29,10,13.91,19
2119050,Idle Vikings Clicker,2,0,1.69,2
2114790,AIdventure,1,0,10.8,1
1155970,Roadwarden,229,7,9.89,222
1959530,Extra Case: My Girlfriend's Secrets,19,0,2.99,19
2016580,Deneb: Across the Stars,11,1,5.59,10
1964760,WFO World Football Online,1,0,13.49,1
2116800,モノマギア・カンタービレ,1,0,17.99,1
2001360,Mystical Riddles: Behind Doll’s Eyes Collector's Edition,1,0,13.99,1
1696080,Deadwater Saloon,68,25,15.99,43
1890740,Voice of Cards: The Beasts of Burden,16,2,29.99,14
2126700,Double Trouble,2,0,2.69,2
1718130,SCP: Secret Files,856,93,13.49,763
1897050,VARIOUS DAYLIFE,14,20,28.99,-6
1960590,I Am Sakuya: Touhou FPS Game,116,23,6.79,93
1558930,Little Orpheus,50,10,11.69,40
1714350,Badlands,2,5,14.99,-3
1556790,Isonzo,1650,389,26.99,1261
1839510,RPG Time: The Legend of Wright,43,2,29.99,41
595500,Freedom Planet 2,384,14,22.49,370
2129290,Scary School Simulator,2,5,5.99,-3
1829450,Dr. Kobushi's Labyrinthine Laboratory,7,0,11.99,7
1824130,Outside the Window,8,0,0.84,8
1564220,Q.U.B.E. 10th Anniversary,25,1,13.39,24
2125420,Zorbus,14,4,5.99,10
1726400,The Death | Thần Trùng,2009,117,5.99,1892
2132040,Catherine Ragnor - Blackbeards Fury,2,0,5.39,2
2058180,Judgment,635,31,39.99,604
1941510,Adventures of the Old Testament - The Bible Video Game,26,3,4.99,23
1121640,The Wandering Village,819,87,22.49,732
1160920,Food Truck Simulator,233,122,17.99,111
1702840,Paradox of Hope VR,142,13,16.99,129
1636660,Absolute Tactics: Daughters of Mercy,33,13,22.49,20
2062550,hololive ERROR,148,18,9.99,130
2135580,Again and Again,9,0,4.49,9
2101350,BLACK SHEEP TOWN,14,1,24.99,13
2129720,GUILTY,2,0,9.99,2
1061910,Metal: Hellsinger,2170,54,29.99,2116
1983580,There Swings a Skull: Grim Tidings,7,0,4.88,7
1379960,Grid Force - Mask Of The Goddess,7,0,19.99,7
1170080,Foretales,102,14,17.99,88
1080450,Wayward Strand,17,1,17.99,16
2026340,Unichrome: A 1-Bit Unicorn Adventure,3,0,14.99,3
1932670,NEVERLAND,1,3,4.99,-2
1426050,Fractured Online,88,162,25.99,-74
1723530,Stones Keeper,25,7,14.44,18
2131050,Handyman,0,2,2.99,-2
1764660,FROM FEAR,14,8,12.99,6
1647770,Ankora: Lost Days,2,2,15.99,0
2075050,Boom Slingers,6,0,6.29,6
1734680,INCISION,96,3,12.74,93
1725360,looK INside - Chapter 2,7,0,6.29,7
2076810,Further Still: Survivors,3,0,3.99,3
1132980,There Is No Light,193,74,22.49,119
2021690,Sakura Alien 2,3,0,7.49,3
1602080,Soulstice,238,70,39.99,168
1743850,HYPER DEMON,510,28,14.99,482
2138780,CashGrab,19,2,2.6,17
1924710,Night Janitor,11,0,2.99,11
2067920,Rogue : Genesia,476,23,2.69,453
2137570,Cairn Stone Balancing,2,3,6.39,-1
2060130,Return to Monkey Island,2667,184,24.99,2483
2115060,Magic Kingdom,10,1,14.99,9
2111630,JR EAST Train Simulator,188,69,9.99,119
2133490,Live Cycling Manager 2022,0,1,9.99,-1
1332660,Super Punch Patrol,3,1,5.39,2
1276810,The Outbound Ghost,100,19,15.99,81
1273400,Construction Simulator,1304,378,34.99,926
2129200,Silen House,5,5,4.49,0
2141990,魔塔三国之逆乱时空,5,0,2.99,5
1258520,AST-Hero,4,0,4.49,4
1949010,Room 301 NO.6,47,1,3.99,46
1574900,Salt 2: Shores of Gold,211,27,16.99,184
2120510,Simple Builder,1,0,0.59,1
2091930,2MD:VR Football Unleashed ALL✰STAR,6,0,12.74,6
1896700,Wylde Flowers,76,2,24.99,74
1951700,Areigna Tactics,1,0,7.99,1
2128400,Code:29,2,2,4.79,0
1957230,Employee of The Month,7,0,9.99,7
2080340,European Football Dynasty 2023,3,0,7.99,3
1692340,Unknown Number: A First Person Talker,12,0,14.99,12
1382980,Fech The Ferret,5,0,22.49,5
1851020,River City Girls Zero,27,5,14.99,22
1980000,Made Beaver,2,0,19.99,2
2009460,War of Wizards,8,1,15.99,7
1935430,Cowboy Hell,2,1,2.99,1
1080020,Electrician Simulator,283,56,14.39,227
2087350,Climb and Fight: Mafia,10,1,1.59,9
1399080,The DioField Chronicle,131,123,59.99,8
1513660,Stalked,1,1,8.99,0
1039100,No Place for Bravery,40,13,19.99,27
1707220,Chicken Fall,22,0,5.39,22
1337920,Serial Cleaners,54,13,22.49,41
1969430,Desert Revenant,6,0,14.99,6
2119730,Arcane Arts Academy 2,1,0,9.74,1
2125580,锻灵ElementForger,7,0,3.19,7
2004370,Sinner 97,7,0,4.99,7
1297270,Programmer Dungeon Knightress,5,1,6.79,4
2123420,Vilomah,9,0,2.69,9
1337760,Potion Permit,401,158,19.99,243
2134120,Super Anime Waifu BBQ Simulator,1,0,1.99,1
1657630,Slime Rancher 2,5720,241,29.99,5479
840880,Camped Out!,1,1,19.99,0
2091680,Tap the Blocks,1,0,1.99,1
2096800,Steel Saviour Reloaded,3,1,5.99,2
776660,Smooth Operators 2,3,0,13.59,3
2056410,Alien Time,1,0,1.79,1
1269640,Beacon Pines,166,4,17.99,162
2097180,OxU,8,0,1.59,8
1329500,SpiderHeck,510,56,13.49,454
1497330,Bad Way,16,4,12.74,12
2120810,The Peak Climb VR,0,1,19.99,-1
1189730,Tales of Tomorrow: Experiment,5,0,7.99,5
1721440,DreamWorks Dragons: Legends of The Nine Realms,1,0,49.99,1
1709510,Remoteness,15,16,19.99,-1
1441550,Regular Human Workshop,7,1,7.49,6
2142210,Project Alex,1,4,2.09,-3
2109640,Cross Concerto,32,2,22.49,30
2118910,The Chaput's Baby,6,1,5.99,5
1679210,The Spirit and the Mouse,95,1,19.99,94
1266430,Lost In Fantaland,88,9,11.89,79
2106080,Infinimine,6,0,19.99,6
1954200,Kena: Bridge of Spirits,726,68,29.99,658
1176470,Terra Invicta,835,158,35.99,677
1773180,The Matriarch,129,40,4.49,89
2145550,CyberHeroes Arena,16,1,2.69,15
1831160,Monkey Barrels,2,0,14.99,2
1189100,Rise Of The White Sun,15,1,13.49,14
1966700,Windfolk: Sky is just the Beginning,27,3,11.69,24
1557410,BLACK WITCHCRAFT,41,16,17.99,25
2138480,Capsule Rush,3,0,1.79,3
1765520,Flippin Misfits,9,2,4.99,7
1602110,Kredolis,19,16,19.99,3
1898430,HORDE Survival,12,6,12.59,6
1998260,Ancient Aliens: The Game,2,1,19.99,1
2123120,Ultimate Protector,7,1,2.99,6
2143950,Don't Shit On My #!$@& Roof,29,2,2.69,27
2000270,Dual Universe,82,78,14.99,4
1081450,Criminal Dissidia,39,21,11.69,18
801950,CryptoRIG,4,0,6.29,4
1637320,Dome Keeper,1017,155,16.19,862
1942280,Brotato,768,29,4.99,739
1728840,Beneath the Mountain,35,16,19.99,19
1911780,Lost Fleet,14,9,18.74,5
1532460,The Fridge is Red,39,28,14.99,11
1374970,Moonscars,152,45,19.99,107
1272010,Destroyer: The U-Boat Hunter,91,26,26.99,65
2058380,Procemon: You Must Catch Them,3,1,7.99,2
2139500,Waste Life 1 消耗阳寿1,2,0,0.89,2
1939790,Paper Bride 3 Unresolved Love,120,12,8.99,108
2112520,her tears were my light,25,0,2.69,25
1727180,NeverAwake,34,0,16.99,34
1998530,Yoiyami Dancers: Twilight Danmaku Dancers,116,0,8.49,116
1319850,ValiDate: Struggling Singles in your Area,15,2,12.44,13
1812060,Yokai Art: Night Parade of One Hundred Demons,128,23,3.99,105
1182310,The Excavation of Hob's Barrow,121,4,13.49,117
2132570,Total Factory,3,0,14.99,3
1552220,LakeSide,20,10,13.49,10
1902790,刻印战记：冰冻之剑 RE,70,14,6.39,56
1898560,Pillars of Light,2,0,15.29,2
1824150,Tales of Terror,4,7,4.49,-3
2144360,Pretty Girls Tile Match,7,0,3.99,7
2142030,Fishton: A Town to Remember,4,1,15.29,3
1732090,Words Can Kill,6,0,6.79,6
2146600,I commissioned some bees 7,2,0,1.69,2
1569200,Brewmaster: Beer Brewing Simulator,158,13,16.19,145
2065520,Endless Nightmare,4,0,15.99,4
2074910,Photogenic Minds : Identity,5,2,19.99,3
513910,C.A.R.L.,4,0,9.89,4
2058370,Jack Big Chin: Alien Invasion,3,0,2.09,3
1474390,Broken : Paranormal investigation,2,4,11.19,-2
1500620,Tavern Tales: Tabletop Adventures,1,0,19.99,1
2144180,勇者联盟星耀传说,1,0,5.59,1
1811260,EA SPORTS™ FIFA 23,1997,3934,69.99,-1937
2088070,Zombie Hunter,0,1,2.69,-1
1592190,BONELAB,3412,1007,39.99,2405
1575750,ShapeVS,4,0,6.29,4
1493940,Airoheart,4,2,26.99,2
1795010,Funtasia,4,1,8.99,3
2153390,西部幻想 WestFantasy,2,0,13.99,2
1748330,Sand: A Superfluous Game,2,0,12.74,2
1267070,Monorail Stories,6,0,9.89,6
1427340,Witchy Life Story,37,3,17.99,34
1573630,Choice of Life: Middle Ages 2,19,0,6.29,19
1720510,Mass Harvest,4,3,29.74,1
2020670,StarMaker VR,0,1,19.99,-1
2106450,Brave survivors,14,2,2.39,12
1934990,Senpai and the Mysterious Dungeon,16,0,12.59,16
2093270,Death in the Night,9,0,5.99,9
2116920,Runic Survivor,6,0,2.99,6
1873440,I Am Two People,3,1,5.39,2
1930640,Lost2,186,11,14.39,175
1353830,Horrors of Space,6,3,12.74,3
1491950,BrightSeeker,2,0,10.79,2
1877800,ARMS DOLL,5,0,17.09,5
2113540,梦魇：无归 Nightmare without return,13,0,5.59,13
1787690,Blade Crusade,1,0,13.49,1
2153770,Coin Flipper,8,0,2.69,8
1789480,Marauders,2933,746,29.99,2187
1473760,Beyond the Storm,4,3,8.39,1
2070540,Shogunaria,4,0,5.59,4
2114440,Elland: The Crystal Wars,2,0,14.39,2
2103350,Nick Bounty - The Goat in the Grey Fedora: Remastered,8,1,2.99,7
981830,GIGABUSTER,3,4,13.49,-1
2157540,Lost Amulets: Mystic Land,2,0,5.09,2
1839940,Dakar Desert Rally,185,143,39.99,42
2122550,Mushroom Card RPG,12,0,15.83,12
2093380,Noclipped,7,1,2.69,6
2142100,A Smooth Game (Unlike... Life),2,0,1.99,2
2145080,Ballspell,1,0,4.99,1
2149480,Card Cowboy,7,0,2.69,7
437440,Lord of Rigel,11,2,17.99,9
1228500,1428: Shadows over Silesia,24,1,29.99,23
2006140,Withering Rooms,25,0,14.99,25
2109460,VillageRhapsody,190,15,2.99,175
1811740,The Plague Doctor of Wippra,30,1,9.99,29
1942360,Breakers World,0,2,9.99,-2
1388350,Parallel,6,0,24.99,6
1688080,Aeternum Vale,18,1,10.79,17
2130940,Puzzle Park,6,1,6.74,5
2089460,Demong Hunter,3,1,7.64,2
1872500,Rivalia: Dungeon Raiders,6,0,11.99,6
1963450,Wands Alliances,3,2,17.99,1
1810270,Blood Nova,22,0,10.19,22
2157670,Big Adventure: Trip to Europe 2 - Collector's Edition,1,0,4.49,1
1582410,Manafinder,20,0,11.89,20
1610500,Bibots,14,19,11.69,-5
1309090,Barold,13,0,3.99,13
2142860,Neuro Horror,12,0,0.89,12
1444710,FireJumpers Inferno,5,2,0.0,3
2114360,Maze Blaze,3,2,6.99,1
1875160,The Blunderbuss,1,3,15.99,-2
2153610,Virtual Sailor NG,2,0,39.99,2
2119940,Her World,35,1,14.99,34
1704730,Vacant Kingdom,10,0,7.19,10
950620,Priest Simulator,106,4,15.99,102
2140870,Stunt Legends,1,0,2.99,1
1338730,Paramount Hero,1,2,10.04,-1
1463830,Vostok 2061,15,1,8.99,14
1259580,Nonno Lorenzo,5,0,12.99,5
1734250,Triple Take,16,0,5.59,16
2154000,TOKKI,2,0,1.99,2
1986250,ヒロイン忍法帖 姫影・ 壱／Pretty Ninja HIMEKAGE_01,2,2,3.99,0
1492070,Sker Ritual,125,43,13.49,82
2066030,The Grizzled: Armistice Digital,1,0,6.99,1
2163050,夢隠し - Dreamed Away,2,1,2.99,1
2149880,Hallway Defender,2,0,4.49,2
1923070,Deadland 4000,6,0,8.99,6
1961950,CHAOS;HEAD NOAH,59,8,24.99,51
924530,One Last Try,1,0,3.59,1
1563130,SuperPower 3,62,719,26.99,-657
2027130,Protect My Cheese,5,0,3.99,5
2003220,TitTok 3,24,0,1.19,24
1978100,Grand Prix Story,21,1,8.09,20
2055740,DnD Adventure: Rogue's Choice,3,0,4.49,3
1891010,Expansion Core,3,0,4.49,3
1477700,Project Wunderwaffe,119,56,13.49,63
2084720,Home Run High,11,2,8.09,9
2066950,Quadrata,28,0,1.99,28
1967480,One Many Nobody,16,0,11.99,16
2100050,Spell Defender,39,2,2.54,37
2089920,Shadow Heroes,25,2,3.19,23
2061230,Chasm: The Rift,77,7,17.99,70
2152690,Actua Soccer 2,4,0,7.19,4
1867190,Wordle 5,20,5,0.59,15
2072140,Epic Astro Story,6,0,8.09,6
1832950,One More Gate : A Wakfu Legend,75,12,18.99,63
2144460,Path to purge,8,0,2.99,8
1731070,Asterigos: Curse of the Stars,379,96,31.49,283
2084930,Ever Seen A Cat? 3,29,0,2.24,29
1744330,No More Heroes 3,100,16,44.99,84
1774630,Hallowlands,2,0,8.99,2
2013080,Unders_core,13,1,10.19,12
1856030,Fresh Start Cleaning Simulator,97,2,9.99,95
1158160,Coral Island,1323,161,24.99,1162
1993900,Not Your Mama's Autobattler,4,1,11.99,3
1220170,Eville,98,21,13.49,77
1768280,Ozymandias: Bronze Age Empire Sim,173,14,11.99,159
1775860,Space Roguelike Adventure,11,0,4.49,11
2150090,Fury Turn,9,0,11.04,9
2108600,Potato Survival,51,0,3.59,51
2083840,Her Name Was Fire,71,31,3.59,40
2142150,Crazy Click Thursday,0,1,1.39,-1
1613580,ARRIVAL: ZERO EARTH,26,0,5.39,26
1924810,Kamiwaza: Way of the Thief,22,4,39.99,18
2078210,Bulls and Cows,1,0,1.99,1
1627310,Ralph and the Blue Ball,33,0,0.69,33
1745280,Magitek VR,7,1,13.49,6
1996600,Byte Lynx,24,0,17.99,24
1384940,Egression,23,0,16.99,23
1096140,Timemelters,20,1,17.99,19
1890680,Milk Girl -Sweet memories of summer,8,9,13.49,-1
2027560,Valkyrie Champions,9,2,3.39,7
2012890,Dungeon Liberator,0,2,5.09,-2
2016080,A Hero's Rest,21,3,22.49,18
1324130,Stranded: Alien Dawn,274,52,29.99,222
2139310,Endless,6,1,0.99,5
1380910,Stardeus,175,13,29.99,162
1968320,Relapse,69,5,4.79,64
1950440,Mage and Monsters,124,11,3.19,113
1898290,LEGO® Bricktales,111,12,29.99,99
1710620,Winter Games 2023,5,2,19.79,3
2158240,The Trench,8,1,3.99,7
1968570,The Quintessential Quintuplets OMOIDE VR ~ITSUKI~,10,2,24.99,8
1311710,Somber,7,0,7.99,7
1684930,CULTIC,680,6,9.99,674
1580520,Lost Eidolons,235,60,34.99,175
2077080,Pitstop in Purgatory,5,0,4.49,5
2074530,SHAFTED,4,0,3.99,4
2167800,Idle Cyber Dungeon,5,2,3.49,3
2112200,古巫竞技场 Ancient Witch Arena,40,7,2.69,33
1728390,Phantom Thief Mew's Secret Prima,2,0,6.1,2
1969440,Sunday Gold,62,4,19.79,58
2165120,Pogo Rage: The Awakening,2,0,8.99,2
1718570,ASTLIBRA Revision,168,13,22.49,155
2095860,异界双子 -Twin Souls-,1,0,1.99,1
1677770,The Case of the Golden Idol,287,1,16.19,286
1931690,Azure Striker GUNVOLT 3,62,5,26.99,57
1880840,Dead End City,9,0,10.04,9
1276760,DRAGON BALL: THE BREAKERS,659,334,19.99,325
865680,The Eternal Cylinder,45,13,19.99,32
2019840,Atama,11,0,17.99,11
2154090,Vs Chat Pack,4,0,13.49,4
1488430,Fueled Up,26,9,17.99,17
1225790,Heat and Run,23,0,10.99,23
2164780,Tile Town,3,0,5.39,3
1588010,PGA TOUR 2K23,109,73,59.99,36
1759340,The Death Tree,3,0,6.02,3
2123390,CyberBlocker Complete Edition,2,0,8.99,2
1850510,TRIANGLE STRATEGY,155,26,59.99,129
2134630,Hot Cleopatra,5,0,0.84,5
1171520,Gravity Chase,3,2,8.99,1
2167860,Dungeon & Adventure,7,0,17.99,7
1878720,Gnome Online,16,3,11.99,13
1508000,Venice 2089,1,1,14.99,0
1253010,Stella Pastoris,2,0,7.99,2
2065620,IndividuaLand,1,1,5.99,0
1228320,Dungeon Looter,3,1,8.49,2
1151130,Dark Chess,8,0,9.34,8
1608660,Overhaul,23,0,9.59,23
2095180,Numeral Lord,6,0,1.79,6
1847230,Island Berry,0,1,8.99,-1
2133440,Pixelmancer,4,0,2.39,4
1637950,Cloaks and Capes,4,0,7.99,4
2144470,Arata Haunted Asylum,1,0,1.19,1
1835970,ICEwall,4,0,7.64,4
1655220,Star Trek Prodigy: Supernova,3,1,49.99,2
1304160,Spellbearers,2,0,13.99,2
698670,Scorn,2867,1214,35.99,1653
2113230,Oil-Manager,2,0,17.99,2
1281190,The Shadow Government Simulator,18,1,8.99,17
2169620,Frog In the Well,2,0,0.89,2
2061300,The Way Home: Pixel Roguelike,15,1,6.99,14
1806960,Mythos: Sudoku,8,0,7.99,8
2171650,Walking In The Abyss,8,0,0.59,8
2168000,Trader of the Night,4,1,6.99,3
1016180,Terror of Hemasaurus,190,11,10.39,179
2065990,FREM Sprite32!,2,0,5.39,2
2138400,Slime Hero,5,1,3.99,4
1687590,Mars Base,17,10,15.99,7
1749430,Reefland,29,0,3.39,29
965990,Destiny's Sword,6,1,7.64,5
1852180,Undercraft,0,1,15.99,-1
1332450,Open The Gates!,30,1,11.69,29
1182900,A Plague Tale: Requiem,1411,190,49.99,1221
1874490,Potionomics,1166,201,22.49,965
1965920,Cthulhu Mythos ADV 闇に囁く狂気,7,1,9.99,6
2141730,Backrooms: Escape Together,109,18,3.99,91
1860330,Cubelander,3,0,1.19,3
2164320,Oathbreakers,5,0,15.99,5
1676130,Deadlink,234,15,15.99,219
1378990,Crash Bandicoot™ 4: It’s About Time,138,4,39.99,134
1989150,Thread,4,0,10.99,4
1532710,Lucy Dreaming,47,0,16.14,47
2132450,Spectator,6,0,11.04,6
2075770,Coin Blitz,0,1,6.29,-1
2016110,Blaze in Space: Beat a-Maze,11,0,13.49,11
2008050,Right and Down,56,6,7.99,50
917140,Amberial Dreams,12,0,5.94,12
1466350,Jennifer Wilde: Unlikely Revolutionaries,2,0,14.39,2
1531490,Harmony's Odyssey,32,1,11.99,31
2012160,Stranded Nightmare,41,1,9.99,40
959860,The Valiant,70,35,35.99,35
1647550,NEO: The World Ends with You,117,2,44.99,115
1766100,The Last Hero of Nostalgaia,128,10,24.99,118
1722110,CAPTAIN STARONE,1,0,8.99,1
2012520,Aero Striker - World Invasion,16,0,11.99,16
1556980,Internet Generation,588,144,19.99,444
1659420,UNCHARTED™: Legacy of Thieves Collection,2083,228,49.99,1855
1582180,Hello Puppets: Midnight Show,9,0,19.99,9
2074800,Richman 11,110,117,17.09,-7
2147640,Chacara,2,0,2.69,2
1850960,The Jackbox Party Pack 9,55,15,26.99,40
2149870,Closer To Home,4,0,7.99,4
1768780,Of Blades & Tails,32,1,11.69,31
2166520,THE TRADER -Goods Dealer Simulator-,1,0,10.49,1
2083540,Disc Golf Online,5,1,13.49,4
1114950,Learn Japanese RPG: Hiragana Forbidden Speech,2,0,14.99,2
2136700,ソラナと陽の工房,1,0,11.04,1
1454970,New Tales from the Borderlands,64,52,39.99,12
1781960,Sigil of the Magi,6,0,13.49,6
1798670,Horoscopicus,5,0,5.09,5
1506680,Horror Tycoon,30,8,13.49,22
1687950,Persona 5 Royal,3588,102,59.99,3486
2102070,无极修仙传·序章,3,0,3.74,3
2059670,Moss: Book II,19,1,29.99,18
1521070,The Pegasus Expedition,17,5,16.99,12
1903720,With Good Intentions,13,1,12.74,12
1948210,Mineralis,1,0,8.99,1
1734230,WHATEVER,2,0,7.99,2
2121910,Bunny Eureka,1,0,2.69,1
1324530,"Warhammer 40,000: Shootas, Blood & Teef",356,58,17.99,298
1506440,Batora: Lost Haven,53,11,19.99,42
2159180,Hidden Shapes - Trick or Cats,13,0,1.49,13
1582500,Purple War,18,2,17.99,16
1730650,REQUISITION VR,78,19,19.99,59
1910300,JoJo Siwa: Worldwide Party,1,0,39.99,1
2106720,Port Cranes : Container Age,4,1,5.99,3
2005210,Void Scrappers,73,3,3.59,70
1179080,FAITH: The Unholy Trinity,279,6,13.49,273
1302230,Dead Containment,5,1,8.99,4
2066490,Robot Resistors,6,0,4.99,6
2123050,TAKIBI,1,2,3.19,-1
2165030,DEATHWATCH,10,0,5.94,10
1665190,Monster Prom 3: Monster Roadtrip,380,2,10.79,378
1496790,Gotham Knights,1942,1057,59.99,885
2081420,Witch Amelia,6,0,10.39,6
2085320,Meow Defence,1,0,2.99,1
2000040,Space Menace,0,1,11.99,-1
2105130,Observo,1,1,10.99,0
1716830,Sumo Seals,1,0,17.99,1
1800790,Father's Day,8,0,11.04,8
1993010,Clown Theft Auto: Woke City,8,4,0.79,4
2173200,Age of Heroes: The Beginning,1,0,6.99,1
2158130,Deadly Harvest,16,0,0.89,16
1594460,I See Red,28,3,9.59,25
799600,Cosmoteer: Starship Architect & Commander,1240,40,17.99,1200
2128300,Dungeon in a Bottle,5,0,11.99,5
2124780,Endoparasitic,721,54,7.49,667
1912330,12 Labours of Hercules XIV: Message in a Bottle,1,0,9.59,1
2014650,PHOBOS Project,5,1,5.99,4
2176640,Gloomy Tales: Horrific Show Collector's Edition,0,1,12.59,-1
2118130,Chicken Feet,72,10,5.09,62
1125890,Party Maker,31,9,13.49,22
1309760,Last Gang Standing,9,0,13.59,9
1940090,Murder Is Game Over,7,0,3.99,7
2174710,Broken In Time,2,0,0.99,2
2150950,Paranormal Observation,6,1,5.09,5
2154820,"EL PASO, NIGHTMARE",28,2,4.49,26
1925970,SIMULACRA 3,49,22,9.99,27
2175450,Rhythm Stones,1,0,8.09,1
1740660,Miraculous: Rise of the Sphinx,11,12,44.99,-1
2118540,My Big Sister: Remastered,13,0,5.99,13
2167750,The Monster Within Me,6,1,7.79,5
1992110,FIND YOUR WINGS,3,0,3.59,3
1760300,Jousting VR,2,1,8.99,1
529340,Victoria 3,7506,4617,49.99,2889
2140700,SO BELOW,4,0,17.09,4
1978460,Death's Playground,14,0,7.99,14
1487270,Last Command,345,4,13.49,341
2099430,Dork,3,0,14.99,3
1870630,Virtual Virtual Reality 2,2,3,17.99,-1
1548910,Life in Willowdale: Farm Adventures,2,3,29.99,-1
2090700,WikiArena,18,0,1.79,18
1897630,Garbage Pail Kids: Mad Mike and the Quest for Stale Gum,6,0,8.99,6
1797930,Para Eyes,22,0,9.99,22
1886070,Bonding Ambivalence,3,0,14.99,3
1868140,DAVE THE DIVER,557,27,17.99,530
1856750,Relayer Advanced,16,8,44.99,8
1300920,Ghost of Dragon,186,119,17.99,67
2173550,冒险与魔法,7,0,1.79,7
1461930,Robotry!,7,0,9.99,7
2157100,The Villager and the Werewolf - A jigsaw puzzle tale,11,0,1.19,11
1821070,Grey Block,2,0,19.99,2
2165610,Mosaique Neko Waifus 5,148,5,2.39,143
1691620,Titanium Hound,3,0,14.99,3
1942300,Outer Darkness,0,1,2.69,-1
2109700,Temple of Horror,20,0,7.99,20
2086380,Miss Kobayashi's Dragon Maid Burst Forth!! Choro-gon☆Breath DIRECTOR'S CUT,22,1,29.99,21
1971330,Stonegeon 迷石地牢,2,0,4.79,2
1900300,The Bad Son,6,1,10.79,5
1840730,Ancient Islands,5,0,8.09,5
2096790,Assassin's Vol.,30,15,1.79,15
1171320,Frog Detective 3: Corruption at Cowboy County,299,3,4.99,296
1424290,Project Colonies: MARS 2120,2,0,11.99,2
1898790,A Crown of Sorcery and Steel,4,2,5.39,2
2151430,NSG,3,0,5.59,3
1830450,Square Farm,2,0,5.59,2
1820570,Panic Porcupine,15,0,5.99,15
2167040,Pocket Witch,13,0,1.69,13
2181990,"Good Night, Peregrine",5,0,0.99,5
1714920,Charon's Staircase,5,1,22.49,4
1894730,Asterix & Obelix XXXL : The Ram From Hibernia,3,0,29.99,3
1599660,Sackboy™: A Big Adventure,246,27,59.99,219
1004370,Paper Cut Mansion,9,3,17.99,6
2051100,ALPHA-NIGHTHAWK,6,0,15.99,6
2177550,Jewel Match Twilight 2,1,0,6.29,1
2118580,SuperTotalCarnage!,22,7,2.39,15
1933820,SGS Korean War,8,3,23.99,5
2164880,Tilecraft,5,1,2.99,4
2007010,Welcome To The Backrooms,5,1,13.49,4
2177540,Jewel Match Twilight,2,0,6.29,2
2069310,RealFlight Evolution,4,4,69.99,0
1776380,STAR OCEAN THE DIVINE FORCE,364,163,59.99,201
2145560,Imaginefield 2042,0,3,0.59,-3
1938090,Call of Duty®: Modern Warfare® II,16018,12744,69.99,3274
1918040,Army of Ruin,98,16,3.59,82
1825160,The Backrooms,6,2,0.59,4
2152710,Actua Ice Hockey,0,1,7.19,-1
1807960,修真元界  XiuZhen Metaverse,1,0,11.99,1
2176140,云城异闻录,3,2,1.19,1
1901990,Machine Gun Fury,3,0,9.59,3
1957010,Undead Under Night Rain,1,1,7.49,0
1729250,Dashpong,5,0,8.99,5
2104560,SOWON,6,0,15.29,6
1394030,CESSPOOL,2,0,7.49,2
1566550,A Walk With My Dog,4,0,7.99,4
1757920,Astral Flux,5,1,8.99,4
1912900,Maximum Velocity,2,0,19.99,2
2150700,Magic Axolotl,13,0,2.99,13
2058970,For What Will Come,2,0,8.49,2
2115140,The Levels of Backrooms,1,0,10.49,1
2150820,Living With Dragons,0,1,10.79,-1
2170760,Saturn Quest: R. U. N. E. 3000,3,1,5.09,2
1347760,Clash II,11,1,24.99,10
2184970,Lost Amulets: Four Guardians,1,0,4.49,1
2179650,SPACE DUDES vs ALIEN DUDES,1,0,0.69,1
2063580,Trigger Henry,9,0,5.99,9
1777430,恋爱绮谭 不存在的真相,209,2,12.59,207
2158880,Tkium Underground,1,1,0.69,0
2117190,Spliced,2,0,5.24,2
2168450,DREAMWILD,17,1,6.79,16
2091520,Aftertime,2,3,2.99,-1
1439310,If Fusion Were That Easy,1,0,12.74,1
1460220,Evil Nun: The Broken Mask,183,7,13.49,176
2101110,Touhou Soujinengi V -The Genius of Sappheiros-,11,0,24.99,11
2096580,NekoNecro,13,0,13.49,13
2121480,The Silent Huntress,3,0,4.99,3
2057970,Rainy Butcher,28,7,4.79,21
2109440,Vajont VR,3,1,5.99,2
2181720,Scarlet Tower,85,12,4.24,73
2059480,Interrogation Simulator,4,0,1.49,4
2170090,Each Other,4,0,8.49,4
2182240,Dots in line,1,1,0.59,0
656830,Body of Evidence,4,4,15.99,0
1963990,Deliver Us From Evil (DUFE) - Masquerade,2,0,4.99,2
2009350,Out of Ore,39,13,14.44,26
2105660,I live under your house.,12,0,1.79,12
2113030,The Nameless,2,0,3.59,2
1418360,Lonesome Village,18,6,19.99,12
1108170,Plot of the Druid,23,0,14.99,23
1492730,DORAEMON STORY OF SEASONS: Friends of the Great Kingdom,55,4,49.99,51
2002200,Future Mirror,0,1,6.29,-1
2175700,Odd Woods,8,1,9.89,7
1967390,Lenny Loosejocks in Space,2,0,11.99,2
1619820,Operation: Pinkeye,4,2,16.99,2
1436410,ReThink 4,5,0,8.99,5
2185880,wurdweb,12,0,4.99,12
2157130,This is Hell,18,1,5.99,17
773750,Danger Forever,2,0,11.99,2
1544000,For a Vast Future,7,1,8.49,6
1937230,Shatter Remastered Deluxe,12,9,9.99,3
1973610,建安外史 The Tales of Jian An,22,10,16.19,12
1336490,Against the Storm,584,14,16.99,570
2103940,Skate Rift,7,1,4.49,6
1734540,PUPPETEERS,7,16,8.99,-9
1515210,The Past Within,1657,135,3.59,1522
2163790,Lighten Up,2,0,0.99,2
1799220,Malice,96,521,7.99,-425
2095120,S.E.C.U.,3,1,4.99,2
2007530,Spellbook Demonslayers,209,23,2.69,186
2183240,SUKUR,8,0,3.89,8
1252000,GOAL! The Club Manager,44,64,23.39,-20
2146520,Love Spell: Aslan's Story,2,0,5.99,2
700820,TFM: The First Men,114,43,24.99,71
1803400,Beneath Oresa,71,17,24.99,54
1704250,Pirated Code: Admin Edition,1,0,9.89,1
1067220,RoboCo,39,0,19.99,39
2188920,Angelic Wishes,1,0,1.59,1
1502190,From Space,331,187,11.99,144
1951940,Eschaton,8,0,2.69,8
2154230,AI: Art Impostor,21,16,4.99,5
2135780,Shin Galaxy - Alpha War,1,0,2.99,1
922620,Kingshunt,69,87,0.0,-18
2181710,Me With Me,4,0,0.74,4
1549440,MeiQi 2019,10,0,3.99,10
2065570,Silver Nornir,0,1,13.49,-1
2114070,Talon City: Death from Above,1,0,2.99,1
1709700,How to Say Goodbye,10,0,11.69,10
1953520,WRC Generations – The FIA WRC Official Game,241,68,39.99,173
347800,Ghost Song,195,18,19.99,177
1577250,The Chant,64,17,39.99,47
2083180,Cat Herder,15,0,3.99,15
1474740,Horse Tales: Emerald Valley Ranch,106,75,26.99,31
1371560,DarKnot,6,4,13.49,2
1730590,The Entropy Centre,216,11,22.49,205
2094190,苍白花树繁茂之时Blood Flowers,21,0,6.23,21
918780,Sector Sweep,6,1,2.69,5
2088340,Bratz™: Flaunt your fashion,36,8,39.99,28
2101480,Drunk: Relapsed,2,0,9.99,2
2188470,Save the Queen,1,0,6.29,1
2077650,Amok Runner,12,1,15.29,11
2187850,Minesweeper Arcade,1,0,2.39,1
2184110,SURVIVAL IN THE BACKROOMS,0,2,1.59,-2
2166120,Digit Factory,2,0,3.59,2
1886270,Juno 06,1,0,5.99,1
1728430,I wanna go home,1,0,3.19,1
1841200,Skullborn,15,3,10.79,12
787920,Running Fable,3,0,7.99,3
2094480,Senet,1,0,9.99,1
2055500,Repetendium,17,0,3.99,17
1622770,Doors: Paradox,37,1,13.49,36
1968300,Ambushed,2,1,6.29,1
1510070,Cliff & Field Tower Defense,12,1,5.59,11
1816300,HARVESTELLA,244,140,59.99,104
2001800,Spintales,2,0,8.99,2
1987330,Cyberpoly,0,1,9.09,-1
2088670,Puzzline,3,0,3.59,3
2179290,HerrAnwalt: Lawyers Legacy,111,29,4.79,82
2114500,伏魔天师,4,2,6.79,2
1965610,Froggie,13,0,0.69,13
1939560,镇邪,158,32,13.49,126
2162780,E.E.R.I.E2,10,2,6.99,8
1925830,轮回之理-MOBIUS THEORY,2,0,4.99,2
2146960,VOID,6,2,1.99,4
1848130,无限投影,53,21,0.69,32
1093840,NiGHT SIGNAL,9,2,9.99,7
986040,The Unliving,123,82,15.29,41
2053360,PUTRID SHOT ULTRA,10,0,2.99,10
1904540,Football Manager 2023,1471,226,47.99,1245
1932280,Medieval Fantasy Survival Simulator 2: Gladiator Edition,23,2,1.79,21
1237320,Sonic Frontiers,5721,331,59.99,5390
2095100,Nature Escapes,1,0,5.59,1
2183920,Cat Herders: Couch Coop Cat Corralling!,3,0,5.51,3
2135990,Ringlorn Saga,13,0,7.19,13
2184640,Drive West Coast,2,1,2.99,1
1978080,Is It You?™,6,0,4.99,6
2066020,Soulstone Survivors,2293,306,9.99,1987
2192650,Super Clown 3: Revenge,12,3,1.21,9
2154890,Survival Academy,26,9,3.39,17
1734370,Timewreck Tales: A Rogue RPG,2,1,15.99,1
1614550,Astro Colony,240,53,17.99,187
1937470,Franchise Hockey Manager 9,25,3,35.99,22
2120410,The Letter: Classic Edition,5,0,1.79,5
2115650,Xeno Command,15,0,4.49,15
1535100,Nadir: A Grimdark Deckbuilder,44,9,17.99,35
1285060,Winter Falling: Battle Tactics,28,1,8.99,27
1958240,TRUE SKATE™,12,5,19.99,7
2168490,Masarada Town Story,7,0,10.19,7
1629520,A Little to the Left,169,30,14.99,139
2157340,Meowjiro,82,18,4.99,64
1772260,The Video Game Machine,1,0,11.24,1
1681870,Cobra Kai 2: Dojos Rising,8,6,44.99,2
1981570,Land of the Vikings,165,34,17.99,131
1621000,Ultimate Waifu Battle Online,0,1,5.39,-1
2126620,Super DynoStory,6,0,10.79,6
1668190,Once Upon a Jester,22,0,14.99,22
2107650,Guardian of the jungle,1,0,1.39,1
1943370,Invercity,7,0,12.74,7
1558840,Path of Kami: Journey Begins,5,1,4.49,4
2186140,Early Worm,6,0,3.19,6
1936430,I.D.F.K.,0,1,8.99,-1
1053390,Kowloon High-School Chronicle,3,0,19.99,3
1918440,Championship Wrestling Promoter,3,1,17.99,2
2070550,A Castle Full of Cats,295,4,2.69,291
2113490,Mess Quest,8,0,4.79,8
2091720,Nightmare,3,2,4.24,1
1879030,Return the Backrooms,13,0,3.74,13
1968790,Alkali,12,0,10.55,12
1977910,Shinonome,5,4,16.14,1
1318970,This Way Madness Lies,14,0,8.99,14
1846030,HyperLeague Heroes,6,4,4.99,2
1613470,Roboplant,12,1,17.99,11
1701800,Lunistice,187,1,4.24,186
1975550,Skystrike: Wings of Justice,1,1,5.99,0
645720,Fabular: Once Upon a Spacetime,34,8,13.49,26
2147890,Demolish or Die,3,0,4.99,3
1617890,Imprisoned Hyperion,0,2,13.49,-2
1622040,Lila's Tale and the Hidden Forest,10,0,2.99,10
2065000,Chess Survivors,19,0,2.69,19
2105670,Single Player: Horror,1,1,5.99,0
1613670,Anglerfish,48,3,8.99,45
1364210,City Bus Manager,157,34,26.69,123
1849900,Among Us VR,429,159,9.99,270
2122490,机械兽：进化（Mechanical beast: Evolution）,1,4,4.99,-3
1654130,孙美琪疑案:雨儿胡同,24,6,3.59,18
2141720,Tower Numbers,5,0,1.49,5
1828540,九州风流,4,3,12.05,1
1451090,Tactics Ogre: Reborn,369,77,49.99,292
2201210,Cursor Engine,3,0,3.59,3
2171600,The Enemy Approached The Walls,1,0,0.69,1
1728180,Astral Shipwright,2,2,8.99,0
1975340,HAITENAI RPG,27,4,22.49,23
1963210,VALKYRIE ELYSIUM,99,31,59.99,68
2182450,Fairy Girl,5,0,0.84,5
1881120,Titan Station,17,0,14.99,17
2195200,Find The Key,0,2,0.99,-2
2182690,Gore Screaming Show,11,0,26.99,11
1919470,Atari 50: The Anniversary Celebration,34,1,39.99,33
2197500,Mining Copper,2,1,3.19,1
2078780,Lovelorn sanatoriumⅠ,344,71,7.19,273
2123100,Kitty May Cry,23,4,8.99,19
2013360,The Oregon Trail,45,19,29.99,26
1985350,Pixel Gangsters: Mafia Manager,1,1,8.99,0
1338580,McPixel 3,100,2,9.99,98
2167220,The Bible,149,22,10.04,127
1493520,Beat Hazard 3,76,4,17.09,72
1358840,Flat Eye,38,9,17.09,29
748020,TERRACOTTA,68,6,15.99,62
1671410,Somerville,162,113,22.49,49
1669330,残世界的鸢尾花,12,0,4.49,12
2155010,MindHunt,4,1,3.99,3
1723560,Ballads of Hongye,221,230,8.49,-9
1865060,14 Minesweeper Variants,59,1,5.94,58
1839050,HatMania,3,0,2.99,3
1266340,Arcane Waters,59,20,19.99,39
1205520,Pentiment,337,15,19.99,322
1732920,Bulanci,60,33,12.79,27
973230,We Who Are About To Die,697,93,19.79,604
1336180,Floodland,117,93,29.99,24
2181480,I Fought the Lawn,5,0,9.99,5
1782120,ZERO Sievert,1128,145,17.99,983
973070,Bound By Blades,32,2,9.89,30
1887010,Tiny Football,8,1,9.09,7
1982150,RWBY: Arrowfell,48,17,26.99,31
1492150,Primal Survivors,23,2,2.09,21
1733680,战国异闻录,36,9,13.49,27
2139800,Orcen Axe,5,0,3.99,5
943370,Bravery and Greed,104,17,19.99,87
1414650,EDENGATE: The Edge of Life,16,10,6.99,6
2150530,Rubble,2,0,8.99,2
1929900,Touhou: Dreamland of Infinity,37,0,17.99,37
1117200,Redemption's Guild,1,2,26.99,-1
1881420,Cardfight!! Vanguard Dear Days,160,17,69.99,143
2134640,Viking Heroes 3,3,1,4.24,2
1833490,GOODBYE WORLD,196,28,10.79,168
2142930,꿈을 빼앗긴 남자 - Dream invader,1,0,3.89,1
1738890,Naval Hurricane,13,0,8.99,13
1962430,Monochrome Mobius: Rights and Wrongs Forgotten,101,58,53.99,43
2105000,Super Choppy Orc,17,0,3.99,17
2007700,Scared Tube,0,2,4.49,-2
1810580,Nobody - The Turnaround,3469,2096,0.0,1373
2094750,Timeloop: Sink Again Beach,19,1,7.0,18
2166540,Candice DeBébé's Tantalising Tricks,2,0,8.09,2
801550,VAIL VR,320,45,11.99,275
2154800,Natsukiri－Summer Vacation At Kirishima House,6,0,1.99,6
2106810,The Forest of Drizzling Rain,20,0,12.79,20
2203730,IN THE BUILDING: CATS,13,1,1.19,12
1454540,LAPIN,29,1,14.39,28
2134970,The Hotel,6,1,15.99,5
1947070,Broken Edge,32,7,9.99,25
1461810,蜀山：初章,1904,436,24.99,1468
1949100,My Fantastic Ranch,1,1,26.99,0
1305640,Beyond Hope,1,0,11.69,1
2186940,Dark Sweeper,10,0,8.39,10
1899950,Dolmenjord - Viking Islands,16,1,2.09,15
1269370,171,642,172,26.99,470
1961250,Extinction Eclipse,2,0,11.99,2
2115400,Muse&Barbarian,4,0,3.19,4
2144530,No Random Novels,2,0,26.99,2
2012100,WHAT THE BAT?,8,2,24.99,6
2167900,Puny BOB,10,0,7.79,10
1593780,Organs Please,59,1,12.59,58
1107340,LONN,25,11,29.99,14
2096610,Crysis 3 Remastered,98,18,22.49,80
715400,Frozen Flame,557,353,25.49,204
2173890,I commissioned some bees 10,2,0,1.69,2
1954930,Stronghold’s Dungeon,11,0,5.59,11
2201450,laf the game,4,0,0.69,4
1589680,Torii,9,1,12.74,8
2196140,HellRazor64,2,0,14.99,2
2096600,Crysis 2 Remastered,154,19,22.49,135
2204940,Battle Robots,9,0,0.74,9
2193410,Undercover - Blood Bonds,1,0,9.74,1
1567020,The Dark Pictures Anthology: The Devil in Me,290,269,39.99,21
1778380,Mine Upgrade,2,0,0.99,2
2138000,Hoshizora no Memoria -Eternal Heart- HD,7,1,17.99,6
2111490,Sins From Magdala,0,1,5.39,-1
2088170,Medal of Guardians,0,2,3.59,-2
2111040,Dead Beacon,2,0,3.99,2
2198800,CRUMB Circuit Simulator,16,3,8.99,13
1688520,Abyss Protection,3,1,8.49,2
1817190,Marvel’s Spider-Man: Miles Morales,1759,99,49.99,1660
1708990,Bingus: My Beloved,15,0,4.49,15
2166990,Crazy Drift,1,0,9.99,1
966190,Lost Marbles,3,0,6.79,3
1687710,Everdine - A Lost Girl's Tale,2,0,4.49,2
2206580,Gravity Magician,0,1,0.59,-1
2206460,Furry Killer,3,1,0.59,2
2207100,Tiny Onion Knight,0,1,0.59,-1
2211190,BYTE FYTE (MULTIPLAYER),3,1,0.69,2
1231840,Climber: Sky is the Limit,54,16,17.59,38
1065310,Evil West,1652,437,49.99,1215
844670,Please Be Happy,48,1,17.99,47
2203620,Blood Exile,11,0,0.59,11
2162890,Keep of the Witch,1,0,3.99,1
2128770,SGS Okinawa,2,0,11.99,2
2126990,Lost World,28,8,7.99,20
2053080,Opaloid Kingdom,1,0,5.39,1
2146720,EON Fighter,7,0,2.69,7
2109630,SKY TOMB,1,1,2.54,0
1981700,Jacob's Quest,2,0,6.59,2
2104850,Moving Jigsaw Puzzles,3,0,4.24,3
2206690,Kalzoon,12,0,0.59,12
1588610,Beers and Boomerangs,16,0,14.99,16
1286580,Ship of Fools,485,71,13.49,414
1394460,RXC - Rally Cross Challenge,18,0,14.99,18
2203690,DICE GAME,12,0,0.59,12
2186380,Teahouse of the Gods,3,0,4.61,3
2182420,Idle Shapes,3,1,3.19,2
2214840,The Shadow Over Route 80,8,0,1.99,8
1913690,Cleopatra Fortune™ S-Tribute,4,0,13.49,4
2179380,Sand:box,13,0,1.79,13
1527890,Dysterra,119,55,29.99,64
1397070,重返现场,5,5,8.99,0
2199570,Station 117,4,1,2.69,3
1479400,Riffle Effect,7,0,18.99,7
2172510,Fairy Biography2：Confidante,83,11,1.79,72
2116890,Zodiac fantasy 2,66,0,1.79,66
1972460,Portobugia,3,1,5.24,2
2113770,In Woods,6,0,1.59,6
2188220,Across-Stitch,5,0,1.59,5
1400610,One Drunken Knight,1,0,8.49,1
2157070,Funeral,3,1,3.19,2
2020860,Rush Rally 3,27,1,12.74,26
2150180,Deep Dungeon,12,0,2.99,12
2007270,The Mystery of William Moore,0,1,19.77,-1
1550870,The Indigo Parallel,9,0,12.99,9
2015650,Disembowel,16,8,4.24,8
2181440,Delivery Man,9,6,4.49,3
2195530,Theocracy,1,0,6.99,1
2211960,Counterspell,2,0,1.99,2
2203720,Female Prison,0,3,4.99,-3
1919140,Antioch: Scarlet Bay,20,3,4.24,17
2176760,Maid for Loving You,11,0,15.99,11
2093950,Boots Quest DX,10,0,7.99,10
2209580,Digital Frida,9,1,5.99,8
2205460,İBLİS2:sorcery,3,4,15.99,-1
1848870,Hologram,0,4,23.99,-4
2154350,Zombie Slapper,1,0,7.49,1
2207520,MIND CORRIDORS: Paroniria,17,0,5.99,17
2213460,Ghost Guy,2,0,2.99,2
1912380,Soccer Story,35,21,17.99,14
2081490,Die O'Clock,7,1,11.99,6
1872680,The Knight Witch,105,37,17.99,68
1924910,Dr. Chatelet: Faith 神医,30,3,3.52,27
1642790,Deepening Fire,137,30,10.79,107
2219650,Deserted Island,1,0,4.99,1
2135970,Magnus Positive Phototaxis,4,0,2.99,4
2213600,Medusa,1,0,2.99,1
2192220,Doughball Descent,3,2,7.99,1
422890,22 Racing Series | RTS-Racing,10,2,24.99,8
2161900,Spin Quest: A Slot Adventure,4,0,3.39,4
1743930,Froggo Swing 'n Grapple,2,0,9.99,2
2214430,星辰封神,0,1,1.79,-1
1880930,Rugby Union Team Manager 4,2,1,31.99,1
1934020,Polar Penguin Post,4,0,12.74,4
2158290,Necroffense,2,0,2.0,2
1802270,TypeOut,5,2,4.99,3
961200,Predecessor,1062,299,0.0,763
2061710,DO NOT OPEN,13,2,24.99,11
2128310,Ceaseless Night,2,0,11.99,2
1847510,Boba Simulator : Idle Shop Management,8,0,2.39,8
2207610,Beat the Heat,2,0,5.99,2
1913680,Elevator Action™ -Returns- S-Tribute,16,1,13.49,15
1512390,The Whispering Valley | La vallée qui murmure,6,0,10.79,6
2151580,Infinite Tao,42,18,2.99,24
1361210,"Warhammer 40,000: Darktide",4486,2104,39.99,2382
2138190,StarTron,1,0,2.99,1
368260,Marvel's Midnight Suns,921,413,59.99,508
1793030,Romancing SaGa -Minstrel Song- Remastered,49,8,24.99,41
2210630,Pretty Girls 2048 Strike,6,0,5.59,6
1722860,Munchkin Digital,83,32,14.99,51
2161730,Mike's Arcade,1,0,6.79,1
1895950,Doki Doki House,2,0,11.04,2
1956310,Scandal Notes,2,0,2.99,2
2002540,Otaku Engine,2,0,3.89,2
2215780,抵御者 Defender,7,0,0.89,7
1309780,MODERN NAVAL COMBAT,23,8,22.49,15
2209660,Awaken,4,3,7.99,1
2201170,Christmas Wonderland 13,0,1,6.99,-1
1952440,God Souls,40,2,3.39,38
1066760,Moonshine Inc.,29,18,17.99,11
2220350,I commissioned some bees (advent),1,0,4.24,1
2210710,Zombie Shooting Star: ARCADE,3,3,1.79,0
1509650,I Am Jesus Christ: Prologue,179,61,0.0,118
1492320,New Joe & Mac - Caveman Ninja,0,3,26.99,-3
2215820,Late photographer 6,3,0,0.79,3
2100780,Spin Time,4,3,3.99,1
2214250,Falsepine,10,2,9.59,8
1680620,Tree of Mu,0,1,8.99,-1
1846380,Need for Speed™ Unbound,1929,564,69.99,1365
2186500,Vispo - The Video Spot the Difference game.,3,0,1.99,3
2098130,International Basketball Manager 23,8,2,24.99,6
1544020,The Callisto Protocol™,6137,5900,59.99,237
1274230,Legend of Kendor,2,1,7.79,1
1230000,Curse of Eternity,9,2,16.99,7
1947990,Pirates - Digital Strategy Game,1,0,9.99,1
2201680,Rocket Escape,3,0,5.99,3
1738670,Fairground Power Polyp Simulator,4,1,6.29,3
2162220,CRAP,1,0,3.99,1
2010370,The True Love Rings,8,3,1.99,5
1993150,轮回修仙路,160,26,11.89,134
1846460,Burnhouse Lane,69,2,13.49,67
2209680,Beach Invasion 1944,125,26,8.99,99
2179720,The Seekers: Survival,9,1,13.49,8
2186240,Saint Kotar: The Crawling Man,9,0,3.39,9
2213880,The Future Ends,3,3,11.99,0
2006470,Chronos Builder,0,4,44.99,-4
1498140,Cafe Owner Simulator,86,35,17.09,51
2183210,Fairy Card Rogue,2,1,8.99,1
2210590,自由人生模拟 Free Life Simulation,7,3,2.39,4
1771400,"Die, A.I.",7,0,2.99,7
1804270,Swordship,33,0,17.99,33
2220590,华夏五千年,2,0,3.99,2
2183080,Princess Dating Sim,2,0,2.54,2
1222540,Gastova: The Witches of Arkana,5,0,19.99,5
2224790,PIEN & PAON plus,11,0,3.59,11
1573090,Impaler,92,4,2.69,88
2158190,Robot Programmer,5,0,8.49,5
2208920,Assassin's Creed Valhalla,828,518,19.8,310
1948800,Yi Xian: The Cultivation Card Game,797,212,7.99,585
1294660,Divine Knockout (DKO),707,244,0.0,463
975370,Dwarf Fortress,9616,328,29.99,9288
1807200,Mirror Forge,44,10,11.04,34
1321680,Hello Neighbor 2,264,182,39.99,82
2193870,多比大冒险(Doobi's Adventure),13,6,2.45,7
736820,Knights of Honor II: Sovereign,855,322,39.59,533
2213930,Survive and Revenge,0,1,11.99,-1
2186530,My Desktop Girlfriend,0,1,0.79,-1
1949000,Catgirls From My Sweet Dream,58,3,2.54,55
1620290,Zombie Cure Lab,77,6,19.99,71
2201390,Palladise Island：Legendary Space,5,1,1.79,4
2226500,monsterLabShooter,0,1,2.99,-1
1940140,Tiles and Towers TD,7,0,3.99,7
2228400,Unsolved Case: Fatal Clue Collector's Edition,1,0,13.99,1
1113120,IXION,2155,1314,31.49,841
2153050,Clutter's Greatest Hits - Collector's Edition,2,0,12.59,2
1265800,Hubris,87,36,39.99,51
1550270,Togges,8,0,17.99,8
1339110,The Maze: Humanity,11,0,17.99,11
1952250,SAMURAI MAIDEN,178,141,53.99,37
1740930,JellyCar Worlds,95,0,7.99,95
1443630,Turbo Sloths,8,0,17.99,8
1766340,Professor of Magical Studies,4,0,5.93,4
1786830,NecroBouncer,50,6,11.89,44
1301010,World Racing 2 - Champion Edition,51,0,7.79,51
2172120,Rift Rangers,1,0,3.99,1
2065810,Undead Horde 2: Necropolis,11,3,13.59,8
1964480,Yami RPG Editor,10,0,71.99,10
1639180,Dance Assembly,4,1,3.59,3
2151700,Yokai's Wish,6,2,1.79,4
1229240,Chained Echoes,261,31,21.24,230
2101410,Lost Beyond,2,0,9.74,2
1183010,Listeria Wars,5,0,8.91,5
2198650,Surrealidade - Definitive Edition,1,0,6.39,1
1290750,Crawl Tactics,16,3,17.99,13
1431430,Tiny Island,11,1,13.49,10
2089710,A Most Extraordinary Gnome,9,0,5.4,9
1867530,Solar Ash,64,8,25.99,56
2188380,Halcyon,1,0,2.99,1
2190290,To Be or Not to Be,869,190,11.69,679
1772310,Grey Heritage: Faded Vision,13,0,11.99,13
1766740,Choo-Choo Charles,2696,252,19.99,2444
1985420,This is a Ghost,7,1,11.99,6
2190390,Ocean Is Home : Island Life Simulator,7,0,11.99,7
2098090,Lost Lands: Sand Captivity,1,0,6.99,1
2117960,Slay The Zone,4,0,4.99,4
1973730,Sheep in Dreams,12,8,15.29,4
2121260,My Mad Scientist Roommate Turned Me Into Her Personal Robotic Battle Maiden?!?,5,0,26.99,5
2060670,Sue Shi Survival,2,0,2.99,2
1914750,Resist,9,0,15.99,9
2199360,Cow Girl 2,3,2,0.84,1
594030,Afterglitch,3,0,14.99,3
2124420,Fate Seeker: Journey,574,135,10.0,439
2151290,Football Coach: College Dynasty,68,1,11.99,67
2182130,Wrapped With a Kiss,1,0,4.99,1
2192670,G-MODEアーカイブス+ 女神転生外伝 新約ラストバイブル,2,2,14.39,0
1764820,PYRMD,12,6,4.79,6
2179360,INCUR Survival,1,0,4.99,1
2169100,五代十国之玉知,3,0,1.99,3
1823930,Wavetale,59,9,26.99,50
2192680,G-MODEアーカイブス+ 女神転生外伝 新約ラストバイブルII 始まりの福音,1,1,14.39,0
1818230,Lodventure,8,1,8.99,7
1655960,Maptroid: Worlds,19,0,2.54,19
1935660,Chop Goblins,655,6,4.49,649
1855160,Find the Gnome 2,1,0,6.29,1
2178650,Fastraq,0,1,1.39,-1
1608070,CRISIS CORE –FINAL FANTASY VII– REUNION,1294,150,49.99,1144
1623070,Master of Magic,184,73,39.99,111
1862690,My Gaming Club,24,4,11.89,20
2176130,Tower! Simulator 3,28,20,50.99,8
1583230,High On Life,1962,247,59.99,1715
1585400,Gjallarhorn,5,0,19.99,5
2222170,Crazy City Driving,10,0,14.99,10
1586800,Lil Gator Game,461,3,13.99,458
2076220,Akai Katana Shin,24,2,29.99,22
1458090,Hapland Trilogy,5,0,5.99,5
1750770,Starcom: Unknown Space,82,10,16.99,72
2059280,Nightmare knock,8,0,0.99,8
2229080,Beauty from Wisdom,0,1,1.39,-1
1429500,Frontier Hunter: Erza’s Wheel of Fortune,147,22,17.99,125
2098390,Planet Surfer,14,0,5.09,14
1591450,Aka,82,41,11.69,41
1920480,River City Girls 2,203,46,35.99,157
2212390,AOI,17,4,4.24,13
2094300,Virtual AI - Aki & Mika,5,0,15.99,5
1633160,Aquarium Travels,1,0,7.19,1
1970460,Garden Galaxy,117,2,9.99,115
2196120,Baker Business 3,2,0,6.99,2
2175800,LONGEYED PROJ,11,4,10.19,7
1941310,Sleep Paralysis: The Uncanny Valley,6,1,7.64,5
1679220,Portal Dungeon,56,8,11.69,48
1692400,Last Shape Standing,1,0,7.19,1
1747680,Faraway: Jungle Escape,0,1,4.49,-1
1993120,Death Below,18,6,5.99,12
1787480,Metro Simulator 2,43,20,13.49,23
2050510,Oriental Dynasty - Silk Road defense war,20,26,5.39,-6
1745780,Substance 3D Modeler 2023,1,1,98.99,0
2218980,Sperma,4,0,2.99,4
1893950,One Life,1,0,7.99,1
2215220,Jewel Match Winter Wonderland 2 Collector's Edition,5,0,11.04,5
1975530,Choice of the Viking,1,2,5.27,-1
2162070,Ooglians,12,1,1.99,11
1839190,House Flipper Pets VR,2,0,17.99,2
2085360,Insomnia: Theater in the Head,166,2,1.99,164
2197050,Xmas Apocalypse,13,1,2.99,12
2106520,私のリアルは充実しすぎている フルボイス版,118,2,8.49,116
2233590,mummification,1,0,0.69,1
1970820,EvoMon,13,2,4.89,11
2099080,Hidden Cats in London,25,0,1.59,25
2216320,Eggcelerate! to the North Pole,2,0,7.49,2
1768920,Splatter,46,1,12.74,45
2165740,SokoFrog,11,0,0.79,11
1643100,Noun Town: VR Language Learning,16,0,14.99,16
1650200,Scholar of the Arcane Arts,9,0,3.59,9
2068280,Nordic Ashes: Survivors of Ragnarok,29,6,4.99,23
1585220,Melatonin,220,6,13.49,214
1532690,BLACKTAIL,147,22,23.99,125
1708550,Cassiodora,4,0,13.49,4
2208070,Jigsaw Puzzle Best Places,6,1,0.69,5
1963520,Cygnus Enterprises,27,6,19.99,21
1907380,Arcane Vale,17,2,6.79,15
2226350,Cat + Dog,1,0,1.49,1
1324150,Micetopia,1,3,3.99,-2
2235610,Sakura Mirror,5,1,0.84,4
1018640,Pixel Happy Game Girls,2,0,0.0,2
2022090,HeatStroke,13,1,1.99,12
1012110,Military Conflict: Vietnam,129,18,19.99,111
1996210,Sakura Hime 3,99,4,2.79,95
2158900,Automaton Lung,11,0,14.99,11
2017730,The Chicken Game,1,0,4.99,1
2206340,Aokana - Four Rhythms Across the Blue - EXTRA2,222,0,22.24,222
1995590,The Block,15,2,2.39,13
2027540,Zombies Attack,1,0,1.79,1
2232380,Glory to the Robots!,9,1,5.99,8
2235250,Crystal Winter,10,0,2.48,10
1261220,The Neverland of the Mountain and Sea,118,2,9.99,116
2216960,Super Psycho Baseball,65,2,4.99,63
1477070,Depersonalization,1190,125,17.99,1065
2017640,Sakura Gym Girls,2,1,7.49,1
2161330,I Love Finding Birds,1,0,5.24,1
2232290,From The Rain,14,1,2.99,13
1574110,Lying Souls™,2,0,5.99,2
2102240,Ravage Road,2,1,15.29,1
1385680,Corpse Box Racers,7,0,8.49,7
2192480,Luna & Monsters Tower Defense -The deprived magical kingdom-,1,0,12.74,1
2124380,Super Lesbian Animal RPG,97,0,13.49,97
1922550,Psychosis,4,0,4.24,4
1456470,Rolling Gunner,5,2,19.99,3
1031460,Sail Forth,93,3,17.99,90
2225290,Beau & Bow,2,0,1.99,2
2244550,Don't Steal My Christmas!,7,0,0.89,7
2207030,下山的试炼之江湖遗失录,3,0,1.59,3
2183370,Survival Shot,0,1,4.99,-1
2153330,Otome * Domain,51,0,19.99,51
2004340,Eternal,3,0,5.19,3
1663250,Hyper Gunsport,7,0,24.99,7
2229670,Lucy´s World,1,0,9.99,1
2240440,Amanda's Magic Book 5: Hansel and Gretel,1,0,5.39,1
2236730,Jedi Survive,1,1,1.39,0
2208870,Wrestling Manager 2023,0,1,9.99,-1
2210670,Torecower,2,0,2.99,2
1452210,INPUT6,2,0,3.59,2
1548350,Weirdlands,1,0,10.99,1
1709730,Beyond The Edge Of Owlsgard,3,0,22.49,3
1070840,Quest Together,7,0,11.99,7
2073570,Holy Paladin Cynthia,6,1,15.99,5
1935830,Stoney's Adventure,3,0,9.99,3
2211640,Who Knocks,11,1,6.99,10
2134650,New Yankee: Karma Tales,1,0,3.39,1
2196790,Jianghu Survivor,33,5,6.29,28
2220850,Combine And Conquer,2,0,3.99,2
2244640,Trophy Chaser,12,0,0.59,12
2235350,Family Business,2,1,2.99,1
2242610,Time Thief,1,0,4.99,1
2206310,BlueTricks,0,1,2.09,-1
1877410,Fairy Deer,11,0,1.99,11
2251240,Police Car Simulator,3,3,0.84,0
2237800,Dragon's Treasure,0,2,2.09,-2
2230330,Pot Farmer,1,0,0.74,1
2162160,The Passenger,19,0,5.03,19
2244620,Blacklight,2,0,2.52,2
2240450,Helga the Viking Warrior 2: Ivar's Revenge,1,0,5.39,1
2236480,僵尸（THE JIANG SHI）,14,13,0.0,1
2251680,Epic Assassin,1,0,0.69,1
2200760,The Bogtavern,1,0,1.79,1
2238350,AutoSim 2,2,0,9.99,2
2253290,My Grandparents' Christmas Mystery,5,2,1.49,3
1197180,Spider Queen cave,4,1,7.99,3
1236300,Resident Evil Re:Verse,19,15,29.99,4
2199580,Interstellar Pilot 2,9,0,3.99,9
2171610,Mini Star Bakery,8,0,9.99,8
2253910,Mothership Forever,5,1,7.99,4
1787180,Revenge on the Streets 3,3,0,3.99,3
2233140,Double Line Confrontation：New World（双线交锋：新世界）,1,0,6.99,1
2251810,Hole in Won,9,1,2.54,8
2241240,DUNGEON WALK－竜迷宮の管理者－,2,2,3.99,0
2095330,BackRoomsNew,3,1,1.99,2
2203490,My Land!,1,0,2.39,1
2180430,MeiQi 2023,8,0,7.19,8
2083870,Enworden,2,0,4.44,2
2185760,Under the Sky World,10,0,14.39,10
2209560,NoEL - Nothing on Elysion Line,7,3,17.49,4
2129150,Horror Tale 1: Kidnapper,10,3,3.99,7
2180060,Trouble in Tornado Town,4,0,4.99,4
2088160,天外武林 (Traveler of Wuxia),702,165,22.49,537
2243040,The Cleaner,5,1,0.99,4
2257450,Nash Racing: 70 seconds left,5,2,2.39,3
2207590,Exorcist 2: Crow Magic,3,1,14.99,2
2179270,Mudoba,2,1,3.39,1
2027820,Art Girl 2,1,4,4.24,-3
2182590,The Fernweh Saga: Book One,19,4,5.03,15
1364760,COTTOn Rock'n'Roll -SUPERLATIVE NIGHT DREAMS-,10,0,22.49,10
1619940,Mix-A-Max,2,0,1.0,2
2237510,Polaroid,2,1,3.99,1
2024990,Pedigree Tactics,2,2,8.99,0
2228040,Legacy Of The Pact,4,1,2.99,3
2074940,Phantom Alchemy ~Silvia's Dynamic Urban Planning~,18,7,10.79,11
1631090,Alien Maze,8,1,1.99,7
2231730,Stay Still,14,8,4.49,6
2251120,League Manager 2023,5,10,21.24,-5
2017840,Kit's Quest,5,0,11.99,5
2183730,The Gravehouse,5,1,13.99,4
2230300,NIKKA : RISE,1,0,1.39,1
2246120,Coralina,18,1,5.0,17
2204760,Cat Life,3,0,6.99,3
1960060,Faith & Shield:4044 Tower Defense,0,2,2.99,-2
1816070,ILLUMINATI,11,5,21.24,6
2249160,September 7th,51,2,6.99,49
1817110,Isaiah 188,1,0,10.79,1
2252170,World Soccer Kid,1,0,1.49,1
2196230,SlasherRPG,3,1,6.99,2
1825970,Blockworks,6,0,8.99,6
2113900,Touge Shakai,33,14,14.99,19
2108440,Lawless West,11,1,5.24,10
2244530,Christmas Land: Opposite Worlds,2,1,3.99,1
2120900,Fears to Fathom - Carson House,335,37,3.99,298
1184140,KartRider: Drift,990,371,0.0,619
2077590,Sidestep Legends,12,0,2.99,12
2230220,Wilderless,14,1,4.99,13
2137660,SANRI,5,5,13.49,0
2192570,Vosphia,4,3,13.49,1
2260260,Hack and Shoot Heroes,1,5,3.59,-4
1035760,Glimmer in Mirror,334,66,15.29,268
1969060,Path of the Midnight Sun,41,4,22.49,37
1612520,SmallZ,7,3,5.99,4
2262960,Artur's Pinball,1,1,0.59,0
1765010,Darwin's Aquarium,0,1,14.99,-1
2255480,Idle Banshee Alliance,7,2,3.49,5
2258910,Horror Tale 2: Samantha,4,1,4.24,3
2027090,LiMiT's Escape Room Games 2,1,0,11.99,1
2261090,三國立志傳,13,0,7.99,13
1050260,Isle of Pan,13,0,14.99,13
1912140,The Dreamland,0,2,11.99,-2
2242220,Forest Fire,14,0,5.39,14
1816570,江湖十一,1316,2517,17.99,-1201
1677020,Magirune 2,4,0,4.24,4
1870150,Xuan-Yuan Sword: The Clouds Faraway,17,6,8.49,11
2146450,"Car Racing Highway Driving Simulator, real parking driver sim speed traffic deluxe 2023",23,2,1.19,21
1790370,Rogue AI Simulator,70,12,10.79,58
1765350,候鸟,143,2,8.79,141
1108000,Children of Silentown,145,17,17.99,128
1883840,Ocean Punk,17,8,5.39,9
2183180,BACCHANALIA,12,38,4.79,-26
2257790,Trapers Platformer,1,0,9.74,1
1741400,Wander Hero,184,24,8.09,160
1972550,paradise of desire,34,14,3.99,20
2193900,Creepy Forest,8,0,3.99,8
1916610,Frame - Portals on Steroids,5,0,13.59,5
2116770,Armoured Cavalry: Operation Varkiri,12,0,8.99,12
1261430,Kandria,55,1,17.99,54
2250820,Party Party Time,1,0,3.49,1
1870140,Xuan-Yuan Sword: The Cloud of Han,18,4,8.49,14
1926370,Yeah！Fighting Girl,8,5,13.49,3
1728520,Xuan-Yuan Sword V,17,9,8.49,8
1647420,GROSS,58,11,16.19,47
1455910,Territory: Farming and Fighting,35,4,8.79,31
2242090,Midnight Alert,1,1,5.99,0
2161440,Sailing Era,868,288,22.49,580
2134580,实习班主任 Practice Teacher,5,1,3.59,4
1125710,Gatewalkers,123,65,19.99,58
1984790,Drago Noka,31,10,19.99,21
2221490,Tom Clancy’s The Division® 2,528,414,9.0,114
2075410,初夏倾语 - Summer Whisper,9,5,1.79,4
1452070,LONE RUIN,64,31,13.49,33
1942010,Vengeful Guardian: Moonrider,86,6,15.29,80
2158740,Within the Backrooms,12,0,12.74,12
1812300,Aquatico,135,51,22.49,84
2155280,DEFCON: Xenos,5,0,2.99,5
1694510,Barista Simulator,47,8,13.49,39
814000,ONE PIECE ODYSSEY,658,111,59.99,547
2140680,Code R.U.B.I.K.,2,0,22.49,2
1710100,Bing in Wonderland,318,9,8.09,309
2246400,Confabulation,5,0,6.29,5
1422130,SimRail - The Railway Simulator,214,44,31.49,170
1808570,Aurora's Journey and the Pitiful Lackey,1,0,14.95,1
2112420,Pillazon: MMO Drug Lord Tycoon,16,0,3.74,16
349470,Drift Stage,16,14,9.99,2
2192840,Terfenstein 3D,4,1,4.99,3
1595770,SUFFER 2,2,0,4.24,2
2246940,Only A Dream,4,0,4.99,4
2234720,Project Sail,1,0,11.99,1
2147050,Jumping Cat,19,0,2.99,19
2096310,Novastella Island,101,136,11.99,-35
1275370,Sharded World,6,1,4.49,5
2254600,Let's Pet Pets,19,0,4.99,19
2241620,Starless Hotel,1,2,2.99,-1
2256520,Gunslinger Nova,1,0,5.99,1
2106760,The Burrito Quest,3,0,2.69,3
2237350,100 Keys To Your Heart,3,0,5.99,3
2164790,Putin Destroys Alien,3,0,0.69,3
1318740,Farlanders,120,9,13.49,111
2265040,Cracks In Hell,6,1,2.09,5
1903970,World Championship Boxing Manager™ 2,18,1,12.99,17
1815540,BLINNK and the Vacuum of Space,1,0,22.49,1
2171010,The secret pyramid VR,11,0,5.99,11
1532240,PocketCiv,2,0,9.99,2
2071200,The Bad Kids,161,57,6.79,104
1789220,Horror haze,5,0,3.39,5
2058200,Showrunner,21,8,8.09,13
2073140,Another World - Thought Taboo,13,0,3.59,13
2263510,The Simulacrum,14,1,4.99,13
1561380,RE:CALL,9,0,19.99,9
2095290,Theseus Protocol,100,23,8.99,77
2112210,Ensora,11,1,11.19,10
1254320,Surviving the Abyss,167,59,17.99,108
1486440,Graze Counter GM,43,1,11.99,42
2268460,Dark Shrine,2,1,0.99,1
1036240,Definitely Not Fried Chicken,160,50,21.24,110
1809700,Persona 3 Portable,893,334,19.99,559
1827910,星の欠片の物語。しかけ版,3,0,31.49,3
1420350,Fraymakers,309,128,19.99,181
1843110,Makis Adventure,19,3,7.99,16
1696960,Lake Haven - Chrysalis,53,0,2.99,53
2167870,A Bit of Tactics,5,0,3.99,5
2025320,Estencel,18,10,12.59,8
1546990,Grand Theft Auto: Vice City – The Definitive Edition,151,69,29.99,82
1200570,AColony,8,0,14.99,8
2210210,A Matter of Principle,4,0,3.59,4
1930580,Devil's 5 Days Mischief Game,6,0,12.59,6
2261240,Nope Nope Nope Nurses,11,0,9.59,11
2220980,错误之事,4,3,2.39,1
1201270,A Space for the Unbound,240,4,17.99,236
1547000,Grand Theft Auto: San Andreas – The Definitive Edition,215,93,29.99,122
2267040,Light the Backrooms,1,0,4.49,1
1546970,Grand Theft Auto III – The Definitive Edition,122,72,29.99,50
2223590,2112TD: Tower Defense Survival,24,3,4.31,21
1247740,Your Story,11,1,11.99,10
2102680,Blinded by Fear,4,0,8.99,4
2173270,FORTUNE the FATED,0,1,2.99,-1
2220070,Encoded War,6,0,10.79,6
2244150,Tristia:restore,1,0,44.99,1
2098070,Star Ring,19,1,8.99,18
2263170,Maiz,9,0,2.39,9
2244160,Tristia:legacy,2,1,59.99,1
2217560,Sudden Market,2,0,2.39,2
2262790,虚空灵药园,1,0,4.24,1
2077380,The Multi-Medium,20,0,6.99,20
2268040,Tracadie Bird Shit,4,0,0.89,4
2267770,Xploquest 3,4,0,4.79,4
1406260,Bram The Toymaker,5,1,5.99,4
1891600,Human or Not,3,0,10.19,3
2257050,Flaming Thunderer,1,0,14.99,1
2263710,T-Rex Dinosaur Game (Unreal Engine 5 Edition),1,0,0.69,1
2199540,80's Mania Pinball,3,0,1.99,3
1697590,Palette Swap,3,0,2.99,3
934670,Avernus,0,1,12.74,-1
2269460,創業王 CEO,3,1,9.99,2
1042600,Demon Queen Melissa,15,7,17.99,8
2257060,Lone Traveler,2,0,14.99,2
1512590,Punch A Bunch,167,34,11.99,133
2158670,RPG Architect,14,0,29.74,14
2206590,Fateel - فتيل,2,1,4.49,1
2157060,Project Malice,4,0,8.49,4
2227130,Caves of Lore,5,1,9.99,4
2255020,Qdice,1,0,2.99,1
2265130,Survivor:Stay In The Light,1,0,3.39,1
1858090,A Modest Legacy,2,3,5.99,-1
2231380,Tom Clancy's Ghost Recon® Breakpoint,864,824,12.0,40
2239000,The Forgotten Tapes: Analog Nightmares,15,1,6.29,14
2244420,情人泪,33,22,5.39,11
1952340,Poly Skies,5,1,7.99,4
1680880,Forspoken,1820,1576,69.99,244
2260540,Endless Nesla,9,0,3.99,9
1707400,Larcin Lazer,123,0,8.99,123
2248920,Super Kids Racing : Mini Edition,0,1,8.49,-1
2195230,仙界之剑 仙王少女战记,10,1,8.39,9
1978380,Rival Rides,5,1,29.99,4
1932160,Neptunia: Sisters VS Sisters,172,19,44.99,153
1717640,Mahokenshi,121,33,22.49,88
1856130,Catoise,2,0,5.99,2
2162950,A Maiden Astrologer Divines the Future,5,3,8.39,2
541910,David Slade Mysteries: Case Files,4,1,9.99,3
2273440,可识此阵,6,0,0.59,6
2113920,The Legend of Heroes: Kuro no Kiseki Ⅱ -CRIMSON SiN-,89,13,53.99,76
1850490,Warmonium,1,0,20.09,1
2274860,Bus Simulator: Car Driving,3,2,0.84,1
2273400,三国群英战略版,1,1,0.59,0
2211110,Brick Odyssey,4,0,10.19,4
2267350,Forkscythe,1,1,4.49,0
1817230,Hi-Fi RUSH,2395,36,29.99,2359
2168880,Rogue Blaster,4,0,3.49,4
1293420,Roller Drama,4,0,13.49,4
2274510,Hood Warfare,4,3,4.99,1
2265010,草食系男子の言いなり入院生活- A passive boy at the Huntress clinic -,1,0,19.99,1
2250340,I commissioned some bunnies,13,0,3.39,13
2141820,Onion Assault,11,0,7.99,11
2214090,Hyper Shapes,2,0,4.49,2
1724390,Power Chord,29,8,17.99,21
2095060,Inhabit,9,0,2.99,9
2241920,Stay Human,2,0,7.99,2
1380290,New Witch in Town,0,4,5.93,-4
1622610,Hell Slayer,1,0,2.99,1
2244770,Stonga Bird,4,0,0.84,4
2239550,Watch Dogs®: Legion,272,232,12.0,40
2237070,Deathtide Survivors,4,2,4.49,2
2231450,Pizza Tower,1375,7,19.99,1368
2247820,Rogue Station,14,0,9.99,14
894620,ATONE: Heart of the Elder Tree,5,1,11.99,4
2252550,Hope,6,0,3.19,6
2276000,SUA,1,0,2.99,1
1693980,Dead Space,4478,643,59.99,3835
2204680,Cyber West: Hidden Object Games - Western,9,0,2.69,9
2235530,The Green Room Experiment (Episode 1),1,0,8.99,1
2063870,bloody lonely cold,1,1,2.09,0
2282540,Scary Turnaround,4,0,0.74,4
2069180,The King's Dilemma: Chronicles,39,13,14.99,26
2095080,Paperback Adventures,20,1,11.99,19
1757890,Elohim Eternal: The Babel Code,7,0,7.99,7
2192170,Whackerball,21,1,3.99,20
2193080,Amabilly,2,0,3.99,2
1920100,Backfirewall_,113,4,13.49,109
1760640,Awakened Evil,21,0,5.99,21
2234150,BACKROOMS: APPREHENSION,8,1,2.99,7
2241390,Spelp,15,0,4.49,15
2218140,Alien Slayers,14,2,2.99,12
2062390,Clockwork Survivors,2,0,7.38,2
2100720,Rat Cage,6,2,8.99,4
957960,Inkulinati,67,11,22.49,56
1350780,Orbital Strike VR,3,0,17.99,3
2231530,Idle Drift Kings,1,1,2.99,0
1618380,Spellmasons,31,4,14.99,27
2122210,Battle of Vukovar: Rain of Steel,28,5,9.99,23
2254750,Black cotton: Wuneng,22,7,4.79,15
1859150,Knight Solitaire 2,1,0,2.99,1
1148490,Second Front,159,47,29.74,112
1282150,SpongeBob SquarePants: The Cosmic Shake,676,37,39.99,639
695330,SEASON: A letter to the future,358,16,22.49,342
1770080,Superfuse,337,270,24.99,67
1451190,Undisputed,2342,525,29.99,1817
2283690,The Adventures of LinShanHai,19,0,0.89,19
1928360,Please Teach Me Onedari Shogi,2,0,9.99,2
2002850,Raiden IV x MIKADO remix,4,2,26.99,2
1761600,JETT: The Far Shore + Given Time,7,4,17.99,3
1475840,Rhythm Sprout: Sick Beats & Bad Sweets,167,8,13.49,159
1913620,Puzzle Bobble™2X/BUST-A-MOVE™2 Arcade Edition & Puzzle Bobble™3/BUST-A-MOVE™3 S-Tribute,4,5,13.49,-1
2238310,The Cooking Class,5,0,2.99,5
2250250,Mighty Mage,1,0,2.69,1
2243920,The 2nd page of the medical examination diary: Another story of exciting days of me and my senpai,16,3,11.89,13
2237370,Cubis,3,0,4.49,3
1739650,Dimensions: Dreadnought Architect,58,33,12.74,25
2243140,Guns & Fishes,18,0,1.49,18
1913670,Metal Black™ S-Tribute,7,2,6.29,5
2268720,Mullet Hell,5,0,3.99,5
2193770,Our Summer Sports,1,0,5.99,1
1603940,Nuclear War Simulator,29,15,29.99,14
1687210,Tell Some Story: Foz,13,0,13.99,13
2214160,Stream Runners: Heroes,1,0,1.99,1
2212330,Your Only Move Is HUSTLE,1283,37,4.99,1246
1883090,The Symbiant,84,1,17.99,83
1343810,Fallen Hero: Retribution,95,2,7.91,93
1345890,Deliver Us Mars,295,101,29.99,194
2279870,Project Nosferatu,2,0,14.99,2
2244330,Crossroad of Worlds: Mystery Agency Collector's Edition,1,0,13.99,1
1803760,Windmills,10,2,10.49,8
2173760,Super Video Golf,6,0,6.02,6
1771130,OPEN DOOR,8,1,16.99,7
1016360,PERISH,144,71,17.99,73
2283240,Ultimate Flight Simulator Pro,1,0,0.84,1
2223020,Glass Heart,3,0,19.99,3
2229420,Cleaning Queens,0,1,9.59,-1
2228220,Variant 22,0,9,11.89,-9
2275650,Back Rank Chess,1,0,1.39,1
1938120,QUALIA ~The Path of Promise~,4,0,17.99,4
2274390,Lawbringer,2,1,3.59,1
2007930,Fallen Bride Mege,21,3,13.49,18
1094590,Helvetii,20,0,13.49,20
2286510,Move Nature,4,0,1.87,4
1581770,SpellForce: Conquest of Eo,276,77,23.99,199
1968330,The Trasamire Campaigns,2,0,9.74,2
2063310,Joe Wander and the Enigmatic Adventures,3,0,29.99,3
2287060,Extreme Car Drift Simulator,1,1,0.84,0
2272010,Minibots TD,1,0,5.94,1
2107860,Yggdra Union,48,5,19.99,43
2055290,Sonic Colors: Ultimate,83,46,27.99,37
2290070,Army War: Shooting Simulator,2,2,0.84,0
1994760,The Fairy's Secret,6,2,10.79,4
1995490,House of the Soul,2,0,3.99,2
2287360,Chess Defense Saga,1,0,6.29,1
1769270,Spikair Volleyball,12,0,17.99,12
2270930,F1 Crazy Stunts,0,1,2.39,-1
2277410,Under the Sky World~Another~,5,1,2.63,4
2204830,Street Lords,37,16,9.74,21
2286800,高考夺魁记,4,1,1.57,3
2292940,Multiplayer Werewolves,6,1,0.69,5
2224430,Asian Food Cart Tycoon,0,2,9.99,-2
1090100,Scorchlands,27,0,10.79,27
1718240,Beaver Clicker,19,1,3.99,18
2188230,Phoenix Nightmare,0,1,15.99,-1
2274700,Daily Dadish,4,0,9.99,4
2225530,Drawing From Memory,113,1,4.99,112
2130060,Tower Walker: MMO Grind Simulator,8,3,8.49,5
2251620,Sunrider 4: The Captain's Return,18,3,26.99,15
2128340,Death Trials (Director's Cut),0,1,2.99,-1
2253730,Madorica Real Estate 2 - The mystery of the new property -,3,0,13.99,3
2052540,The Cursed Knight,1,0,9.99,1
2297150,Taxi Driver Simulator: Car Parking,1,1,0.84,0
2203030,Girl Fantasy,280,4,3.19,276
2088750,Mystic Gate,9,1,7.99,8
2188960,Vampire Slayer: The Resurrection,15,3,3.49,12
2180410,Dark spell,0,1,1.59,-1
2197760,Midnight Scenes: From the Woods,13,2,4.49,11
2051110,BETA-SIXDOUZE,3,0,15.99,3
2153590,Detective Super Star,1,1,1.79,0
2241020,Garbage Truck Simulator,10,4,10.39,6
2145810,Bumblebee - Little Bee Adventure,12,0,7.99,12
1342080,"The Maiden, the Butler, and the Witch",5,0,13.49,5
2153950,Broken Blade: Prelude,0,1,0.89,-1
990080,Hogwarts Legacy,33521,2000,59.99,31521
2181930,DR LIVESEY ROM AND DEATH EDITION,2599,102,0.59,2497
2288210,三国真龙传,8,2,4.99,6
2282330,Crime Passional,7,1,2.69,6
1801110,違う冬のぼくら／BOKURA,96,37,9.89,59
1737340,Noobs Want to Live,1351,116,4.24,1235
2129280,Trap of MUSK:Europe Night,123,47,29.99,76
1818610,Karagon (Survival Robot Riding FPS),37,18,17.99,19
1946070,Ten Dates,105,18,14.39,87
1592290,PARANOIA PLACE,52,5,4.49,47
1629910,Souls of Chronos,48,8,14.39,40
2003050,Perseus: Titan Slayer,189,46,7.19,143
2010320,TitTok Kitty,19,0,0.59,19
2241560,Angel's Gear,47,15,8.99,32
2139890,Dream Fight Will,4,0,5.99,4
1601740,Corpse Keeper,407,127,17.99,280
2197550,Love Quest,4,0,4.24,4
2184230,Red Tape,27,3,5.39,24
2061150,Ikki Unite,235,82,7.19,153
1820770,DUCK: Dangerous Ultimate Cartridge Kidnapper,47,2,10.79,45
1998340,Labyrinth of Galleria: The Moon Society,64,4,49.99,60
871410,Dawngrown,4,1,5.99,3
2011900,Zero Wing,13,1,7.99,12
1434260,Painting Werther,14,0,11.69,14
2298060,Polyrhythm Master,3,0,2.54,3
1981610,Wanted: Dead,174,148,59.99,26
2303720,Multiplayer Cowboys,7,1,0.69,6
2106860,Spy Bros. (Pipi & Bibi's DX),9,0,6.39,9
835770,Tony Slopes™,4,1,19.99,3
2165380,Hunting Labyrinth,16,2,14.39,14
2022910,Twin Cobra,8,0,7.99,8
2188620,It Returned To The Desert,5,0,8.99,5
2236820,Anyone There?,3,1,3.59,2
2022880,Truxton,22,1,7.99,21
1982340,Blanc,120,53,14.99,67
2139620,FFF,7,0,5.94,7
2270000,Golden Gloves VR,1,0,24.99,1
1500540,Hardwar,6,0,8.49,6
1454700,Cube Conflict,5,1,0.0,4
2078040,White Day2: The Flower That Tells Lies - EP1,64,174,19.99,-110
2304230,I'm On Merrymaking Watch,2,0,1.19,2
2084240,Starshifter,7,2,11.24,5
1894430,Plan B: Terraform,441,49,8.99,392
1901950,Raid on Taihoku,70,12,17.99,58
2304680,Tofas Sahin: Online Car Driving,18,4,0.84,14
1351080,Pharaoh: A New Era,762,345,19.54,417
1649240,Returnal™,1516,360,59.99,1156
2163230,Witch Guild Survivor,1,0,3.99,1
736590,Operation: Harsh Doorstop,964,505,0.0,459
1935470,The Tales of Bayun,45,5,8.09,40
2269320,Natti,14,1,6.39,13
2057430,The Wraith of the Galaxy,22,2,3.39,20
1882960,Lucie's Potager,1,0,17.99,1
2208300,Terrarium Builder,1,0,5.99,1
1938010,WILD HEARTS™,1872,2645,69.99,-773
2230630,Web or Dead,4,0,5.94,4
1201540,HELLCARD,245,32,17.99,213
2166820,史莱姆冒险战SlimeWarfare,5,1,5.39,4
2306160,MULTIPLAYER KNIGHTS,3,3,0.69,0
2084940,Mysterious School,80,32,6.39,48
2178560,Horde Hunters,13,1,3.59,12
2206150,Hot And Lovely ：Charm,296,40,2.99,256
2149900,The Moon Hell,32,4,11.99,28
2300390,I commissioned some cats,9,0,3.39,9
2230120,Inky & Blinky,0,1,1.99,-1
2304030,天下霸圖,41,4,7.99,37
2132530,Last Order,1,1,17.99,0
2286990,Beep's Escape,3,0,9.99,3
1444580,EVIL BELOW™,1,0,17.99,1
1592540,Loretta,45,2,13.49,43
2230770,Overrun Survivors,10,3,6.29,7
1895890,9 Childs Street,72,2,6.29,70
1378200,Rooftop Renegade,1,0,17.99,1
1413660,Elderand,55,13,16.99,42
616820,District Steel,13,1,24.99,12
1296450,Dust & Neon,69,25,23.99,44
1448820,Hydrofoil Generation,17,1,17.99,16
2299610,連縁无現里 ~ Misremembered Memories,4,0,4.99,4
1329880,Wild West Dynasty,238,632,21.59,-394
1253610,Knights of Braveland,37,12,12.74,25
2246550,Interkosmos 2000,3,2,17.99,1
1295000,The Last Shot,17,3,8.99,14
2301370,Fantasy World Souls,14,1,5.99,13
2303300,Real Zombie War Simulator,1,1,0.84,0
1902850,Dreams in the Witch House,25,0,10.99,25
1342090,PRIMITIVE HEARTS,16,10,13.49,6
2299070,OVE : The Sword of Liberation,1,1,24.99,0
2161110,The end is nahual: If I may say so,2,3,8.99,-1
1962520,Rise of Fox Hero,4,0,3.99,4
2251540,IBIS AM,1,0,1.19,1
2266410,Drifting with Maxwell Cat: The Game,25,7,1.49,18
2299890,CosmoOdyssey 2: Comeback to origin,6,0,2.99,6
1716500,Blue Fish Yokohama,2,0,4.79,2
2248390,Citadelic,4,0,9.99,4
1646850,SpaceBourne 2,161,35,15.99,126
2302240,Gallery Manager,6,0,1.21,6
1858900,Stardust Exile,8,1,17.99,7
1713990,Parasomnia,10,1,2.7,9
1804890,Turnament,4,0,6.79,4
1770500,Gigantosaurus: Dino Kart,1,2,39.99,-1
2233240,CyberHeroes Arena DX,1,1,3.99,0
2178570,Arthas - The Game,188,62,4.49,126
2165720,Monsters of Seabrook,1,1,8.99,0
1398210,Selene ~Apoptosis~,102,13,0.0,89
1889040,Birth,73,1,9.89,72
2218970,Plains of Pain,5,3,9.59,2
2188030,Elemental Adventure,1,0,4.49,1
2156620,The Future Radio and the Artificial Pigeons,28,1,26.69,27
2070510,Going Deep,2,0,3.99,2
668580,Atomic Heart,8955,1289,59.99,7666
2302160,Stacks:Space!,13,1,4.49,12
2292840,My Lovely Pets Collector's Edition,1,0,5.39,1
1570830,Mori Carta,6,0,19.99,6
1386140,Johnny Lionface,1,0,13.49,1
2284100,Notes of the Young Lady: In Turbulent Times,4,0,10.79,4
1499770,Echoes of Mayhem,6,0,13.49,6
2201070,Phylakterion,28,8,13.49,20
1557180,Ex Natura: Nature Corrupted,23,5,8.49,18
2067780,Your Turn To Die -Death Game By Majority-,348,2,15.29,346
1638440,Gatedelvers,20,3,13.49,17
2200780,My Dream Setup,311,58,5.39,253
2306380,Sally Can't Sleep,1,0,5.59,1
2299150,Dusk of the Cage,15,0,2.99,15
2064700,Speedonauts : Jetpack Speedrun Skiing,19,0,6.39,19
2005680,Akka Arrh,16,0,19.99,16
2222220,FaceValue,4,0,2.99,4
1584820,The Hero We Need,8,1,14.44,7
2308920,Classic Car Simulator: Car Driving,1,1,0.84,0
1805480,Like a Dragon: Ishin!,1090,201,59.99,889
2311760,House Designer : Fix & Flip,28,5,3.99,23
2188790,Unknown Pyramid,7,0,4.99,7
2146180,Cyclo Chambers,32,3,4.49,29
2305940,Offroad Jeep 4x4: Car Driving Simulator,1,0,0.84,1
2246130,HIYOKU NO TORI,4,0,6.29,4
2139300,Redemption Reapers,63,40,49.99,23
2290890,Endless Dark,2,0,7.99,2
2101080,East Trade Tycoon,153,36,3.59,117
2104750,Arcade Party,4,1,14.99,3
2219880,Animal Academy,1,0,3.99,1
2270220,Dragon Survivors,2,2,6.99,0
1785300,Saint Maker - Horror Visual Novel,26,2,11.19,24
2261130,ReverseRoom,3,3,2.39,0
1579880,The Light Brigade,163,8,24.99,155
1815570,Aces & Adventures,136,13,15.99,123
2004670,Frebbventure,1,0,11.04,1
2226640,December 1914,8,0,2.24,8
2081400,Grim Guardians: Demon Purge,226,77,22.49,149
2265160,Logic - Keypad,3,0,6.29,3
1838290,LOUD: My Road to Fame,9,0,7.49,9
2091540,RUSHAWAY,3,0,9.34,3
1122340,Chef Life: A Restaurant Simulator,120,17,29.99,103
1016950,Blood Bowl 3,323,910,29.99,-587
791200,Planet Cube: Edge,54,0,11.99,54
1326470,Sons Of The Forest,31006,5954,29.99,25052
1677280,Company of Heroes 3,3171,2152,59.99,1019
1094720,Clive 'N' Wrench,19,12,25.49,7
1023140,Artificiality-人造物-,4,0,3.59,4
1678910,The Nightmare Journey,2,1,5.39,1
2316450,Free Kick Football: 3D Soccer,1,0,0.84,1
954850,Kerbal Space Program 2,3287,3329,49.99,-42
2128050,Refund Me If You Can : Lexy's Story,5,0,5.99,5
1266030,The Pale Beyond,144,11,17.99,133
2294030,Samurai Sword Stage,1,0,0.99,1
1971650,OCTOPATH TRAVELER II,426,29,59.99,397
2167430,Puss in Combat Boots,2,1,27.99,1
2268960,GyroGunner,4,0,4.24,4
2165420,Ultra Blade,4,0,2.99,4
2257460,File Destined,7,0,7.19,7
1375020,Secret Of Dungeon,3,2,0.0,1
2284310,Elephantasy: Flipside,15,0,8.99,15
2285880,PARANORMAL GIRLFRIEND,3,1,4.97,2
2258260,Cache Grabbers,9,0,14.99,9
1742010,Ghosted,7,0,9.99,7
1747690,Faraway: Arctic Escape,2,0,4.49,2
844980,I Am Your President,68,35,13.49,33
2200620,Shopping Center Tycoon,24,0,5.59,24
2096510,The Ouroboros King,46,11,8.99,35
1598910,The Excrawlers,33,3,4.49,30
1526870,Otherwar,32,9,5.09,23
2236860,Basements n' Basilisks: Storms of Sorcery,77,0,2.69,77
2231900,Fateweaver: The Alchemist's Quandary,34,0,2.39,34
1952540,Voltaire: The Vegan Vampire,42,3,11.99,39
1825210,DESTRUCTURE: Among Debris,32,0,7.99,32
1896010,It's Hasegawa-san!?,25,2,1.79,23
2241250,流浪荒岛,3,1,3.74,2
1634220,Rytmos,15,1,13.49,14
2292720,EDEN: Create World,15,4,2.99,11
553540,Phantom Brigade,847,149,23.99,698
2309550,Fight With Keys,1,0,0.59,1
2206490,Ruined Kingdom,12,0,13.49,12
2081540,Rustled Pete,19,0,0.89,19
2104310,Public Land Hunter,12,0,3.99,12
1693930,浮世万千三天地情殇,9,0,14.99,9
2258380,Pact of Steel,3,0,14.99,3
2309890,Mahjong - Legacy of the Toltecs,1,0,4.49,1
1668290,Dungeons of Aether,134,36,13.49,98
2296850,First Person Hooper,7,0,4.49,7
2193630,The Final Bastion,3,0,9.99,3
2268800,Cockroach Simulator household survivor,10,0,0.99,10
1764700,ふりかけ☆スペイシー,31,0,13.49,31
2194940,Takenoko - Tilt Five AR,1,0,16.99,1
1080680,Cold Shell,14,0,8.99,14
2286260,Infinite Incantation,17,1,3.99,16
2243050,Small Town Detective,10,0,5.59,10
1196090,Scars Above,172,51,33.99,121
2240630,Sokoball Dreams,3,0,2.69,3
1831410,Poly Vita,5,0,5.09,5
2164100,So Much Stuff,1,0,5.59,1
2256900,Frack the World,12,0,3.19,12
2317570,Crazy Designer,0,1,7.99,-1
1953110,Programming Without Coding Technology 2.0,5,0,2.39,5
1138210,Esperia ~ Uprising of the Scarlet Witch ~,5,0,16.14,5
2249120,Blockappend,4,0,7.19,4
1840610,Apocalyptic Vibes,33,4,17.99,29
1970260,Presentiment of Death,20,0,14.99,20
1823730,Alephant,14,0,8.49,14
2310690,Extra Lives,9,0,2.99,9
1125830,We Are Screwed!,4,0,19.99,4
2138610,The Legend of Heroes: Kuro no Kiseki,8,0,59.99,8
1803600,Gone Rogue,29,0,9.99,29
2156410,Konkan Coast Pirate Solutions,7,0,7.99,7
1504840,Surprising My Neighbors 2,2,0,0.84,2
2149560,Unforgettable Voyage,6,0,3.99,6
2304550,Wheelie King 5,1,0,6.99,1
1896390,Stickman Trenches,123,33,4.97,90
2079680,Evolution Tale,0,1,3.19,-1
789150,Mask of Fury,0,8,7.99,-8
2310300,THE MEME HUNTER,10,2,0.74,8
2060230,Infested Fortress,3,0,19.99,3
2307630,Fremdganger - The Cheating Demon,3,0,9.95,3
2106610,The Smile Alchemist,3,0,17.99,3
1783360,Meg's Monster,121,1,13.49,120
1757700,三千世界,2,1,9.59,1
1068460,Stuffo the Puzzle Bot,13,0,7.99,13
2269700,Lilly's Flower Shop,1,0,6.99,1
2318760,Space Pop - Bubble Shooter,1,1,1.39,0
892840,OscarWildeCard,1,0,5.94,1
2209270,Moorhuhn Piraten - Crazy Chicken Pirates,2,0,3.99,2
2060750,Star Survivor,78,18,4.49,60
1918170,Arclight of City,14,0,6.99,14
2094320,Escape First Alchemist ⚗️,83,9,12.74,74
2318820,Simple Increment,2,1,2.54,1
1839880,King Of The Castle,141,12,4.99,129
2052780,Painter Simulator,2,0,8.99,2
2277910,I commissioned some bees 14,1,0,3.39,1
2304970,shita ni,4,0,4.99,4
2095130,LIQUID,3,0,3.59,3
2302960,The Castle Burns!,14,0,4.49,14
1814230,Belle Automata: Chronicle I,10,0,15.99,10
2303950,TRAUMA Broken Paradise,4,0,14.99,4
1134610,Dice Hero: The Unoriginal Story,3,0,1.79,3
2262770,Garten of Banban 2,374,262,4.99,112
1448440,Wo Long: Fallen Dynasty,4367,7101,59.99,-2734
2307080,Pasha Planet: Reborn,3,0,12.59,3
2202690,Gladiators and Glory,18,1,5.59,17
2185860,SokoChess White,17,0,4.49,17
2157680,Lunar Mirror:The Pavilion of Desire,432,22,8.99,410
1488510,VRNOID,2,0,15.29,2
2338600,Dark City: International Intrigue,3,0,3.49,3
2092330,Powerful Courses,27,0,11.99,27
1684110,Field of Arms: Tactics,3,0,11.99,3
2021710,Sakura Succubus 7,7,0,7.99,7
2291360,CalmLine,5,1,4.49,4
1588500,Rogue Sweeper,2,1,3.59,1
2217680,KOP KILLER 22XX,32,0,2.0,32
2322850,GOOD LUCK BABY!,1,0,14.99,1
1888330,Conur Life,18,1,5.99,17
1375290,Working Zombies Steam Edition,1,0,11.99,1
1705140,Final Profit: A Shop RPG,26,0,14.99,26
2271000,Rayland 2,16,0,1.59,16
2313660,Milo no Senki 3,1,1,5.0,0
2279390,Made in Ohio,10,0,0.99,10
2162130,Deck 'Em!,2,0,2.54,2
2129470,Knights of Pen and Paper 3,18,63,11.69,-45
1214470,Hotel Renovator,437,123,19.99,314
1948980,Hero's Adventure,2058,462,15.83,1596
1786930,Steelborn,41,3,13.49,38
1789340,Evil's Den: Forsaken Dungeon,4,3,3.99,1
1192810,Romancelvania,51,13,24.99,38
1920490,The Outer Worlds: Spacer's Choice Edition,76,243,47.99,-167
2190470,Russian Train Trip 2,5,12,5.27,-7
2238440,The Last Craftsman,2,0,8.99,2
1766720,Outlanders,31,4,14.99,27
2229350,Someday You'll Return: Director's Cut,7,1,19.99,6
2106840,PARANORMASIGHT: The Seven Mysteries of Honjo,110,4,15.99,106
596500,Chippy & Noppo,1,0,19.99,1
2255730,告死天使复仇之夜 Death Angel Nightmare,4,0,1.69,4
1582200,Sanctuary Saga,5,2,13.49,3
2211840,Stellar Sovereigns,10,4,24.99,6
2101190,ONI : Road to be the Mightiest Oni,11,23,26.99,-12
2253770,Grow Your Pets,1,0,4.24,1
2084590,Alkurai,9,1,5.99,8
2213980,Caverns of Mars: Recharged,5,0,9.99,5
1985810,Call of Duty®: Black Ops Cold War,486,164,29.99,322
2130460,FATAL FRAME / PROJECT ZERO: Mask of the Lunar Eclipse,381,50,49.99,331
2298080,Snafu,16,2,4.49,14
756800,Contraband Police,1462,92,17.59,1370
2316310,Ugmania,3,0,0.59,3
2000950,Call of Duty®: Modern Warfare®,261,160,29.99,101
2207640,Little Circuit,3,0,8.09,3
1085220,Figment 2: Creed Valley,56,2,21.24,54
1668310,24 Killers,36,0,14.99,36
2319370,Ultimate Anime Jigsaw Puzzle,2,0,2.39,2
1873870,IDEA,15,1,10.79,14
1146420,Relic Space,8,0,16.19,8
1742930,Looking Up I See Only A Ceiling,45,2,1.79,43
2058750,Monster Energy Supercross - The Official Videogame 6,29,22,49.99,7
2309010,Geko: Entering The Pipe,3,0,0.79,3
1831370,PolyShot,4,0,0.59,4
1967940,Germinal,22,0,14.99,22
2285570,Immortal Seeker,149,112,6.29,37
2285520,DOOMSDAY SURVIVORS,9,2,2.79,7
2327670,Pipe Dreams,22,0,1.49,22
2136550,HIGhSCORE,3,0,3.99,3
2180150,ITRP _ Aero Star,47,2,1.99,45
1374350,Tiny Troopers: Global Ops,7,3,15.99,4
2238710,Australian Football Coach 2023,2,0,17.99,2
1761780,Creepy Tale 3: Ingrid Penance,58,1,8.99,57
1644500,Masterplan Tycoon,124,33,8.99,91
2170100,Volley Pals,17,0,3.99,17
2323670,Jigsaw Puzzle Delicious Foods,12,0,0.69,12
1410090,Hellscreen,18,1,17.99,17
1430680,Clash: Artifacts of Chaos,99,7,29.99,92
2121050,Phantom Island,1,0,7.99,1
1885570,"Happy Live,Show Up!",16,0,34.99,16
1945730,K-Pop & Rock Band Manager,1,1,3.99,0
2292030,Little Garden,4,0,4.49,4
1583500,Eternal Dread 3,44,7,13.49,37
1331550,Big Ambitions,565,25,20.69,540
2306080,Kingdom of EXPLORERS,11,0,3.49,11
1189290,The Black Grimoire: Cursebreaker,42,1,13.49,41
1922980,Xheres,4,0,17.99,4
1944850,DC's Justice League: Cosmic Chaos,2,0,42.49,2
2087260,Living Legends Remastered: Wrath of the Beast Collector's Edition,1,0,8.99,1
2307120,Lovelorn sanatorium Ⅲ,333,72,7.19,261
1986390,Passed Out,105,18,9.59,87
1485690,Potion Tycoon,73,37,17.99,36
1366560,MiLE HiGH TAXi,36,26,14.44,10
2146500,Unluckily in Love,3,0,9.89,3
2009310,Goi: Let's Play Together,10,0,6.29,10
1376760,Life of Delta,30,7,17.99,23
2323560,HOW,2,0,5.99,2
2318440,Girls Tennis League,2,1,9.99,1
2164750,Kai Yuan,5,2,19.99,3
2023990,Triopticon三昧,1,0,10.99,1
2183070,Tokyo Necro,34,6,35.99,28
2230180,Escape Dream,5,3,3.99,2
1291860,Rough Justice: '84,25,5,17.99,20
1961760,My Girlfriend’s Special Place,27,1,13.49,26
1956430,Terminal Velocity™: Boosted Edition,11,0,11.99,11
1271310,The Forest Cathedral,5,0,14.99,5
2323580,Before The Green Moon,3,0,11.99,3
1546710,Vernal Edge,184,22,15.29,162
2225250,Slobbish Dragon Princess 3,17,0,13.49,17
2322470,Threesome Puzzle,0,1,1.39,-1
1687960,The Wreck,36,1,17.99,35
2185850,Richman 7,7,0,6.79,7
2137760,Crafty Survivors,58,4,3.59,54
1851610,River Tails: Stronger Together,5,0,15.99,5
2298210,Physical Layer,24,0,8.09,24
1849740,Stars Arisen,8,0,7.91,8
2185870,Richman 8,8,1,6.79,7
2328770,House Sitter Escape Game,3,0,8.49,3
1494810,Mortal Sin,164,5,15.99,159
2185840,Richman 6,6,10,4.24,-4
2294600,House Sitter,4,0,3.59,4
2104010,Elowen's Light,10,2,5.99,8
1317270,Walthros: Renewal,2,0,13.49,2
2283870,The Backrooms Experiment,4,2,7.99,2
1751970,A Blast From The Past,2,0,5.99,2
2257840,Arena Story～Rouge And Princess Knight～,9,0,8.09,9
1641240,Hero's Quest,45,4,2.99,41
2269980,FUR Squadron,3,0,6.29,3
2227180,Water 2050,1,0,3.99,1
2304510,TRASHMORFERS,3,0,7.19,3
2136950,Forklift Extreme: Deluxe Edition,8,0,5.99,8
2145720,Petit Petit Petit,0,1,4.49,-1
1942660,WWE 2K23,410,78,59.99,332
1998450,Black & White,183,61,13.49,122
2284000,Running Riot,3,0,2.99,3
2304570,Heavy Armored Assassin,2,1,0.99,1
2241980,Tanky Tanks 2,46,0,7.99,46
2285000,The MisAdventures of Xenos,1,0,4.24,1
1957780,Ghosts of Tabor,465,87,19.99,378
2328690,Psychic Investigation of Sakuragi Haru,0,1,6.99,-1
820520,Deceive Inc.,537,62,19.99,475
2342280,Ten Seconds Trillion,2,0,2.69,2
2317870,WWW,0,1,9.99,-1
1079300,Goblin Keep,1,0,17.99,1
2344350,Farm Day 2023,1,0,1.79,1
1947500,The Walking Dead: Saints & Sinners - Chapter 2: Retribution,251,97,39.99,154
2267260,Horror Explus,1,1,5.39,0
2311680,Magic Research,14,0,3.99,14
1917830,The Safe Place,7,1,11.99,6
1730930,Backrooms Exploration,9,3,12.74,6
2257770,Not For Broadcast VR,2,5,24.99,-3
2266020,Zombie Watch Part II,1,1,10.79,0
2215290,我在终点线等你,31,0,6.29,31
2307160,Yukiiro Sign,5,0,15.99,5
2332710,Brain Hole Girls,0,3,1.39,-3
1708110,Misericorde: Volume One,6,0,7.64,6
2227860,XenoWorld ~The Rondeau of Astra~,12,2,9.89,10
2331150,Legendary Realms: A Fantasy World Odyssey,2,1,1.99,1
1624540,Storyteller,524,201,13.49,323
1999770,Atelier Ryza 3: Alchemist of the End & the Secret Key,347,17,59.99,330
2344890,破洞小世界 呆望窗,1,0,0.59,1
2324230,Project Liminal Redux,8,1,1.19,7
2050650,Resident Evil 4,21231,723,59.99,20508
1985960,Ogu and the Secret Forest,50,3,16.19,47
2341920,三國立志傳2,11,0,7.99,11
1708320,GRAPPIN,3,0,11.04,3
2319470,A TAVERN FOR TEA,9,0,2.69,9
1565210,Buildest,17,0,11.69,17
2187130,Rabat Protocol:Metal Rhapsody,10,1,8.99,9
2330320,Aqua Marbles - Ocean,2,0,5.39,2
2272050,Fairy Biography3 : Obsession,135,9,4.75,126
2344020,Silver Box Classics,2,0,8.49,2
2326100,Reclusive,18,2,6.29,16
2350550,Spelljammer: Pirates of Realmspace,4,3,8.49,1
2216090,ZaBaTa!,4,0,4.49,4
879050,Drakkar Crew,18,0,7.49,18
2302680,Manacle | 猪仔,5,11,5.94,-6
2350530,Fantasy Empires,2,2,8.49,0
2340600,Industrial War,2,1,7.99,1
2350540,DeathKeep,2,1,5.09,1
2350520,DragonStrike,5,1,5.09,4
1968630,Stories from the Outbreak,31,6,11.69,25
2103620,Age of Gladiators Reforged,6,1,6.79,5
2266910,Chinese Expeditionary Force - Assault Team,0,2,4.99,-2
1866120,Heartwood Heroes,17,0,10.19,17
2340740,Future Front(Idle Game),110,49,2.69,61
1402120,9 Years of Shadows,369,75,19.99,294
2336310,KingMini,3,0,0.89,3
2138710,Sifu,1069,72,35.99,997
2292910,Final Dose,4,1,2.54,3
2051130,Ghostland Yard,29,0,10.39,29
1619570,Death Roads: Tournament,113,28,13.49,85
2127920,Super Greedy Cat,20,0,3.59,20
2091550,赌神模拟器：亚洲风云God Of Gamblers,33,100,12.95,-67
1801410,Deadnaut: Signal Lost,24,1,15.29,23
2322080,Banana Clicker,2,1,1.79,1
1139490,Summer Daze: Tilly's Tale,8,3,17.99,5
2224350,Celebrity Simulator,5,0,8.99,5
2344040,Lovers in Playa Rosa,2,1,6.39,1
1838490,Bullet Casters,18,0,3.99,18
1888930,The Last of Us™ Part I,9067,12035,59.99,-2968
1902300,DROP - System Breach,35,2,9.99,33
2320660,1000 Man General,1,0,8.99,1
711840,Johnny Chainsaw,15,0,2.99,15
1369720,Innchanted,43,5,16.99,38
1593030,Terra Nil,1194,226,24.99,968
2277310,Golden Rails: Valuable Package,2,0,5.94,2
2323060,Monster Factory,0,1,7.19,-1
768200,Smalland: Survive the Wilds,1177,248,22.49,929
2202110,Railways: Train Simulator,1,0,4.24,1
2187300,Active Soccer 2023,19,0,13.49,19
1702130,ACL Pro Cornhole,5,5,29.99,0
2085390,一九三零 浪漫譚,2,1,12.99,1
2347460,Survival Sprint,2,1,3.99,1
2284370,Pyramis,4,0,16.19,4
1546090,RAIDBORN,67,12,22.49,55
2350810,Glory Room,3,0,3.59,3
1923080,Cloak & Dagger: Shadow Operations,8,2,4.99,6
1211600,ZED ZONE,770,88,10.19,682
2011440,Adventures of DaKoo the Dragon,2,0,14.99,2
2351730,Idle Simple RPG,22,4,3.99,18
1336380,Gripper,34,5,17.99,29
2327690,The Orphan,2,0,2.99,2
2015360,Linked Worlds,13,0,12.74,13
2013120,1997,10,0,9.99,10
2264930,"『LACKGIRL I - Astra inclinant, sed non obligant.』",9,0,16.99,9
2327160,I commissioned some dogs,6,0,3.39,6
2229920,Temporian,11,1,8.99,10
2094550,Saga of Sins,18,5,12.74,13
2109370,The Great War: Western Front™,455,123,34.99,332
1579280,The Last Worker,18,6,17.99,12
1979570,Tomomon,5,2,22.49,3
2125160,Prison Life 2,9,1,10.79,8
1466060,Tainted Grail: The Fall of Avalon,312,88,26.99,224
2319250,Water tank| 貯水槽,3,0,4.0,3
1050370,LUNARK,44,5,17.99,39
1562430,DREDGE,1896,84,24.99,1812
2318830,Digital Diamond Baseball V11,3,0,21.24,3
2304310,BookyPets Legends,2,0,17.99,2
1872870,United Assault - World War 2,2,1,14.99,1
2288730,Vault City,1,0,4.99,1
1098610,Crush the Industry,47,1,9.89,46
1309080,INFINITE GUITARS,7,1,19.99,6
2212490,BulletLive,2,0,19.99,2
843390,Vertigo 2,250,4,29.99,246
2291760,Papa's Freezeria Deluxe,778,6,4.97,772
1498740,Troublemaker,236,12,15.99,224
2244830,Nautikin Adventures,1,0,13.49,1
2296870,Crimson Connect Origin,17,1,5.39,16
2314950,Pop Some Eyes,1,0,2.39,1
2154400,Aery - Calm Mind 3,20,0,7.99,20
2069920,The Dawn is Inevitable,7,0,6.29,7
2141040,Formula Retro Racing - World Tour,6,2,11.99,4
2334850,SHIRIME: The Curse of Butt-Eye,15,1,3.59,14
1617010,Solbane,1,1,6.29,0
2330500,BETON BRUTAL,13,0,5.59,13
2281410,江城创业记,146,23,10.79,123
774801,Crab Champions,1211,19,8.49,1192
2265120,无限投影2,11,3,2.99,8
1632530,Adventures of  The Carrot Captain,10,0,18.0,10
2280320,Amigo: Kebab Simulator,27,5,10.99,22
1716600,Brinefall,24,23,16.99,1
2057550,我在地球修仙有系统,340,111,13.49,229
1835240,Spiritfall,225,27,16.19,198
1501690,Dice Kingdoms,44,3,13.59,41
2058850,Traveler's Game,7,0,7.19,7
2058090,The Game of Fourtune,1,0,24.99,1
1525580,Kabaret,4,0,19.99,4
1195420,Filthy Animals | Heist Simulator,69,11,15.99,58
2333590,Mystery Case Files: The Dalimar Legacy Collector's Edition,1,0,12.59,1
2225600,Race Code,3,0,4.99,3
1194810,Meet Your Maker,1018,215,29.99,803
2359720,Figure Workshop,1,0,2.69,1
2328110,4 Seasons Runner,8,0,1.19,8
1571100,Passpartout 2: The Lost Artist,201,11,19.99,190
2184220,The Wolf of Derevnya,2,0,4.97,2
2356050,学園ハンサムFighters,13,1,3.99,12
2365110,Text Twist 3,4,0,2.99,4
2359570,Hard to make a romantic cartoon!,6,1,22.49,5
1364690,First Racer,17,0,1.69,17
1835260,Brewmastery: Tavern Simulator,1,6,8.99,-5
2365660,The RailIdle,5,0,5.39,5
2312400,Money Maker,0,1,1.99,-1
1883800,The Magical Mixture Mill,43,8,15.99,35
2113450,"Forests, Fields and Fortresses",8,0,3.99,8
957950,1971: Indian Naval Front,3,2,13.49,1
2345920,蕾拉 Layla,1,0,1.99,1
2290000,TerraScape,83,9,9.74,74
1837340,Grimgrad,19,15,14.44,4
2310400,Gender Dysphoria,7,0,3.0,7
2362790,The Dungeon Vendor,1,1,7.99,0
2071280,Ravenswatch,1039,510,17.99,529
1339340,The Unbeatable Path,8,1,17.99,7
2339180,Rescue Agency: The Kidnapper of happiness,5,0,11.47,5
2308820,Qualification as Rogue,0,1,8.99,-1
1822030,The Library of Babel,15,6,17.09,9
1736120,Gambit!,10,17,17.99,-7
1074030,Melon Journey: Bittersweet Memories,21,1,13.49,20
1453900,Curse of the Sea Rats,23,28,17.99,-5
2366030,My Dear Dad 父亲,1,0,2.39,1
1365720,Kujlevka,46,1,17.99,45
2085040,ToriDori,24,0,4.24,24
2301850,Story of Animal Sprite,20,1,8.09,19
1358700,STRANGER OF PARADISE FINAL FANTASY ORIGIN,288,32,39.99,256
2324730,Necogram,0,1,0.79,-1
1677350,EA SPORTS™ PGA TOUR™,83,132,69.99,-49
2120320,Wayhaven Chronicles: Book Three,31,11,7.91,20
1646070,Undeadly,9,1,15.99,8
2302050,First Light,1,1,6.29,0
2287350,Chief Emoji Officer,20,0,2.99,20
2061430,Oxygen,64,10,13.49,54
2272290,Bottoms Up!: Part 1,1,0,2.99,1
2347380,Witch's Garden,29,0,22.49,29
2334340,Apex Armor Swap Trainer,17,0,0.84,17
2354900,Dark Dead,14,1,0.59,13
2343960,巫族 WITCH RACE,9,1,7.19,8
2219800,Mechaneer Resta's Grand Adventure,17,1,13.49,16
2280540,The Last Saintess,41,6,4.99,35
2102490,Basketball Club Story,19,3,8.99,16
2264310,Christmas Night,12,2,5.99,10
2339020,Magic City Detective: Rage Under Moon Collector's Edition,0,1,13.99,-1
1409300,Rendezvous,21,0,12.99,21
1934040,Miniland Adventure,89,30,10.99,59
2168200,NervBox,4,3,14.99,1
1685730,Cynthia: Hidden in the Moonshadow,49,5,13.99,44
2088030,Long Dream,273,2,6.99,271
2338860,VIRA,9,0,0.9,9
2166050,Moonleap,190,1,8.99,189
2355050,Save District 3,57,4,1.99,53
2176880,Road To Devadatta,24,2,9.99,22
2244050,Paint By Pixel,1,0,6.99,1
1727270,Murderous Muses,16,5,13.99,11
1974290,Sentinels of Earth-Prime,22,0,17.99,22
2364030,Crystal Blast,19,1,14.99,18
2156300,Unscripted,48,30,12.99,18
1118110,Coal Mining Simulator,48,74,14.99,-26
2302670,重返越南,4,0,0.99,4
2144290,Idle Gem Quest,7,0,0.99,7
1949030,Sherlock Holmes The Awakened,365,43,39.99,322
1772830,Rusted Moss,228,36,19.99,192
2371750,That Rocket Game,12,0,0.99,12
2109430,Tron: Identity,109,15,14.99,94
2369140,绝影-Vanishing Shadow,33,21,6.99,12
1469540,Maximus 2: Street Gladiators,15,1,4.99,14
2202760,Rogue Valley,1,1,14.99,0
2372080,Deep Dark Dungeon of Anglaus,10,1,1.99,9
2198070,Cardboard Town,334,46,19.99,288
1811990,Wildfrost,2572,935,19.99,1637
1795470,Flooded,53,3,11.69,50
2115610,If only I could go home early,28,1,1.99,27
2375930,Simple Multipliers,5,2,2.99,3
1504090,Ascendum,5,0,13.99,5
1893370,GHOSTWARE: Arena of the Dead,44,5,14.99,39
2133870,Golfinite,15,2,9.99,13
2094270,Lightracer Spark,276,67,12.99,209
1091920,Plantera 2: Golden Acorn,400,17,4.99,383
1567000,illWill,56,8,19.99,48
1911360,Trinity Fusion,38,6,24.99,32
1968710,MEATGRINDER,106,12,9.99,94
2370100,Smash Room,1,0,4.99,1
1649740,Hunt the Night,177,56,19.99,121
1364020,Boundary,7228,2536,22.49,4692
1651560,Fabledom,894,113,15.99,781
762370,Everything is going to be OK,7,0,5.99,7
1798020,Mega Man Battle Network Legacy Collection Vol. 2,139,11,39.99,128
1194250,Screaming Chicken: Ultimate Showdown,62,5,14.99,57
1183800,Shardpunk: Verminfall,254,13,11.99,241
2337140,Can't Live Without Electricity,8,1,4.99,7
1798010,Mega Man Battle Network Legacy Collection Vol. 1,456,38,39.99,418
2373770,Unknown,4,1,0.99,3
1922010,Breachers,378,33,29.99,345
1905220,Kill It With Fire VR,24,2,14.99,22
1797630,Dance of Cards,21,2,9.99,19
2118370,Bosorka,127,7,5.99,120
2287960,Stigmata of Sacrilege,33,20,9.99,13
2363140,ForeVR Pool VR,1,1,19.99,0
1687730,IRON WORLD,6,3,5.99,3
2329130,Rewind Or Die,117,8,11.99,109
2239870,Small People Defense,3,0,3.99,3
2211410,RivenWorld: The First Era,12,4,19.99,8
2114350,Is It Wrong to Repay the Debt in a Dungeon?,50,7,17.99,43
2345630,The Gap,37,3,2.99,34
2376070,Quadrium,3,0,5.99,3
2081970,Swirl W@tch,12,0,13.49,12
2145190,ENERGY SURVIVORS,18,6,2.54,12
1815290,Hitman Party,2,0,6.99,2
2109340,Pixel Game Engine,11,1,26.99,10
1611960,Doomed Lands,12,0,9.59,12
1714250,Pets Hotel,62,3,15.29,59
2368510,Soulvester VS Lil' Beezey,14,0,0.84,14
1929250,Armechgeddon,10,0,3.49,10
1804610,Recollection,36,0,4.49,36
2135870,WarpVector,1,0,4.99,1
2269290,What Is Sleeping In My Room?,3,1,2.69,2
1463780,Mohism: Battle of Words,212,29,8.99,183
1730080,Beyond the Long Night,49,18,14.39,31
2231550,The Traveler's Path,13,0,1.59,13
2326960,Battle of Hořice 1423,7,2,5.99,5
2378840,HAELE 3D - Feet Poser Lite,9,1,9.74,8
1928870,Minecraft Legends,833,532,39.99,301
1899350,Trade Bots: A Technical Analysis Simulation,9,0,10.19,9
1681060,Exogate Initiative,62,25,20.69,37
1457080,The Mageseeker: A League of Legends Story™,731,146,29.99,585
2313420,Jewel Match Aquascapes Collector's Edition,2,0,11.04,2
1976950,Desktop Dungeons: Rewind,260,44,16.99,216
2330970,Zippy Detective: Cats,19,0,0.89,19
1234180,Moons Of Darsalon,51,1,16.71,50
2340800,Life Changer,2,1,19.99,1
1217410,孟德大小姐与自爆少年THREE KINGDOM FANTASY,182,53,7.19,129
1277230,Crying Pony,13,4,8.09,9
1967630,Survival: Fountain of Youth,144,31,20.69,113
2377210,Little Turrets,10,0,2.99,10
2354930,Counterclocking,1,0,11.99,1
2302820,FAS: Fight Action Sandbox,9,0,6.99,9
2344240,StreetStep: 21st Century Basketball,8,0,8.99,8
1308360,GUN JAM,14,18,17.99,-4
1569810,24 Solar Terms,19,6,6.29,13
2356350,Grand War: Rome,5,0,11.69,5
2379730,Edelweiss,11,0,3.59,11
1434540,Zoeti,26,0,17.99,26
2249040,Blood Moon,19,1,5.03,18
2207490,Factory Town Idle,47,3,4.49,44
2164390,Skader,2,0,9.99,2
2366530,Flashpoint Campaigns: Southern Storm,9,2,44.99,7
2318480,Last Train Outta' Wormtown,7,0,7.99,7
1214670,Mr. Sun's Hatbox,60,10,13.49,50
2321210,Neon Echo,860,95,14.99,765
2020710,Havendock,109,5,15.29,104
2358750,Forsaken Woods,1,0,2.99,1
2301210,Busway Islands - Puzzle,7,0,2.0,7
1827640,DINO MERCS,3,0,5.59,3
1669980,Volcano Princess,1726,25,9.34,1701
1608640,OTXO,203,13,13.49,190
1860510,Total Conflict: Resistance,119,24,26.99,95
1969650,Formula TOP,5,0,10.39,5
1956800,Thriving City: Song,224,67,17.09,157
2074000,One Eleven,14,0,14.99,14
2197020,Remote Planets,9,0,8.99,9
1701520,Afterimage,700,218,24.99,482
1432380,Lichenvale,18,4,7.19,14
2297650,Re:Fresh,29,1,3.74,28
2345380,100% Challenge,12,0,1.19,12
506480,Archmage Rises,86,19,25.49,67
986130,Shadows of Doubt,1207,128,17.99,1079
2346490,Loop,18,0,0.89,18
2001110,Roguematch : The Extraplanar Invasion,13,1,11.99,12
2341410,Wizard's Way Out,19,0,2.67,19
740310,Transmogrify,5,0,24.99,5
1267210,Together in Battle,7,1,13.49,6
2009650,Desta: The Memories Between (Dream Team Edition),8,0,14.44,8
2382870,Elevator,0,2,1.99,-2
2176320,Magical Drop VI,29,9,26.99,20
1074190,Dragon Spirits,81,18,7.99,63
2386330,Cat Search in Medieval Times,10,0,1.69,10
2176930,Trinity Trigger,14,4,49.99,10
2379030,Barro T23,2,0,2.39,2
2162020,Strayed Lights,64,15,22.49,49
1245560,Roots of Pacha,547,41,22.49,506
2166060,Amanda the Adventurer,447,21,8.09,426
2341330,Lost Alone Ultimate,10,4,14.99,6
1414230,"Oddyssey: Your Space, Your Way",9,1,19.99,8
2246330,Rescue Team: Magnetic Storm,3,0,5.94,3
1321440,Cassette Beasts,509,21,17.99,488
2384380,Family Farm 2023,0,1,1.79,-1
1834010,Desktop Hacker,2,0,13.49,2
2358520,Contraptions 2,1,0,6.99,1
2193090,Witch Rise,8,0,3.99,8
2159730,The Forgotten Concluder,280,53,34.99,227
1493750,Evil Dead: The Game,221,99,19.79,122
2386520,Pixel Tank,1,0,1.99,1
2227520,Hookscrap,1,0,0.99,1
2014380,LIVE A LIVE,48,4,39.99,44
1824580,Dungeon Drafters,143,41,24.99,102
2353280,FANTAVISION 202X,9,3,17.99,6
1623940,Bramble: The Mountain King,258,7,26.99,251
2003880,The Creepy Syndrome,8,0,4.49,8
2339220,Mini Taoism,4,0,10.19,4
2126400,Super Kill-BOI 9000,7,0,1.79,7
2224910,Auver,1,0,2.24,1
2360020,Kao the Kangaroo (2000 re-release),39,8,1.99,31
1774580,STAR WARS Jedi: Survivor™,4536,4652,69.99,-116
2184650,AbsentedAge2:アブセンテッドエイジ２ ～亡霊少女のローグライクアクションSRPG -依代の章-,1,0,9.09,1
2248120,Light and Shadow - Doppelganger,11,2,17.09,9
1861630,Junk Survivor,9,2,15.29,7
1293460,Ash of Gods: The Way,97,14,22.49,83
2319050,闪客快打8武装行,6,8,4.99,-2
2023360,The Last Case of Benedict Fox,101,28,19.99,73
2321310,Hidden Cats In Town,5,0,1.59,5
2281540,Japanese Rail Sim: Operating the MEITETSU Line,9,6,8.99,3
1948090,Chernobyl: Origins,38,1,10.19,37
1295730,Leveling up girls in another world,2,1,14.99,1
1492120,Summit,0,1,3.99,-1
2263430,DarkBlood -Gaiden-,1,0,6.99,1
2079950,残秽的我们2：普渡慈航,35,0,7.19,35
1822560,Minabo - A walk through life,21,0,13.49,21
2149420,Dino Trauma,11,1,12.99,10
2353660,Blood Sunset,5,0,6.99,5
2318920,Re:Touring,1,0,8.99,1
2343480,Just Find It,1,0,5.59,1
2358280,So Much Stuff 2,1,0,5.59,1
2279310,Pixel Town: Akanemachi Mystery 2,15,0,7.99,15
1933180,Varney Lake,9,0,9.99,9
1296490,"Don't Take It Personally, I Just Don't Like You",2,0,17.99,2
2114970,Skinny & Franko: Fists of Violence,22,2,17.09,20
2326210,Innkeeper's Basement,1,0,6.29,1
2341030,Grim Tides - Old School RPG,1,0,5.09,1
2091300,Raimodula,4,0,9.99,4
1906510,Arto,26,1,15.99,25
2368860,Paws of Coal,15,0,4.49,15
2246110,Q REMASTERED,59,1,6.29,58
2094580,We. The Refugees: Ticket to Europe,16,1,13.49,15
2380870,PieClicker,6,1,2.99,5
2247580,The Last Vagabonds,2,0,0.99,2
1470390,City of Beats,48,1,15.99,47
1277920,Ethyrial: Echoes of Yore,187,468,0.0,-281
2086140,RICE - Repetitive Indie Combat Experience™,73,18,1.97,55
2395380,DUCKLYTE,3,0,0.59,3
1783930,Civatlas,1,3,17.99,-2
2100560,Karl Marx and the Ring of Communism,3,2,1.29,1
1550010,The Witch of Fern Island,61,17,15.99,44
1512050,World Turtles,18,2,15.99,16
1294810,Redfall,715,1809,69.99,-1094
2106910,Gods Of Defense,11,4,12.74,7
1673090,Vagabond,27,3,13.49,24
2377520,2D Dogfight,5,0,4.99,5
1515330,Monster Tribe,34,17,13.99,17
2384940,Pixel Madness,4,1,0.69,3
2340010,Ritual,3,5,4.49,-2
2393670,Magic Toenail,2,0,3.39,2
1669000,Age of Wonders 4,3823,737,49.99,3086
2270410,Farmburgh,1,0,3.99,1
2389600,Tuya,2,2,1.99,0
2142450,Z.O.N.A Project X VR,17,0,14.99,17
1155330,Showgunners,141,14,26.99,127
2395370,Survival Shooter,16,0,0.59,16
2132520,The Magic World,1,1,13.99,0
2370330,Linia Stripes,4,0,2.99,4
2395580,三国吞天传 幻想姬武神战记,3,0,6.29,3
2211730,KILLBUG,80,0,6.99,80
1566200,Tape to Tape,474,70,17.99,404
2362120,Finding Hannah,18,0,5.24,18
1837580,Mia and the Dragon Princess,39,15,11.69,24
1179580,KAKU: Ancient Seal,138,19,22.24,119
1651490,Tiny Life,67,5,12.74,62
2314580,Jigsaw Puzzle Fever,2,0,7.99,2
2056340,Room of Depression,70,10,3.59,60
1494420,Silica,467,158,19.99,309
1667180,No Man's Island,8,3,7.99,5
2262610,Endless Monday: Dreams and Deadlines,103,0,8.99,103
1423000,NeuroNet: Mendax Proxy,17,2,16.39,15
1186660,Bare Butt Boxing,14,3,14.99,11
1840790,Metal Mutation,31,7,14.44,24
2236590,Psionic Awake,20,2,3.99,18
1649130,Knight Crawlers,37,16,17.99,21
2376740,200 DAYS Zombie Apocalypse,2,4,5.39,-2
1849360,SGS NATO's Nightmare,12,2,23.99,10
2352040,FatSheep Crisis,9,2,3.19,7
2397400,Unnatural Season Two,0,1,6.02,-1
1824960,Propagation: Paradise Hotel,94,14,19.99,80
1999470,THE LAST HUMAN IS A BIKER,6,0,1.99,6
1375900,Swarm Grinder,55,9,6.39,46
2053600,挑战不死之王,1,0,3.99,1
2238740,After Stream,4,1,4.24,3
2346890,Bananaguy,6,0,3.99,6
2311190,Garten of Banban 3,413,238,4.99,175
2391040,Teacher Certification Hell,11,6,3.39,5
2228340,Burning Secrets - A Bara Visual Novel,11,0,4.49,11
1940340,Darkest Dungeon® II,3265,1058,39.99,2207
2055910,Poosh XL,148,0,2.99,148
2234890,Urbex Night Security,10,2,4.49,8
1387900,Duru – About Mole Rats and Depression,8,0,17.99,8
2167550,Creeping Deck: Pharaoh's Curse,5,1,13.49,4
1730250,Pan'orama,141,22,11.19,119
1347310,Swarm,4,4,17.49,0
1547670,A Day Out,34,10,8.7,24
2397700,Crystal of Atlantis,2,0,5.39,2
2163400,Magecraft,5,0,2.54,5
1159690,Voidtrain,802,399,26.99,403
1606350,Chess 432,15,2,4.49,13
2392060,Idle ShowOff,20,0,1.77,20
758690,Occupy Mars: The Game,365,141,21.24,224
2370380,D-World Gate,8,0,2.63,8
2380360,MathLand,1,0,5.39,1
1230170,Gunsmith Simulator: Prologue,327,51,0.0,276
2334780,CANINE,20,0,2.99,20
2001340,Fuga: Melodies of Steel 2,45,0,39.99,45
1997120,BountyHeart,5,0,4.49,5
2254140,Project Screwed,2,0,14.99,2
2305520,Project Drift,5,5,1.19,0
2378310,DIVINE PEARL™: Survivors,1,1,4.49,0
1924170,TT Isle Of Man: Ride on the Edge 3,71,30,49.99,41
2400280,富甲天下4,52,27,9.99,25
2369250,Little Army,1,0,3.99,1
2096570,Another Fisherman's Tale,9,1,19.99,8
2144830,Voodolls,3,2,11.99,1
2349830,Touhou: Gensokyo Survivors,33,4,0.99,29
1972050,Band Camp Boyfriend,17,0,17.99,17
2327190,I commissioned some bees 15,2,0,3.39,2
2369390,Far Cry® 6,935,347,15.0,588
2096620,Death or Treat,19,9,22.49,10
669330,Mechabellum,406,32,11.99,374
2371480,VR Tractor Farming,1,0,4.79,1
2279710,Logicats,16,0,1.39,16
1978720,Ultimate Ragdoll Game,17,0,2.54,17
2271200,Assault On Proxima,5,0,13.49,5
2400570,Unalive 010,1,0,4.49,1
2159650,Drift,16,3,15.99,13
2303810,Obscurite Magie: The Blood of Kings,18,1,13.49,17
1559600,The Ranch of Rivershine,60,1,26.99,59
2373220,"Spriters, Hopes Blooming Dawn",1,0,5.94,1
2407800,Demon Scrolls,2,0,11.69,2
1928090,Cook Serve Forever,74,67,26.99,7
2365880,TORIDAMA: Brave Challenge,4,2,6.39,2
2410420,KIDNEY STONE Clicker,1,1,3.06,0
2362420,Mass Effect 2 (2010) Edition,9,8,7.5,1
2225430,V-Hunter Puzzler Dx,12,0,2.69,12
2191100,Crimson Song - Yuri Visual Novel,21,0,1.79,21
1581480,Humanity,75,4,29.99,71
1383370,Trail of Ayash,16,4,16.99,12
2404760,Turbotron,4,0,0.59,4
1924400,Hand of Doom,33,1,9.99,32
1925090,SubwaySim Hamburg,98,109,29.74,-11
1831700,Tin Hearts,22,3,23.99,19
2375160,I Am Sakuya VR: Touhou FPS Game,5,0,7.99,5
2300600,Abandoned World,2,0,8.39,2
2409810,Blood Gazm,4,0,0.84,4
2408610,Paint by Pixel 2,1,0,5.59,1
2279020,Resident Silent,0,2,2.99,-2
2362980,Morbid Catastrophe,2,0,2.99,2
2392140,Eye of Saccharine,4,0,1.99,4
1268750,Starship Troopers: Extermination,5910,461,24.99,5449
2406860,Nova's Cube!,2,0,2.54,2
2116150,The American War,4,0,7.99,4
2016280,MatchR: Now Hiring,13,0,7.64,13
2416920,Groob,1,0,1.99,1
2390670,ASSASSIN: The First List,1,2,29.99,-1
1895820,Greedventory,67,21,17.99,46
2412700,It Is Ticking,6,0,6.99,6
1786010,AETHERIS,10,0,20.74,10
2409850,Cubic Figures,1,0,3.19,1
1724770,Castle Of Alchemists,113,9,11.99,104
2307220,TSUNDERE MILFIN,52,3,2.09,49
2384280,Love Love Joe Biden: The Joe Biden Dating Simulator,10,0,2.79,10
1725340,Elypse,80,12,13.49,68
2278640,Love on Leave,4,4,22.49,0
1829370,Death Horizon: Reloaded,8,1,16.99,7
2217420,AQUA KITTY UDX,14,5,6.29,9
2305880,Hexapoda,1,0,12.99,1
1304930,The Outlast Trials,6451,378,29.99,6073
1451810,LEGO® 2K Drive,99,82,59.99,17
2008100,Rule the Waves 3,154,5,39.99,149
2404420,七楼幸存者,2,7,3.59,-5
754890,Firmament,224,106,31.49,118
2115850,Last Holiday,77,98,29.99,-21
2013170,friends world,2,0,2.79,2
2420230,Multiplayer Military,2,0,0.69,2
2248760,Car For Sale Simulator 2023,290,59,16.19,231
2281360,Old Coin Pusher Friends 2,53,5,3.59,48
2159670,maboroshi caravan,8,1,2.99,7
2331110,No Crime,2,1,6.99,1
2314650,Grey Haven,11,3,16.99,8
2348170,Kuroinu Redux,116,23,15.99,93
2078510,VIVIDLOPE,42,0,9.99,42
1810510,Just Survival - The Zombie Awakening,0,4,29.99,-4
2271980,Adorable Witch5 : Lingering,172,77,7.28,95
2408200,Zenful Journey,4,1,1.19,3
1483320,Railroad Engineer,3,2,7.99,1
2390520,Trans Neuronica,12,1,8.49,11
2344630,Galactic Conquest Battle Infinity,12,0,5.99,12
1952590,Future Racer 2000,24,0,3.99,24
2084460,Annie and the AI,15,0,7.64,15
1062810,Inkbound,433,90,19.99,343
2383710,Caveman Ransom,2,0,3.74,2
1616110,Glitch Busters: Stuck On You,21,1,17.99,20
1388580,Blooming Business: Casino,60,23,18.74,37
2404550,Charge!,7,1,1.59,6
1565880,Turbo Shell,10,0,9.95,10
2180340,Haishan,11,5,9.89,6
2154650,Pawperty Damage,155,16,4.49,139
1608230,Planet of Lana,471,34,17.99,437
1724980,The Lone Blade,13,0,7.99,13
1649010,Miasma Chronicles,224,91,49.99,133
1607680,Bread & Fred,166,18,13.49,148
2423960,Lord of the Click: Interstellar Wars,13,1,2.09,12
2005010,"Warhammer 40,000: Boltgun",4008,230,19.79,3778
1406810,After Us,44,10,29.99,34
1276800,CONVERGENCE: A League of Legends Story™,183,18,29.99,165
2409690,Kingmaker Academy: Warrior's Duels,12,1,0.84,11
2228390,Fairy Fencer F: Refrain Chord,20,4,44.99,16
2434480,Mystery Case Files: Incident at Pendle Tower,1,0,9.99,1
2097740,AKAIITO HD REMASTER,19,4,13.99,15
1662710,Oldowan,3,1,11.99,2
1276130,Twilight Struggle: Red Sea,3,5,13.49,-2
1796870,SHINOBI NON GRATA,28,0,14.99,28
2218750,Halls of Torment,715,34,4.49,681
1730240,Cruise Ship Manager,26,18,8.49,8
2097750,AOISHIRO HD REMASTER,9,2,13.99,7
2099280,Metro Manager LA,2,1,7.99,1
2099880,Approval,0,2,29.99,-2
2282740,BATSUGUN Saturn Tribute Boosted,8,1,26.99,7
1739930,Marlon’s Mystery: The darkside of crime,32,0,9.99,32
2380810,INTERNULL,3,0,6.29,3
2197360,Hot Heat Reset,4,0,4.49,4
999340,Nature Hunter,3,0,19.99,3
1789090,Hello Goodboy,26,0,11.99,26
1276740,Protodroid DeLTA,32,7,19.99,25
2398020,Tuk Tuk Race,2,0,3.19,2
1964040,Do Not Feed the Monkeys 2099,177,22,12.74,155
2417090,Memoryland Prelude,1,2,7.99,-1
1589120,Above Snakes,279,120,22.49,159
1644320,Railway Empire 2,213,128,49.99,85
2280390,Tennis Manager 2023,39,0,35.99,39
2146070,Lorena and the Land of Ruins,12,3,13.49,9
1265780,The Lord of the Rings: Gollum™,124,220,49.99,-96
1561040,Diluvian Winds,77,19,16.19,58
2415950,Pegafuerte el terrible,5,0,7.49,5
2306630,Frontline: Panzers & Generals Vol. I,4,0,9.99,4
2225520,爆裂！スイーツランド - PANIC IN SWEETS LAND -,2,0,24.99,2
1592100,Evil Wizard,45,7,17.99,38
1709350,Bat Boy,41,2,14.99,39
2206320,Hello Neighbor VR: Search and Rescue,47,26,29.99,21
1596730,Dynopunk,41,1,13.49,40
2103480,Summer Trip Cruise,43,0,11.69,43
2300160,Death From Above,74,2,9.99,72
1687840,Heliopolis Six,4,1,15.29,3
1520420,The Hopebringer,0,1,8.49,-1
1577050,Hijack Overdrive,13,0,9.74,13
1747560,Chronicles of 2 Heroes: Amaterasu's Wrath,14,0,19.99,14
1859860,Party Bots,50,1,11.99,49
1853410,The Shape of Things,19,2,5.94,17
2380490,Pengun,7,0,2.39,7
2161130,Rerun,6,1,7.99,5
1816390,Rebirth evolution,31,10,8.99,21
2422150,Speedway Challenge 2023,15,1,10.99,14
1667750,Frigato: Shadows of the Caribbean,11,13,10.19,-2
2109060,Magenta Horizon,38,1,9.34,37
2250550,Tornado: Research and Rescue,41,7,11.99,34
1537080,Return,62,6,17.99,56
1850160,Poly Bridge 3,159,10,17.99,149
2358790,Survival & Horror: Hangman's Rope,9,2,6.49,7
1536980,Glass Masquerade 3: Honeylines,106,8,4.99,98
2243670,Return to Grace,19,2,13.49,17
1363900,Farworld Pioneers,121,176,13.49,-55
2323810,DEFENDUN,7,0,4.19,7
1888450,Shop-Like - The Rogue-Like Item Shop Experience,18,1,6.79,17
1546060,My Summer Adventure: Memories of Another Life,18,1,6.79,17
2257170,Disaster Area,6,2,3.39,4
1785150,Friends vs Friends,1741,420,5.99,1321
1403650,Everdream Valley,189,33,22.49,156
1455450,To Hell With The Ugly,17,3,17.99,14
2427470,Red Moon: Survival,21,4,12.59,17
2026000,Our Adventurer Guild,3,0,9.99,3
1299510,Vampire: The Masquerade – Swansong,26,22,29.99,4
2179770,Unboxing,2,0,1.49,2
2384720,Astebros,4,0,16.99,4
2416460,Unknown Memoirs: The Rental,9,1,0.84,8
482400,System Shock,2278,174,39.99,2104
2429220,Haunted Hotel: Personal Nightmare,0,1,8.99,-1
2014690,Shame Legacy,45,27,21.24,18
2406610,Three of Us 我们仨,7,3,2.54,4
2411430,不和我推谈恋爱就会死？！,2,0,0.99,2
1868180,Etrian Odyssey HD,158,5,39.99,153
2157250,Monsters 'til Midnight,15,8,3.99,7
2187160,Touhou Mini Map,4,2,2.99,2
1426010,STASIS: BONE TOTEM,121,4,15.99,117
1431850,The Tartarus Key,23,1,19.99,22
2417160,Just Skill Shooter,10,0,5.99,10
1868170,Etrian Odyssey II HD,17,2,39.99,15
1672310,Decarnation,128,15,13.49,113
1389520,Cinderstone Online,2,3,24.99,-1
1955520,Escape from the Marble Monster,2,0,6.29,2
1316150,IVAN POE,1,0,0.0,1
922050,DOOMBLADE,37,4,14.99,33
2380130,Tears Fall Low,3,0,8.99,3
1810820,Etrian Odyssey III HD,75,5,39.99,70
1730700,We Love Katamari REROLL+ Royal Reverie,245,8,29.99,237
1646380,Comrades and Barons: Gates of Freedom,4,0,17.99,4
2144260,Mobius' radio waves,2,1,8.99,1
2356450,A Street Cat's Tale 2,5,1,14.39,4
2358600,Death Harvest,4,0,8.09,4
2235340,Urban Flow,3,0,5.39,3
2319390,Kvark,12,0,14.39,12
1455510,Dragon's Hoard,6,0,10.39,6
2397690,Blooby Block,7,0,4.24,7
1959350,Homebody,43,1,19.99,42
2318310,Class of '09: The Re-Up,19,1,14.99,18
2413230,Liminal Space,3,2,2.69,1
1634100,No More Rainbows,4,0,19.99,4
1931020,Slayers X: Terminal Aftermath: Vengance of the Slayer,228,4,15.29,224
2208220,Mislight,5,1,7.99,4
1737220,Myriads: Renaissance,6,1,17.99,5
2419220,Gnome,4,1,8.09,3
824090,TailQuest Defense,16,0,8.99,16
1364780,Street Fighter™ 6,4374,467,59.99,3907
2097490,DESORDRE : A Puzzle Game Adventure,11,0,8.49,11
1487210,Super Mega Baseball™ 4,62,31,49.99,31
2424820,The Adventures of LinShanHai - Chapter5:Three Trees,1,0,1.79,1
2354830,Wise Garden,8,0,9.99,8
2191480,Jumbo Airport Story,29,5,8.99,24
1008860,Repella Fella,60,0,15.29,60
2263950,Vegan Rebellion,1,0,4.49,1
2406970,The doll,4,0,0.79,4
2179520,クラブ・スーサイド,18,0,11.99,18
1095290,Zombie Soup,52,2,13.49,50
2414350,The Summoning,1,0,5.09,1
2414340,Star General,2,0,5.09,2
2290300,Chest,12,0,3.59,12
1944430,Amnesia: The Bunker,1368,141,24.99,1227
2206820,Tokyo Pinball,2,0,2.69,2
2313270,Blightlands Blacksmith,1,1,0.0,0
2441120,Viking Heroes 4,1,0,5.94,1
1543280,Espresso Tycoon,132,13,17.99,119
2235150,Brain Show,9,2,14.99,7
2422840,A Whisper in the Twilight: Chapter One,4,0,9.99,4
2443360,Zortch,27,0,4.99,27
2063610,Pro Cycling Manager 2023,15,4,39.99,11
2433380,YGGDRASILL,2,0,2.54,2
2410260,Death Rabbit Arena,3,0,19.99,3
2345040,Labyrinth of Axarith,2,0,2.99,2
2100160,MotoGP™23,61,22,49.99,39
2024890,"Reincarnated in a stone in a different world, I want to protect the girl, so I will be strong",1,3,11.99,-2
2062690,Tour de France 2023,4,4,39.99,0
2290180,Riders Republic,379,182,15.0,197
1966420,Harmony: The Fall of Reverie,17,3,22.49,14
2441670,Carnival in the hut,3,0,0.64,3
2426800,Pressure Washer,1,0,9.99,1
2436190,Survivors Will,8,0,1.19,8
2404920,Lonely Path,2,0,5.99,2
819190,Undead Citadel,47,29,26.99,18
2416720,Quadrium 2,1,0,5.39,1
2422540,Burning Branch,7,0,9.99,7
2341800,Magic and Machines,2,0,2.99,2
1905020,Greyhill Incident,69,147,24.99,-78
2439010,Unibat,1,0,6.29,1
1762570,Space Reign,53,11,17.99,42
2425010,Astra And The New Constellation,11,1,3.91,10
2421300,侠客春秋,28,7,2.25,21
1947240,Ashen Arrows,3,0,17.99,3
1917810,Rooms of Realities,7,0,14.99,7
2420140,Crushing Depths,0,2,2.99,-2
2442860,Math & Topology,1,0,1.79,1
1790360,Heist Kitty: Multiplayer Cat Simulator Game,26,10,11.99,16
2333390,Cricket Captain 2023,3,3,29.99,0
2403370,|][-@I7 in vitro #デッド・インヴィトロ,3,0,1.19,3
2407200,OVERWHELMED,11,0,3.99,11
1366650,COLD DEPTH,12,3,8.69,9
2305490,THE SEGMENT TWINS,8,0,10.79,8
2436380,FOX ADVENTURE ~HOMEWARD JOURNEY~,1,0,1.99,1
1124160,VR Giants,34,0,16.19,34
2211260,Something's Out There,2,1,3.99,1
1542110,Daydream: Forgotten Sorrow,71,9,17.99,62
2396530,Brainroll,7,0,2.69,7
1234040,DUBIUM,75,16,14.99,59
1309990,Creature Lab,76,51,17.99,25
1946700,Layers of Fear,209,59,25.49,150
2231060,Druidwalker,10,1,2.69,9
2456230,Night Terrors,0,1,4.49,-1
1299540,The Zone: Stalker Stories,4,1,6.99,3
2444660,Four Lights,2,0,19.99,2
2353680,Dice World,6,0,4.99,6
2393900,Story Of Infinity: Xia,6,0,5.99,6
2360690,Pixel Ripped 1978,3,0,24.99,3
1368130,Park Beyond,124,103,49.99,21
2379390,Tom Clancy’s Rainbow Six® Extraction,237,140,10.0,97
2442670,SS.Archives,1,0,1.79,1
1306060,Golf Club Architect,2,0,14.99,2
2418000,Combat Mission: Red Thunder,10,2,50.99,8
1039280,ProtoCorgi,22,0,6.99,22
1710540,Fall of Porcupine,52,6,16.99,46
2108330,F1® 23,770,115,69.99,655
671860,BattleBit Remastered,7213,818,14.99,6395
2367230,[Chilla's Art] Night Security | 夜間警備,80,10,7.99,70
2437080,Stardust Defenders,3,0,4.99,3
2113220,Voxel Miner: Dwellers of The Deep,4,0,4.99,4
2119590,Deducto 2,34,1,4.99,33
2372380,勾八麻将(J8 Mahjong),108,64,1.69,44
2452750,Medical Record Sheet,6,0,3.99,6
2412730,Biomech Hell,3,0,5.59,3
2304620,Backrooms Society,22,3,6.29,19
2312380,Steel Racer,15,0,3.99,15
1150440,Aliens: Dark Descent,2059,257,39.99,1802
2196850,Soul Survivor: Trials of the Goddess,7,0,8.49,7
2371400,Tuttle: Star Flower Harvest,3,0,5.99,3
2051640,The Merchant's Guide to the Kingdom,10,6,17.49,4
1456000,Goodbye Dr. Sanchez,3,3,4.24,0
1569970,Fireball Wizard,3,0,6.29,3
2431490,英雄之旅,9,2,3.59,7
1996880,I Made Myself An AI,1,0,8.09,1
2460000,Sakura in Paris,3,0,5.59,3
2320500,Chloé’s Requiem -encore-,10,1,12.99,9
1164940,Trepang2,1316,59,29.99,1257
1832130,VINE,13,0,12.74,13
1133040,Bandit Brawler,7,8,8.99,-1
1293660,Gemini: Binary Conflict,14,0,16.99,14
1532200,Mars First Logistics,135,3,17.99,132
1515020,Kingsblood,14,0,12.74,14
2399600,The Wonderful One: After School Hero,4,1,9.99,3
2444600,Times Of War,1,0,5.99,1
2228030,Dr. Fetus' Mean Meat Machine,32,12,8.99,20
1548850,Six Days in Fallujah,2326,526,39.99,1800
1457030,Casino Resort Tower,11,0,17.99,11
2383760,Monopoly Madness,13,12,7.5,1
1641960,Forever Skies,580,72,23.99,508
1910860,Grimlord,66,6,23.99,60
1452020,Yuri Dating Agency,8,0,3.19,8
2410740,Creepless,12,0,3.99,12
2347960,D Life,3,0,5.94,3
1432100,The Bookwalker: Thief of Tales,180,7,13.49,173
2251580,"I, the Forgotten One",32,0,5.03,32
2444000,Ramen Oil Pecking Simulator,61,9,0.82,52
2447820,Survivor's guilt,12,1,2.79,11
1672880,Hookah Cafe Simulator,15,15,7.99,0
1597720,Feed All Monsters,45,0,2.39,45
2152780,Impeachment Survivors,9,0,2.69,9
1892570,Colored Effects,5,0,4.49,5
1709080,Dating Simulator,15,11,3.99,4
1501610,Nova Lands,293,22,17.99,271
2399220,NUKITASHI,147,5,19.99,142
1590230,Tyrion Cuthbert: Attorney of the Arcane,22,0,15.99,22
2454020,Mimi the Cat - New Friends,13,0,2.09,13
2456340,太公传承,2,0,2.69,2
2313780,Bad Dream: Purgatory,5,1,6.29,4
2431100,That Which Gave Chase,23,1,4.66,22
2130550,LET ME OUT,5,1,3.19,4
1881610,江湖客栈-The Jianghu,665,496,19.99,169
1956040,Kingdom Eighties,544,213,10.79,331
2064850,Lifespace Traveler,4,0,12.74,4
2022230,Yomi 2,9,1,24.99,8
1811500,LOOPERS,113,4,17.99,109
1670810,Life Not Supported,27,9,16.14,18
1977740,My Little Sister's Special Place,17,0,13.49,17
1465550,One Lonely Outpost,146,48,15.99,98
1941100,Amarantus,19,1,16.19,18
2336200,Choo Choo Survivor,62,11,2.69,51
2348260,Raging Bytes,8,5,14.99,3
2468990,Idle Ultimate,0,1,7.99,-1
2109570,Bombing!! 2: A Graffiti Paradise,9,0,19.99,9
2291390,Peaceful Lands,1,2,2.39,-1
2084000,Shogun Showdown,245,10,8.99,235
2111170,STORY OF SEASONS: A Wonderful Life,245,81,49.99,164
2079320,Other World Survivors,64,15,3.59,49
1781500,NoRoY,3,0,7.69,3
2274480,Merchant of the Six Kingdoms,12,0,9.74,12
1876460,Salty Hounds,19,46,19.99,-27
2232650,Expand & Exterminate: Terrytorial Disputes - Endless Base Defense,5,1,11.99,4
2172900,Little Friends: Puppy Island,15,1,39.99,14
2342830,Skedaddling In Egypt,4,0,3.99,4
1164830,A Long Journey to an Uncertain End,11,0,21.24,11
2468800,Don't let Him In,4,0,4.99,4
2464670,Take No Prisoners,3,0,7.99,3
2364520,Tamageddon,3,0,3.0,3
1306770,Revival: Recolonization,27,7,26.99,20
1967430,Ghost Trick: Phantom Detective,74,4,29.99,70
1410330,Love Shore,1,1,14.99,0
1956680,Axial Disc 2,3,0,11.24,3
1707670,Square Word: Summer Edition,3,0,3.59,3
2466400,REC: Beyond The Lens,8,7,1.79,1
2460730,Future Offline,2,0,2.99,2
2468780,TEAM SIX - Armored Troops,3,0,7.99,3
2238210,Sergeant Squidley: Space Cop!,4,0,14.99,4
1735490,実録パワフル野球拳スラッガー山田,5,0,0.99,5
2448270,Mars Survivors,12,6,3.99,6
1586990,Alterium Shift,16,2,15.99,14
2321420,房间的秘密2：起点,2,1,2.99,1
2460660,A Dark Room ®,2,0,6.99,2
2315990,孵化之地 wild eclosion,2,1,6.29,1
2460310,Wendigo,6,0,3.99,6
2428690,Neon Parkour 2,10,0,1.49,10
2107040,Rumple Town,10,0,2.99,10
2019020,Alight in the Dark,1,0,8.49,1
2419880,Honey Are You There?,5,0,2.99,5
2468160,My Eggs,7,0,8.0,7
2452940,Approaching Cao Army,1,0,2.54,1
2311070,Devil's Dive,12,0,3.99,12
2444840,Cryptid,11,0,8.49,11
2153160,Blind Sound,2,1,3.59,1
2336720,Greed of Man,63,140,19.49,-77
2295290,Delivery Kore,5,3,14.44,2
2446700,Doomies,1,0,5.99,1
2477170,仙途,3,1,5.99,2
2327480,Backrooms: Realm of Shadows,3,2,7.99,1
2347410,Earth Defender,5,2,17.99,3
2484430,Undomestic,5,1,17.99,4
2477770,Summer Party Time,1,0,6.29,1
2138090,Atelier Marie Remake: The Alchemist of Salburg,86,12,49.99,74
2396510,Castaway Station,1,0,11.99,1
1574310,OXENFREE II: Lost Signals,301,23,14.99,278
2250410,Battle Bows,1,1,19.99,0
2430110,Sapiens Craft,3,0,0.99,3
2220690,Life of Slime,8,0,4.49,8
2010000,Nock,10,3,19.99,7
2413840,Cute Capybaras,16,0,0.59,16
2487950,Mecha Kucha Gacha Defence,0,1,3.99,-1
2481610,枪神细胞 Gunnery Cell,1,0,0.59,1
2150660,Touhou: New World,40,13,22.49,27
1286320,Exoprimal,398,174,59.99,224
2008990,Call Hating,1,0,13.99,1
2468030,Throwback,1,0,24.99,1
2435960,Hitler Waifu,5,0,0.59,5
2009450,Invector: Rhythm Galaxy,25,3,22.49,22
1084160,Jagged Alliance 3,807,188,44.99,619
2172260,The Complex: Expedition,303,18,9.99,285
2317820,Feudal Friends,180,58,7.99,122
2303350,Sticky Business,707,10,8.99,697
2489990,Jeepney Simulator,69,2,4.49,67
1539140,STONKS-9800: Stock Market Simulator,127,5,8.99,122
2317330,"Trance, Trauma",11,5,5.39,6
2422090,Treasure Chest Clicker,17,0,3.59,17
1997250,Evergreen - Mountain Life Simulator,15,13,19.99,2
2442060,Nightmare Zapping,24,0,4.24,24
2093970,犬神ディフェンダーズ / Soul Dog TD,9,3,11.69,6
2191490,Pocket Academy 3,27,0,8.09,27
2412190,Meaningless,14,0,6.99,14
2484360,"Please, Forgive Me",33,2,6.99,31
2294950,Kill The Cute,10,0,3.99,10
2284410,Back alley chronicle,5,1,3.55,4
2467190,三國立志傳3,25,4,7.99,21
1515640,Arcadegeddon,116,33,13.49,83
2326820,Shaper,2,0,4.49,2
1926270,Bloodhound,91,27,12.74,64
2464090,Purrfectly Hidden Cats - Kittenwood,33,0,0.89,33
2371280,Tether,6,0,1.99,6
2475820,Strange Investigations: Secrets can be Deadly Collector's Edition,0,1,13.99,-1
2430730,My Child Lebensborn Remastered,33,0,7.19,33
1181610,Roto Force,31,0,7.19,31
1457320,Techtonica,331,81,25.49,250
1574260,My Friendly Neighborhood,578,19,26.99,559
1664810,Gluua,18,27,9.99,-9
1859580,Full Void,37,1,14.39,36
2495700,FLOWFALL,1,0,1.29,1
1926090,Coreborn: Nations of the Ultracore,141,48,18.99,93
538030,Xenonauts 2,439,152,29.99,287
1382070,Viewfinder,1136,94,24.99,1042
2395150,Demon Lord Reincarnation,30,8,7.19,22
2424650,Froggy's Battle,45,0,1.79,45
2406360,SpeedOverflow,20,0,4.49,20
2111090,Let's! Revolution!,73,2,16.99,71
2435020,Onka,2,0,3.99,2
2480930,The Experiment,12,3,1.79,9
1389200,Cramped Room of Death,8,0,14.99,8
1764400,Tea For God,12,0,19.99,12
2319920,Cantirium: God Slayer,3,2,11.99,1
1101120,Gunsmith Simulator,277,57,17.99,220
2437950,Around Us : Zombie Shooter,1,0,2.69,1
2216130,沉默的蟋蟀,55,7,13.49,48
2348100,"YEAH! YOU WANT THOSE GAMES, RIGHT? SO HERE YOU GO! NOW, LET'S SEE YOU CLEAR THEM!",113,12,9.99,101
2106560,Cross Tails,11,1,26.99,10
2429530,Crystal Tower Defense,5,0,9.74,5
1620870,Outer Space Shack,2,2,24.99,0
2110820,Granny Remake,31,6,6.29,25
1584940,Lakeburg Legacies,167,117,19.54,50
2140050,SGS Battle For: Stalingrad,4,0,16.99,4
1708340,BlazingAngel Mistletear,1,0,15.99,1
1161590,Punch Club 2: Fast Forward,355,70,19.99,285
1210470,The Adventures of Bluke Bifton: Chapter 1,10,0,5.99,10
1554650,DROS,17,0,16.99,17
2143050,Red Line,19,1,7.99,18
2132350,Train World,2,1,31.49,1
2312780,Toleo,6,0,9.99,6
1530800,Frank and Drake,8,0,19.99,8
2213300,Might & Magic: Clash of Heroes - Definitive Edition,43,28,15.29,15
2496920,开局一只蛋,3,0,15.99,3
2472870,Doctor Cat,4,0,1.59,4
1851560,Stillborn Slayer,6,0,9.89,6
1481700,Private Property,1,2,11.04,-1
817020,Unholy,37,23,23.99,14
2348280,Whispike Survivors - Sword of the Necromancer,12,6,2.69,6
2475980,GOBLiiiNS5,6,0,10.99,6
2320400,Darkzan Arena,4,0,7.99,4
2075160,BOSSGAME: The Final Boss Is My Heart,18,0,8.49,18
1860350,Dream Swing,31,0,2.69,31
1478970,AI Olympius,4,1,12.74,3
2093000,Homeseek,40,16,24.99,24
1155100,Latte Stand Tycoon +,5,0,6.29,5
756300,Gym Empire - Gym Tycoon Sim Management,8,0,13.99,8
2458530,魔女的夜宴,491,16,27.64,475
2289400,MAD WAY,40,2,8.99,38
2370540,My Klutzy Cupid,6,0,26.69,6
2027330,GoreBox,191,14,2.99,177
1736290,Crime O'Clock,29,3,16.99,26
2295570,Shy Cats Hidden Orchestra,16,0,4.49,16
1376910,Super Catboy,68,15,7.99,53
1851470,Ikkarus and the Prince of Sin,11,0,8.99,11
2154290,Simantik,15,4,8.09,11
1144130,Smash Dungeon,6,1,11.04,5
1481910,Time Bandit – Part 1: Appendages of the Machine,22,0,8.99,22
2000160,Music Store Simulator,36,9,21.24,27
1387500,Offroad Mechanic Simulator,89,11,16.99,78
2321000,Beacon's Bluff,0,4,2.99,-4
2273880,Arms Evolution: ZOMBIE DESTROYER,112,42,5.09,70
2375080,Sakura Bunny Girls,11,0,7.49,11
1605520,The Black Pepper Crew,15,1,6.99,14
2498630,The Frozen Garden,6,3,4.49,3
1740230,Furquest,37,3,14.99,34
2410820,Too Many Sheep,6,0,1.69,6
1780100,Nonorelia,1,0,19.99,1
2500750,Only Climb: Better Together,119,142,4.24,-23
2132540,Mr. Run and Jump,21,0,22.49,21
1574870,USC: Counterforce,30,1,19.99,29
2250170,Probo Rush,7,0,4.49,7
2249340,互联网大亨 Internet tycoon,14,7,6.0,7
2076630,Basalt Breaker,5,0,4.99,5
2490690,Jump Tracks,1,0,3.99,1
2341070,The Banished Vault,47,7,22.49,40
1480810,Crimson Tactics: The Rise of The White Banner,55,15,23.99,40
2469610,Forklift Simulator 2023,0,3,4.79,-3
1282100,Remnant II,9295,2372,49.99,6923
2363680,Green Squares,3,0,1.99,3
2171500,Great Ambition of the SLIMES,10,7,10.79,3
1068410,Super Intern Story,6,0,17.99,6
2505820,主动防御(Active Defense),2,0,0.84,2
2234640,Native Hunter,6,0,16.19,6
2450570,End of Edge,79,31,2.63,48
2348360,Grisaia Chronos Rebellion,6,0,39.99,6
2206270,Vampire Hunters,43,7,9.99,36
2507540,Mystery Box: The Journey,5,0,4.24,5
2390650,Boomeraxe,12,0,1.99,12
1937500,Let's School,1032,116,17.99,916
1895880,Ratchet & Clank: Rift Apart,2301,422,59.99,1879
2485170,Vicious Star: kill All,2,1,2.54,1
1880330,Sanfu,7169,1270,9.89,5899
2452350,Hamboy : AutoChess Survivor,5,2,2.99,3
2262990,Manager can be Tough!: Case of the Kidnapped Waitress,6,2,9.74,4
874450,Lunacy: Saint Rhodes,32,20,15.99,12
1793260,Delivery INC,53,11,12.74,42
2496000,FRACTALS OF DESTINY,7,0,24.99,7
2443300,Elite Status: Platinum Concierge,3,2,4.79,1
1425590,HYPER METEOR,3,0,6.79,3
2468960,The Old House,1,0,0.59,1
1819450,Koa and the Five Pirates of Mara,71,2,16.99,69
691790,Arcadian Atlas,37,29,25.49,8
1974300,One Deck Galaxy,3,0,11.04,3
1805130,Komorebi,41,1,17.99,40
1779760,Moka Future,19,6,3.59,13
2317300,Access Denied: Escape,6,0,4.49,6
1654810,Mix Universe,2,0,19.99,2
2397950,蒼い夏休み,3,2,4.99,1
2208960,Gravity,2,1,3.99,1
2259210,Mega City Police,92,15,12.74,77
1052230,CONCLUSE 2 - The Drifting Prefecture,5,1,14.99,4
2409410,I commissioned some unicorns,2,0,3.39,2
2242310,Folcroft Monastery,7,0,3.59,7
2374590,Sugar Sweet Temptation,30,0,21.24,30
1551600,Nifa's First Mission,18,6,8.99,12
2480680,Touchly Volumetric VR Video Player,1,0,6.29,1
2324610,Xanthiom Zero,9,0,3.99,9
2442040,Swapshot,7,0,1.59,7
2365810,Pseudoregalia,457,13,5.99,444
2301330,Demonic Supremacy,4,0,5.94,4
2379850,Super Box Delivery: Beyond the Horizon,5,0,2.99,5
2444470,Terminal 81,14,1,4.49,13
2502680,ハクスラダンジョンⅢ,1,0,13.99,1
2280810,Doug's Nightmare,8,0,4.49,8
2074750,All-In-One Summer Sports VR,1,0,19.99,1
2406400,ぼくは人狼になりたい,2,0,4.99,2
2336980,Enjoy the Diner,46,1,10.99,45
2281870,Digs,21,2,11.99,19
1566070,The Radiants,22,1,15.29,21
2455060,Taboo Trial,101,12,12.74,89
1903290,Premortal VR,2,1,26.99,1
2476330,Guilty Me,22,2,3.59,20
1681600,Cornucopia,30,1,22.49,29
2303500,MF-01 Aerostrike,3,0,4.97,3
1421490,Rise of the Triad: Ludicrous Edition,195,6,15.99,189
2433150,LOOP LOOP ROOM,2,0,5.39,2
1698850,Mage Tower 2: Call of Zadeus,5,0,14.99,5
2443780,Settlemoon,60,7,13.49,53
1660850,Flesh,4,0,8.99,4
2408890,The Life of a Magical Circle,3,0,5.99,3
1619420,Diebrary,13,3,4.99,10
1774380,Cine Tracer 2,1,1,89.99,0
2418780,Your Spaceport!,1,1,6.29,0
2082510,Bunker 21 Extended Edition,22,1,6.79,21
2480000,Nightshift Survival,16,0,1.69,16
2418630,The haunted hospice,4,0,11.89,4
2366850,DAIR,5,0,2.99,5
2493980,The Friends We Left Behind,8,0,9.99,8
1913370,OPERATOR,190,80,19.99,110
2086910,Verses of Enchantment,11,1,15.99,10
2497610,Mandemon,75,1,2.39,74
2515240,Welcome to Kowloon,110,30,6.29,80
2519850,Pigsaw,7,0,3.99,7
1628610,Paquerette Down the Bunburrows,170,1,9.95,169
1633860,Firebird,18,0,9.59,18
2090980,Ninja or Die: Shadow of the Sun,9,4,13.49,5
2348880,春待ちトロイダル,11,0,6.99,11
2514430,School Bus Driving Simulator,1,0,0.69,1
1467920,A Guidebook of Babel,112,6,12.74,106
2456280,this morning I decided to die,28,3,1.39,25
2239150,Thronefall,1594,52,6.29,1542
2522760,Music Man 2: New land,8,3,1.79,5
2296550,Axon TD: Uprising - Tower Defense,49,3,17.99,46
2416290,PLONG,16,0,4.49,16
1950490,Nova: Cloudwalker's Tale,23,0,8.49,23
2520680,Collision Paradise,1,0,1.39,1
2515910,Laruaville 14,1,0,8.99,1
2432110,WHITE ALBUM: Memories like Falling Snow,117,3,22.49,114
2516770,My First Craft Survival,6,1,4.99,5
2498570,Canvas of Kings,27,0,18.99,27
2318680,SokoSolitaire,14,0,4.49,14
2303290,A Slug's Dream,2,0,8.99,2
2456130,Demon's Bane,1,0,2.24,1
1897480,Devil's Island,4,0,8.99,4
1624550,Betty & Earl,14,0,7.99,14
2085240,Dance Hero: More Jiggle,1,0,4.99,1
2500760,かぞえ飯,14,0,2.39,14
2303470,Wildwood: A Town Building Game,2,0,20.99,2
2390000,Alchemist's Fantasy R ~ A Girl's Alchemic Furnace ~,17,0,13.49,17
2242710,Koi x Shin Ai Kanojo,130,4,26.24,126
1284130,Sclash,52,7,7.64,45
2218400,Greedland,211,31,9.89,180
2244080,erozld,14,1,13.49,13
2509500,Neon Idle,1,1,2.99,0
2153020,Pilfer: Story of Light,9,0,8.99,9
2304650,The Scrap,0,1,13.49,-1
2414640,Bite Size Terrors: Erobos Heaven,4,2,4.49,2
2519670,Wind Love,30,0,4.85,30
2079180,VIDEOVERSE,59,0,12.99,59
1895970,Robotherapy,22,2,4.99,20
2305970,Королевская ночь,28,5,2.99,23
2227030,Penny Larceny: Gig Economy Supervillain,42,1,11.99,41
2528840,Void Runner,22,5,6.99,17
2514470,My Mundane Life Is Threatened by the Tropes of an RPG!!!,19,3,4.99,16
1083790,Deathbulge: Battle of the Bands,219,2,19.99,217
2146490,Swarmcade,15,0,3.99,15
2270120,HiveCorp,19,1,7.99,18
2474180,Save the settlers,19,6,9.99,13
1658040,I Am Future: Cozy Apocalypse Survival,989,93,14.99,896
2217580,New Star GP,134,5,17.99,129
2475810,Knight Cats: Leaves on the Road,3,1,9.99,2
2525680,PP,108,10,0.99,98
2087610,UFO: Unidentified Falling Objects,50,0,14.99,50
1230530,Atlas Fallen,789,444,49.99,345
1104920,The Man Came Around,31,0,12.49,31
2213500,Sven - Completely Screwed,28,3,14.99,25
1920780,Stray Gods: The Roleplaying Musical,736,43,29.99,693
2380230,THE JUSOU,15,8,9.99,7
2300380,Shadow of Ether,2,2,10.99,0
1620520,Mondealy,207,11,11.99,196
2343000,Wyrd Gun,1,0,4.99,1
2413500,The Last Seal,1,0,7.99,1
2316900,Metavaxx,15,4,5.99,11
1147330,Lifeless Moon,93,16,19.99,77
1652250,Tales & Tactics,428,80,17.99,348
1702010,Sengoku Dynasty,1505,602,29.99,903
2490910,富甲天下5,66,41,7.99,25
1077510,Breaking Box,70,2,9.99,68
2164930,Doll Explorer,43,2,9.99,41
1981160,BANCHOU TACTICS,40,8,19.99,32
1916710,Synthwave Racers,17,0,12.99,17
1988550,To The Core,1379,95,7.99,1284
2535640,Mystery Box: Escape The Room,3,0,5.99,3
2383120,Garten of Banban 4,717,307,9.99,410
2442020,Dangeresque: The Roomisode Triungulate,201,2,7.99,199
2494480,Truth of Beauty Witch -Marine's treasure ship-,74,5,4.99,69
429380,Space Mechanic Simulator,48,23,14.99,25
2479000,Noise-o-matic,19,2,4.99,17
1571130,Captains of the Wacky Waters,16,0,19.99,16
2314060,Haunted Hotel XVI: Beyond the Page Collector's Edition,2,0,13.99,2
2400340,Touhou Juuouen 〜 Unfinished Dream of All Living Ghost.,703,58,14.99,645
2497210,PUSHER - Drug Tycoon,45,4,5.99,41
1424600,Verne: The Shape of Fantasy,71,9,14.99,62
596090,Gray Destiny,36,0,3.99,36
1829850,Crystal Tales Tactics: Echoes of the Libertas War,1,0,12.99,1
2246880,STANDBOX,275,22,7.99,253
2324370,12 Labours of Hercules XV: Little Big Adventure,4,0,11.99,4
2476670,New Yankee: Mary's Dark Side,3,1,3.49,2
1905530,Hammerwatch Anniversary Edition,87,13,19.99,74
2533320,Living Legends: Bound by Wishes,2,0,9.99,2
1753510,Cavemen Tales Collector's Edition,2,0,14.99,2
1450900,Desynced,457,72,29.99,385
2476730,Myriad Mayhem,13,1,6.99,12
2051210,Crow's Nest,3,0,12.9,3
1239950,Astronaut: The Best,23,2,14.99,21
1641700,Moving Out 2,50,9,29.99,41
2273430,BlazBlue Entropy Effect,2371,391,19.99,1980
1538970,Hammerwatch II,830,444,24.99,386
1581680,Stories of Blossom,5,1,16.99,4
2064490,Art Reborn: Painting Connoisseur,202,1,6.99,201
2525170,Mystical Riddles: Ship From Beyond Collector's Edition,1,0,9.99,1
2528520,Jank Cube VR,21,4,2.99,17
2205850,"Dwarves: Glory, Death and Loot",463,126,11.99,337
2201940,Ship Graveyard Simulator 2,408,98,19.99,310
1340480,The Cosmic Wheel Sisterhood,789,42,17.99,747
2299450,Apothecary Hero,5,0,5.99,5
1654660,En Garde!,684,42,19.99,642
2369880,Dungeon Survival,12,6,3.99,6
2492380,Shooting Game Builder,6,0,24.99,6
2455370,Russian Village Simulator,28,4,7.99,24
2281650,An Ankou,131,7,4.99,124
1983970,Affogato,543,90,16.99,453
2140330,Madden NFL 24,411,952,69.99,-541
2088650,Mist Slayer,197,80,17.99,117
1351210,Gord,154,177,34.99,-23
2522520,Only Up: With Friends,166,58,4.99,108
2436390,GameDev Trash,10,2,11.99,8
1820470,The Wratch's Den,20,4,5.99,16
1545560,Shadow Gambit: The Cursed Crew,1515,77,39.99,1438
2358770,Million Monster Militia,24,1,4.99,23
2305130,The Danger Zone,8,2,5.99,6
1028310,BOOK OF HOURS,1356,85,24.99,1271
1856190,Hello Engineer: Scrap Machines Constructor,61,17,14.99,44
2094600,Nowhere: Mysterious Artifacts,38,13,14.99,25
2411390,Top Villain: Total Domination,10,1,5.99,9
1171690,Wayfinder,6688,8110,19.99,-1422
2446510,Untold Atlas: otome sim inspired by expedition adventures,3,2,13.49,1
2430690,Clover Day's Plus,355,9,34.99,346
2529510,Fish on the desktop,79,1,0.99,78
2524610,Кукуево / Kukuevo,106,15,2.0,91
2425290,Project Third Eye,42,13,11.99,29
2180550,Dragon Princess is Hungry,89,3,19.99,86
1353230,Bomb Rush Cyberfunk,5570,103,39.99,5467
2377420,Eris Dysnomia,82,5,12.99,77
2439760,要来点百合吗 Love Yuri,251,39,2.99,212
2082350,Vectorio,85,4,9.99,81
2535970,League TD,43,3,3.99,40
1419060,Retchid,18,2,24.99,16
1407180,Lawgivers II,98,30,24.99,68
1932260,No Creeps Were Harmed TD,52,9,19.99,43
2206230,Galaxy Kingdoms,12,1,6.99,11
1433140,The Texas Chain Saw Massacre,6937,1454,39.99,5483
2008980,XENOTILT: HOSTILE PINBALL ACTION,143,3,14.99,140
2072660,Voidborn,92,6,12.99,86
2425920,GanaBlade,45,1,4.99,44
2524480,Cozy Space,214,15,7.99,199
2539960,Orbo's Odyssey,607,6,6.99,601
2441270,Kill The Crows,353,13,4.99,340
2278010,Six Ages 2: Lights Going Out,56,0,22.49,56
1867510,WrestleQuest,102,29,29.99,73
2009100,Immortals of Aveum™,325,123,59.99,202
2140100,Whisker Squadron: Survivor,144,7,14.99,137
2539840,Ping Pong Deluxe,3,0,2.99,3
1504250,Paper Planet,112,9,14.99,103
1893820,Jumplight Odyssey,281,150,29.99,131
1873200,Towers of Thana,1,0,14.99,1
2192620,ghostpia Season One,30,1,19.99,29
1911220,Smurfs Kart,6,6,29.99,0
2191410,For the Crown,1,0,9.99,1
1931730,Fort Solis,444,182,24.99,262
2450100,Journey to the West Survivor,168,13,5.99,155
2177570,Stone Age: Digital Edition,10,5,14.99,5
2367780,Mystery Solitaire. Grimm's Tales 9,1,0,0.74,1
2063120,Box To The Beat VR,17,1,19.99,16
2022140,Rev to Vertex,5,8,23.8,-3
2497510,Detective Montgomery Fox: The Case of Diamond Necklace,3,0,9.99,3
2323540,Mirrored Souls,9,0,14.99,9
1837650,Chicken Journey,47,0,9.99,47
406160,Dust Fleet,26,10,15.99,16
2506480,Clue/Cluedo,48,5,14.99,43
2520560,Killon,11,0,10.99,11
2539090,Cosmo Rider,22,2,3.99,20
2273170,Gaia Trek,246,44,7.99,202
2490790,Joyville,116,49,9.99,67
1684270,It's a Wrap!,22,1,17.99,21
2326070,Rush for the Ages,9,0,5.99,9
2519990,Idle Build RPG,24,11,4.99,13
2090760,X Invader,116,37,4.99,79
1549690,SPRAWL,193,42,14.99,151
2396330,Forbidden Magic,1,0,4.99,1
2022990,Flying Shark,15,0,7.99,15
1888160,ARMORED CORE™ VI FIRES OF RUBICON™,23716,4194,59.99,19522
2103680,Mediterranea Inferno,8,0,14.99,8
2472140,ALL Chess,31,5,9.99,26
2114740,Blasphemous 2,2390,163,29.99,2227
1786070,Edge of War,32,7,12.99,25
2386350,Marauder of Dystopia: The weakest go to the wall,30,11,9.99,19
2274500,Love Too Easily,25,6,21.99,19
600510,GINSHA,14,1,15.99,13
2009780,War and Peace,23,9,34.99,14
1650010,RIDE 5,188,99,59.99,89
742420,Saints Row,1578,865,29.99,713
2364770,Kingdom Incremental,12,13,9.99,-1
2464120,YUME 3,246,59,4.99,187
2495670,Panda Choice Mahjong,1,0,4.99,1
2257510,Pure Gore (Sandbox&Playground),6,0,5.99,6
2314720,[Chilla's Art] Parasocial | パラソーシャル,345,16,7.99,329
2283380,Charrua Soccer - Pro Edition,31,1,8.99,30
2247570,Don Duality,158,60,12.74,98
2312650,Devoid Prototype,1,0,20.0,1
1551670,Samurai Vandalism,197,55,24.99,142
2080690,Sunkenland,2521,942,19.99,1579
2253200,The Devil's Face,8,2,3.99,6
2358100,九霄风云录 Legends Of The Divine Land,20,10,5.99,10
2338740,WarBox: Arcane,2,1,14.99,1
1496310,Poached : Hunt The Hunter,16,0,2.99,16
2307660,Moving In,0,1,4.99,-1
2509370,Cleric and Goblins,26,7,9.99,19
2226610,Aggregator Elevator System,2,0,3.99,2
2401580,拾光集,12,3,5.5,9
2471130,Obsidian,7,2,9.99,5
1244090,Sea of Stars,1202,164,31.49,1038
1975440,Under The Waves,156,35,29.99,121
1538900,Untamed Tactics,71,4,16.99,67
2179860,Prison City,10,2,16.99,8
2063850,Block Buster Billy,4,0,9.99,4
1474770,Strategic Mind: Spirit of Liberty,16,2,25.49,14
2546480,Infinity Islets,1,1,11.99,0
1161830,Age of Reforging:The Freelands,63,19,22.49,44
2140850,Looper Tactics,165,13,9.89,152
2391640,Binding of Elements,6,0,6.29,6
2357950,Q2 HUMANITY,31,1,19.99,30
2556230,Dreamscape Puzzles,7,1,1.99,6
2494510,Stream to 3D,5,2,34.99,3
1696440,The Matchless Kungfu,517,100,14.99,417
2189670,The Black Pool,9,3,17.99,6
1163060,The Making of Karateka,56,1,19.99,55
2223740,Agatha Christie - Hercule Poirot: The London Case,11,6,26.99,5
1310330,Goodbye Volcano High,287,34,26.99,253
2489370,Internet Cafe Creator,5,9,1.69,-4
2460980,Tide—1927—,209,63,2.99,146
1592480,Meta Sudoku,7,0,1.19,7
2435180,Neyasnoe,121,6,9.99,115
2476020,Good Luck My Lord,10,2,3.99,8
1812910,Great Houses of Calderia,25,5,19.99,20
2458060,Soulkeeper Diaries,12,0,6.55,12
2499930,Detective Montgomery Fox: The Case of the Missing Ballerinas,2,0,9.99,2
2539350,Myths of Rules,553,35,2.99,518
1530470,Daymare: 1994 Sandcastle,93,22,26.99,71
2533470,Bizarre Mushroom Cycle Simulator,30,0,1.99,30
2546310,Sandtrix+,64,3,7.99,61
1436700,Trine 5: A Clockwork Conspiracy,139,7,29.99,132
2451110,End of Knights,22,0,2.99,22
2550630,808s&Genetics,42,0,1.99,42
2546170,Memory Fragment,6,1,6.99,5
2538430,School Cafeteria Simulator,30,1,4.99,29
2183650,MEGA MAN X DiVE Offline,578,92,29.99,486
2451820,Brawl Tactics: Origins,21,2,12.99,19
8980,Borderlands Game of the Year,27945,2892,29.99,25053
1555150,Pocket Bravery,86,3,19.99,83
2561180,Rescue Team: Mineral of Miracles,3,0,4.89,3
2218460,Bunny Guys!,24,3,5.99,21
2429870,Quarta Amethyst,35,8,10.39,27
2137700,I'm on Observation Duty 6,259,24,11.99,235
2549580,Up or Lava!,36,5,4.99,31
2559980,I commissioned some ladybugs 2,5,1,3.99,4
2551780,Midnight Monitor: Anomaly Watch,49,1,5.99,48
2512460,Stream Basketball,10,0,4.99,10
2547280,Draft Day Sports: College Football 2024,1,4,39.99,-3
2443790,Terror in the Kitchen,25,3,4.99,22
2565960,Only Up! 1,1,1,4.99,0
2426640,Kobold Castle,15,0,6.99,15
2295790,Become A Star,1,0,9.99,1
1716740,Starfield,83406,41287,69.99,42119
1931770,Chants of Sennaar,6484,82,19.99,6402
2548710,All in Pairs,15,9,59.0,6
2491640,SNAKE FARM,194,9,2.99,185
2556810,Half Alive,22,7,4.99,15
2156440,Raiding.Zone,23,1,1.99,22
1688350,Wastelander,16,0,9.99,16
2243710,Rune Factory 3 Special,265,7,39.99,258
1789370,Girl Genius: Adventures In Castle Heterodyne,62,5,29.99,57
2444350,Enchanted Portals,77,135,19.99,-58
2276930,Chillquarium,1585,75,5.99,1510
1602560,The Many Pieces of Mr. Coo,403,36,14.99,367
2498580,接触: 第一章(The Encounter: Chapter One),40,15,3.99,25
2499970,Detective Montgomery Fox: The Revenge of Victor Draven,1,0,9.99,1
2567610,Roman Empire Simulator,0,2,0.55,-2
2409050,Wildstrive,20,9,7.99,11
1987500,No Son Of Mine,24,0,14.99,24
2337970,March of Tulpas:Xanadu,16,0,10.99,16
2468600,My Legend of Immortal Cultivation,28,17,4.99,11
2165620,Pool Cleaning Simulator,141,55,9.59,86
1063420,Void Crew,1871,185,21.99,1686
2338770,NBA 2K24,2018,10905,26.99,-8887
1891620,Lempo,81,11,19.99,70
1907660,Monster Path,11,4,5.99,7
2561780,Ancient Relics - Egypt,4,1,9.99,3
2338140,Dokapon Kingdom: Connect,178,23,49.99,155
2448610,Beast Slayer,4,2,4.99,2
2498730,Cold Verdict 2,7,0,2.99,7
2533870,The Book Of Hiro,46,34,2.99,12
2230110,Fae Farm,1575,334,39.99,1241
2291020,ANONYMOUS;CODE,183,30,59.99,153
2377340,SwarmsurgE,6,1,2.99,5
1342110,Mage of the Olekta Desert,29,5,10.39,24
1804020,HERO'S PARTY R,17,6,16.99,11
1964820,Sprout Valley,33,4,14.99,29
2280520,Vampire Mansion,309,13,3.99,296
2249700,Bonfire And Tail,520,12,5.99,508
2336420,School Days,13,1,4.99,12
1937820,Tavernacle!,27,8,11.99,19
2535830,Squirrel Stapler,757,24,7.99,733
2000090,The Isle Tide Hotel,74,25,19.99,49
1402110,Eternights,1363,169,20.09,1194
2516280,SEOIRYE,1,0,10.99,1
1990940,The Impossible Game 2,14,3,4.99,11
2507790,The Great Fear,3,3,2.99,0
2530990,Solitaire Quest: Garden Story,6,1,4.99,5
2334280,Stick to the Plan,77,0,11.99,77
363860,MythForce,198,97,14.99,101
2357400,Mary Skelter Finale,38,10,39.99,28
2013240,修仙家族模拟器,459,361,13.99,98
2492390,Logiart Grimoire,76,1,12.99,75
2325800,Gearhead Karting Simulator - Mechanic & Racing,10,5,4.99,5
2069260,Somnipathy,15,1,16.99,14
1141050,Nour: Play with Your Food,28,21,14.99,7
2316290,Cerulean Days,5,4,14.99,1
2342950,God Of Weapons,2039,314,5.99,1725
2551110,Combat Mission Fortress Italy,21,1,35.99,20
2499470,Pumping Simulator 2,548,28,17.99,520
1571990,Galaxy Pass Station,127,9,9.99,118
1983220,Ugly,134,2,19.99,132
2566520,Breaking Box: Walk!,22,0,1.99,22
2372150,Escape from Norwood,3,0,5.99,3
1913740,SUPER BOMBERMAN R 2,65,47,49.99,18
2459100,Pro Strategy Football 2024,29,7,24.99,22
2578550,Cozy Trip,13,1,0.79,12
2503220,Karting Superstars,142,12,17.99,130
1580180,Gunbrella,350,51,14.99,299
2181610,Heretic's Fork,1536,217,9.99,1319
1922020,Land Above Sea Below,78,10,7.99,68
2578490,Eye of artist,12,15,59.0,-3
2141770,URBO,233,10,5.99,223
2422110,Axis Football 2024,65,24,19.99,41
2141520,Survivor Mercs,56,17,7.99,39
1813130,Sugar Shack,147,60,19.99,87
2296990,We Were Here Expeditions: The FriendShip,15636,1275,3.99,14361
1931990,Sunrise's Order,13,1,17.99,12
1707620,GAZZLERS,29,3,14.99,26
1687000,Fading Afternoon,479,100,19.99,379
1877320,The Walking Dead: Betrayal,157,189,9.99,-32
2391870,MareQuest: An Interactive Tail,126,0,4.99,126
1881940,Heard of the Story?,19,0,19.99,19
1234430,Ad Infinitum,186,45,34.99,141
2388460,Pathfinder: Gallowspire Survivors,224,137,6.99,87
1876890,Wandering Sword,10554,891,24.99,9663
1944910,Thunder Ray,103,29,14.99,74
1731410,Monastery,17,1,15.99,16
1479140,AK-xolotl,483,146,18.99,337
890890,Green With Energy,29,2,5.99,27
2064870,Deceit 2,631,350,9.99,281
2476490,Isekai Rondo,6,1,14.99,5
2005050,Dance Dash,54,1,19.99,53
1156060,Railroads & Catacombs,212,45,16.99,167
2518430,The Backrooms : Last Expedition,33,22,5.99,11
2348090,Crop Rotation,203,9,9.99,194
2298390,Paranormal VHS,61,24,8.99,37
2302840,Compass of Destiny: Istanbul,39,14,14.99,25
2202470,No Sun To Worship,158,26,7.99,132
2075240,Baby Shark™: Sing & Swim Party,2,0,39.99,2
2475800,Surface: Project Dawn,1,0,9.99,1
2518960,Wizardry: Proving Grounds of the Mad Overlord,195,45,29.99,150
2161050,Boti: Byteland Overclocked,180,59,19.99,121
2559290,Gold Rush Clicker,5,4,0.99,1
2330380,Golf VS Zombies,17,3,9.99,14
2066680,Dungeons & Keyboards,23,4,4.99,19
2192060,NASCAR Arcade Rush,3,8,49.99,-5
2559360,Symmodance,26,2,2.99,24
2065870,Prescience,9,0,11.99,9
2585260,I commissioned some cats 2,10,0,3.99,10
2215270,Army Troop,76,14,9.99,62
1766060,HumanitZ,1330,408,19.99,922
2328140,Unloop,27,0,2.99,27
2292060,Spell Disk,293,36,14.99,257
1843470,Dungeon Dreams 2,47,1,19.99,46
1317020,77p egg: Eggwife,288,18,9.99,270
1627720,Lies of P,20639,1700,59.99,18939
1199830,How To Hack In?,13,0,11.99,13
1777990,Ortharion : The Last Battle,28,9,19.99,19
2084180,Case 03: True Cannibal Boy,38,1,5.99,37
2566430,DERE Vengeance,16,3,3.99,13
2547330,Dr. Lunatic Supreme With Steam,31,0,9.99,31
1818280,KallaX,223,29,9.99,194
2222540,BIT.TRIP RERUNNER,247,2,19.99,245
2505570,Burger Shop 3,114,1,4.99,113
1971870,Mortal Kombat 1,13500,4783,69.99,8717
1709870,Spirited Thief,47,1,14.99,46
1223530,Mall Craze,12,15,14.99,-3
2284270,Adventurer Farmer: Save my son!,12,0,1.99,12
2547120,修炼成仙,50,14,0.99,36
2430510,Pyramid Curse,31,2,2.99,29
2593760,Kudos 2,7,2,5.99,5
1658150,Moonstone Island,1628,218,19.99,1410
2390060,dEskape,65,30,9.99,35
2221980,Budget Cuts Ultimate,15,2,29.99,13
1260320,Party Animals,24186,9134,19.99,15052
2317950,Jewel Match Atlantis Solitaire 4 - Collector's Edition,5,1,13.99,4
1597310,Airship: Kingdoms Adrift,311,106,29.99,205
2281820,Evolings,186,54,4.99,132
1575510,Seedlings,40,0,9.99,40
1992700,Super Adventure Hand,48,0,12.99,48
1887310,Paperman: Adventure Delivered,20,2,19.99,18
2238430,"Mon-Yu: Defeat Monsters And Gain Strong Weapons And Armor. You May Be Defeated, But Don’t Give Up. Become Stronger. I Believe There Will Be A Day When The Heroes Defeat The Devil King.",5,2,49.99,3
1755830,Astrea: Six-Sided Oracles,2416,158,24.99,2258
2583690,Secret of the Vikings 2 - The World Tree,1,0,9.99,1
1272080,PAYDAY 3,19553,26511,39.99,-6958
1341490,Hellsweeper VR,148,29,29.99,119
2553800,负罪者：方石,14,1,13.99,13
2578860,逝去的群星,5,0,0.99,5
2248430,Touhou Artificial Dream in Arcadia,435,10,9.99,425
2542800,Upload Simulator Silicon,14,4,3.99,10
2527460,Arcana Alchemia,160,1,29.99,159
2488050,The Winning Secret of the Newbie Strategist Princess,26,7,7.99,19
2142330,Bud Spencer & Terence Hill - Slaps And Beans 2,122,3,19.99,119
2504660,Chickado,14,1,2.99,13
2601690,Dark City: Kyiv Collector's Edition,3,0,13.99,3
2373340,Monster Line of Defense,120,5,1.99,115
2533950,Hot And Lovely ：Uniform,146,14,3.99,132
1551530,Pray Game,247,26,19.99,221
1620030,Avatar: The Last Airbender - Quest for Balance,22,67,49.99,-45
2114380,Dungeon Dungeon!,13,3,14.99,10
1892420,The Bunny Graveyard,537,18,6.99,519
2596640,Medieval Kingdom Wars Story,0,2,3.99,-2
2584050,Slaughter: The Lost Outpost,16,5,4.99,11
2356500,Cats Hidden in Bali,534,7,0.99,527
1566670,Attack of the Karens,21,0,7.99,21
1840710,These Doomed Isles,95,21,14.99,74
2014740,Last Devil - Family Friendly,27,13,10.99,14
633080,Relic Hunters Legend,692,347,14.99,345
2510770,Stella of The End,511,7,19.99,504
2477140,Twilight Town: A Cyberpunk FPS,46,1,7.99,45
1932680,LunarLux,152,3,15.99,149
1997590,RETOOLED,19,1,14.99,18
1958220,WitchSpring R,3384,110,34.99,3274
2438770,Chores of Corruption,20,1,4.99,19
1557720,RoboDunk,42,0,14.99,42
1202200,Paleo Pines,836,88,29.99,748
2263980,Memories: Millennium Girl,51,8,15.99,43
2347740,VenusBlood GAIA International,45,32,44.99,13
2589470,Save Prinvess:Infinite Loop,11,1,5.99,10
2563740,Polygons Tower Defense,7,0,2.99,7
2362300,Train Sim World® 4,750,269,49.99,481
1546310,"El Paso, Elsewhere",614,29,19.99,585
762940,Mineko's Night Market,144,37,19.99,107
1423330,Ancient Warfare: The Han Dynasty,848,120,16.99,728
2410780,Goblin Conqueror,43,4,12.99,39
2548950,武林立志傳,28,3,9.99,25
2220570,Dwarves Mining Idle,3,0,2.99,3
2532550,LIZARDS MUST DIE,20517,455,1.99,20062
2489460,Cropisle TD,29,1,2.99,28
2532050,Vampires' Melody 2,306,35,3.99,271
2470130,御姐初长成,71,10,0.99,61
2425370,Plum Blossom Divination,14,2,4.99,12
2140650,Harvest Moon: The Winds of Anthos,145,31,49.99,114
2292650,Escape From Mystwood Mansion,151,9,16.99,142
2216860,The Gray Man,16,1,14.99,15
2324520,Kanji Industry,21,0,6.99,21
2398900,Star Farmer: Warlock of the Universe,22,0,4.99,22
1692240,Fortune's Run,286,19,19.99,267
2191190,FIND ALL 4: Magic,265,2,1.99,263
2291850,Underground Blossom,4199,67,4.99,4132
1808640,Astronimo,22,1,14.99,21
2195250,EA SPORTS FC™ 24,15458,11278,69.99,4180
2296380,I Expect You To Die 3: Cog in the Machine,284,9,24.99,275
1599330,Wildmender,739,115,24.99,624
2109510,CyberTD,31,11,19.99,20
1830630,Overpass 2,6,7,39.99,-1
2357310,Randoville,34,4,14.99,30
1995880,Afterdream,140,9,10.99,131
2600500,BLACK RUNES,1,1,4.99,0
1415280,Faerie Afterlight,39,9,19.99,30
2520870,Love In The Dark,38,12,4.99,26
1306970,Diluvian Ultra,69,5,9.99,64
1902690,Fate/Samurai Remnant,3074,240,59.99,2834
2071600,大宋广记,43,7,8.99,36
2323660,Headlong Hunt,26,0,11.99,26
1555800,The War Enders: First Strike | 终战：初击,8,0,14.99,8
1951230,Pizza Possum,746,24,6.99,722
2467540,Secret Agent,13,5,24.99,8
1845670,Islands of the Caliph,121,11,9.99,110
2027590,Lost Paws,15,0,14.99,15
1295220,Super Buff HD,30,1,8.99,29
2279330,Savant - Ascent REMIX,232,22,9.99,210
2512430,Void Survivors,32,2,1.99,30
2561190,Claire's Cruisin' Cafe: Fest Frenzy,3,0,4.89,3
2197650,Ludus Mortis,22,1,17.99,21
2288080,Maumau and the Labyrinth,44,6,15.99,38
1419850,Saleblazers,231,25,29.99,206
2614820,It Happened Here: Beacon of Truth Collector's Edition,2,0,13.99,2
1568970,Torn Away,319,16,14.99,303
2527640,Alvara,3,2,9.99,1
869490,Limerick: Cadence Mansion,28,1,14.99,27
2007710,Betrix,97,16,2.99,81
1497440,COCOON,2349,70,24.99,2279
2578940,NO Logic,20,1,1.99,19
1952520,PAW Patrol World,29,1,39.99,28
2246640,Tiny Atolls,25,3,9.99,22
2581570,封神榜2023,129,4,13.99,125
2202590,Shape Shifter: Formations,92,1,6.99,91
2578820,Bombabomb!,4,0,0.99,4
2534020,Dungeon Tale,4,1,14.99,3
1662770,UFO: Extraterrestrials Platinum,8,3,19.99,5
2437690,Zoo Park Story,30,3,8.99,27
2575110,Riot of Willy,26,3,1.99,23
1940410,Starri,76,1,17.99,75
1945260,Jelly Express,100,11,6.99,89
2570950,NURTOPU,32,2,0.99,30
2393890,IGNISTONE,36,2,7.99,34
2593940,Sushi for Empress Setsuko,2,0,6.99,2
2560260,Oni Station,12,2,4.99,10
1526370,Bilkins' Folly,44,0,19.99,44
2608440,Sunlight Scream,31,0,2.99,31
2563800,The Last Game,6,1,2.99,5
2361610,In His Time,20,0,9.99,20
2607640,Rolling Toolman 2 Deathly Traps,13,4,2.99,9
2305180,You are the Judge!,20,3,17.99,17
2445020,Auto Checkup Simulator,1,0,4.99,1
2059170,Quasimorph,687,194,19.99,493
2083910,Iron Dungeon,4,2,9.99,2
2562240,Only Up!,14,137,4.99,-123
1960110,Silent Hope,128,30,39.99,98
1421290,Battle Shapers,211,23,24.99,188
2559050,Dimensions,4,0,2.99,4
1932180,Dinobreak,20,8,19.99,12
2396060,Survivor - Castaway Island,15,21,24.99,-6
2272400,Station to Station,635,44,17.99,591
1167750,The Lamplighters League,239,85,49.99,154
2250600,Disgaea 7: Vows of the Virtueless,509,91,59.99,418
2477740,Basics In Intermediate Filmmaking,14,2,0.99,12
2395210,Tony Hawk's™ Pro Skater™ 1 + 2,1986,242,39.99,1744
2461780,网瘾少年2005 Internet addicted youth 2005,100,0,1.99,100
638510,dotAGE,965,31,17.59,934
2562470,POP OFF 2,18,0,4.99,18
1540350,The Fabulous Fear Machine,204,14,17.99,190
2358260,Cricket 24,284,121,44.99,163
687800,Heads Will Roll: Reforged,303,31,14.99,272
2559450,Bump and Run Racing,2,0,1.99,2
1332720,Thief Simulator 2,2181,204,19.99,1977
2375730,Mercenaries of the Kingdom: First Blood,27,3,6.29,24
2322180,A Tiny Sticker Tale,133,1,9.99,132
2205230,True Colours,3,1,13.99,2
2399080,Idle Catfarmia,33,9,7.65,24
2547570,Miss Peach,22,2,4.99,20
715680,Knight vs Giant: The Broken Excalibur,100,30,19.99,70
1566880,SWORD ART ONLINE Last Recollection,253,125,59.99,128
2304640,Hidden Through Time 2: Myths & Magic,126,11,12.99,115
1346020,Wargroove 2,193,64,19.99,129
2278630,Livestream 2: Escape from Togaezuka Happy Place,87,8,24.99,79
1159290,The Bloodline,1066,197,19.99,869
2502940,Helle's Undersea City Project - Bringing Air to The Garden,48,4,10.39,44
2328750,My Little Universe,526,44,14.99,482
1921470,TAGLINE,32,0,17.99,32
1426370,Cat Attack,1,1,4.99,0
2164030,Stop Dead,37,1,14.99,36
2134560,9th Sentinel Sisters,138,32,4.99,106
1943420,I doesn't exist - a modern text adventure,40,13,12.99,27
593150,Ooblets,741,61,29.99,680
2434400,Ghost Simulator,23,4,6.99,19
2543740,Embers Off,5,1,9.99,4
2608250,Idle Blocks,2,3,4.99,-1
2156770,Ghost Signal: A Stellaris Game,30,6,19.99,24
1154090,Kingdom Shell,79,10,17.99,69
2361080,Step By Step,56,0,9.99,56
2484500,Ontotis,57,11,5.99,46
1578990,Midnight Girl,66,4,14.99,62
2523440,Vogvhathos,5,0,1.99,5
2596250,Cactus Simulator 2,6,2,1.99,4
2529120,Old School,187,28,14.99,159
2432000,Inside the Labs,45,7,5.99,38
2588610,Last Lesson,55,14,6.99,41
2604240,Wicked Times,8,0,1.99,8
2506580,Gearbits,60,1,9.99,59
2583930,Where's My Loot?,20,0,1.99,20
2526410,Athos,51,24,24.99,27
2440510,Forza Motorsport,1776,2728,69.99,-952
1292500,Harvest Island,108,20,24.99,88
2601190,Unavailed,34,0,4.99,34
2632180,Living Legends: Voice of the Sea,1,0,9.99,1
2613830,Install Fee Tycoon,53,3,0.99,50
2421440,Chronicles of Vaeltaja: In Search of the Great Wanderer,2,0,16.99,2
1206370,Wild Card Football,78,51,39.99,27
2615330,LightBear,1,1,12.99,0
2394880,Combat Zone,1,5,0.0,-4
2142230,Mercenaries Saga 1 -Will of the White Lions-,21,1,11.99,20
2589820,The Forgotten Village of Gondomayit,7,2,4.99,5
2142240,Mercenaries Saga 2 -Order of the Silver Eagle-,19,0,11.99,19
1154120,Ilysia,73,60,14.99,13
2468470,Soulbind: Tales Of The Underworld,53,6,5.99,47
1542390,Monolith,85,12,14.99,73
2090370,River City: Rival Showdown,53,72,24.99,-19
1937780,Total War: PHARAOH,1466,1069,59.99,397
2285150,The Front,4842,1873,19.99,2969
2142260,Mercenaries Wings: The False Phoenix,12,6,14.99,6
2567490,Mobile Store Simulator,8,9,10.99,-1
2430580,Astrosmash,6,3,14.99,3
1659150,SUPER 56,78,3,6.99,75
2113040,RUNGORE,193,28,14.99,165
1895810,Infinity Strash: DRAGON QUEST The Adventure of Dai,132,169,59.99,-37
2397120,subpar pool,14,0,9.99,14
2555320,Summon,1140,42,0.99,1098
1059900,Tribe: Primitive Builder,389,61,19.99,328
1622900,Star Trek: Infinite,1318,915,29.99,403
2025700,Fragile Feelings,22,0,12.99,22
1389840,Hotel: A Resort Simulator,31,73,19.99,-42
2474940,Nope Nope Nope Nope Nurses,76,5,19.99,71
1419620,Saltsea Chronicles,63,1,24.99,62
2618090,Mistward,32,7,11.99,25
2518900,Manny's,65,2,7.99,63
1159160,VReken,2,1,24.99,1
2080130,A Quest That Became Legend,33,4,29.99,29
2603280,Polygon Fantasy Battle Simulator,20,0,4.99,20
1667530,Chronotopia: Second Skin,12,0,24.99,12
1355090,RAILGRADE,311,69,22.49,242
2604660,Art Heist - Escape Room Adventure,3,0,3.99,3
2097770,"Slave Princess Finne, why did she sell out her own kingdom?",32,4,17.99,28
1501750,Lords of the Fallen,15878,9671,59.99,6207
1999850,Possessions,4,0,19.99,4
1564790,Submachine: Legacy,801,5,24.99,796
2378900,The Coffin of Andy and Leyley,8932,215,9.99,8717
2618840,末世少女 Zombie Girl,383,341,6.99,42
2433700,Boaty Tanks,12,0,9.99,12
2322520,World League Baseball,12,5,8.99,7
2543300,Joy Life 2,118,29,3.99,89
2248420,Infinity Trials,3,0,2.99,3
1955800,TRANSFORMERS: EARTHSPARK - Expedition,8,3,39.99,5
2287970,Dungeon's Legion,246,30,15.99,216
2427100,Cafe Master Story,61,4,8.99,57
2168680,Nuclear Option,443,25,14.99,418
2614790,GunDeck[100],10,0,4.99,10
2368070,Simple Game,18,2,6.99,16
2575900,Corn Kidz 64,273,9,6.99,264
2094370,Alchemist: The Potion Monger,30,3,13.99,27
1826060,Night Loops,48,0,7.99,48
2022670,SONIC SUPERSTARS,1318,551,59.99,767
2340960,ReThink | Evolved 5,1,0,9.99,1
2481710,ReThink | Lite,3,0,7.99,3
2573260,古代风流传,166,41,3.99,125
2310920,THE EDITOR,35,2,11.99,33
2625350,Draft Day Sports: Pro Football 2024,3,3,39.99,0
2313930,NFL Pro Era II,19,12,29.99,7
2366430,Windy Meadow - A Roadwarden Tale,28,5,7.99,23
2243110,EMPTY SHELL,200,24,11.99,176
2576600,Bottle Can Float,44,1,3.99,43
1629210,Tales Of Aravorn: An Elven Marriage,13,1,19.99,12
2491620,Dimenders,10,2,9.99,8
1702430,Vlad Circus: Descend Into Madness,82,4,19.99,78
2237970,Outpath,1420,52,14.99,1368
2300300,Growth,112,1,7.99,111
1021210,Cyber Knights: Flashpoint,165,18,29.99,147
2621400,Robots Shooting Simulator,1,4,0.99,-3
2381950,Card Age,20,5,5.99,15
2374420,100 Steps,12,0,9.99,12
2344520,Diablo® IV,8686,6321,69.99,2365
2338120,Outlive,36,6,9.09,30
2479970,Par for the Dungeon,39,0,4.99,39
2477090,Mosa Lina,534,14,4.99,520
2233790,Legendary Creatures 2,574,196,5.99,378
1150530,Wizard with a Gun,1335,258,24.99,1077
2529830,Pixel Colony,9,0,3.99,9
2097890,Skull Island: Rise of Kong,34,63,39.99,-29
2460920,ACRES,87,15,14.99,72
2322560,Love Is All Around,34626,1678,9.99,32948
2003990,Arcade Sundown,40,1,14.99,39
2446270,花园魔三国2 -The Sacrificial Girl of the Fantasy 3 Kingdoms 2-,53,2,12.99,51
1579660,Wyvia,83,2,9.99,81
2347940,Sea of Survivors,148,30,4.99,118
2508210,Lair of Torment,40,7,3.99,33
2160480,Hellboy Web of Wyrd,351,117,24.99,234
1229020,Kona II: Brume,103,12,29.99,91
1379600,Pandemic Train,110,51,16.99,59
2311260,英灵学院 Soul Academy,249,65,11.99,184
1562910,MAKOTO WAKAIDO’s Case Files TRILOGY DELUXE,51,5,12.99,46
2216830,The Jackbox Party Pack 10,223,108,34.99,115
849100,Alaskan Road Truckers,1416,658,21.99,758
2150300,SGS We The People,16,0,29.99,16
339740,SuiCats,85,1,1.99,84
2565140,Златогорье 2: Холодные небеса,1,0,14.99,1
1485590,ENDLESS™ Dungeon,1847,815,29.99,1032
1928020,Gargoyles Remastered,15,5,14.99,10
2341130,The Turgenev Study,4,2,5.99,2
1715280,AirportSim,441,137,34.99,304
1904790,Agatha Christie - Murder on the Orient Express,164,14,39.99,150
2263160,传说之始,22,0,4.99,22
1623120,Chaos on Wheels,10,2,24.99,8
2383990,Ghostbusters: Spirits Unleashed Ecto Edition,482,60,19.99,422
2051120,HOT WHEELS UNLEASHED™ 2 - Turbocharged,147,38,49.99,109
2603260,Echoes of Madness,26,0,4.99,26
2170520,"Inescapable: No Rules, No Rescue",25,21,49.99,4
1356810,Hexarchy,451,58,19.99,393
2414600,Drum Roll,9,0,4.99,9
2645350,Paranormal Files: Trials of Worth Collector's Edition,1,1,13.99,0
2456960,The 7th Guest VR,168,9,29.99,159
1796220,Laika: Aged Through Blood,1811,74,19.99,1737
1424860,Bish Bash Bots,97,14,19.99,83
2416780,The Sleep Experiment,1,6,11.99,-5
2194530,Yog-Sothoth’s Yard,3703,246,10.99,3457
1458300,The Gap,57,0,19.99,57
2589440,PowerWash Adventure VR,40,1,6.99,39
2059660,Cavern of Dreams,335,9,12.99,326
2631130,Idle Exorcism Hero,53,7,3.24,46
2342150,Folk Hero,81,13,10.99,68
2272250,Forgive Me Father 2,200,15,19.99,185
2574650,SHAPE HUNTER,0,1,1.5,-1
1882500,Cattails: Wildwood Story,817,2,19.99,815
2560460,Hidden Cats in Spooky Town,113,1,3.99,112
2563160,国際指定怪異124号 東京廃村,18,3,7.99,15
2511030,Deep Secret,182,60,3.99,122
1117090,Purple Place - Classic Games,775,65,1.59,710
2055050,Cavalry Girls,489,120,9.99,369
2506160,Fears to Fathom - Ironbark Lookout,1606,130,5.99,1476
2542320,DCOP,7,0,2.99,7
2390260,Topple Tactics,625,34,9.99,591
2631010,Fairyland Solitaire,2,0,9.99,2
2306980,Replik Survivors,21,2,4.99,19
2594730,Daydream Mosaics 4: Shades of Blue,1,0,8.99,1
2599300,Dead Signal,527,50,9.99,477
2215650,That Time I Got Reincarnated as a Succubus,60,8,10.39,52
1791910,Silent Rain,56,31,9.99,25
2206140,GeoDepths,108,21,16.99,87
2429090,Garden Buddies,25,0,14.99,25
2345220,Roody:2d,9,0,14.99,9
2405800,The Dreaming City Chronicles: Quest for the Vanished World,16,0,5.99,16
1840450,Good Bones,16,1,14.99,15
2599700,Algor PEW PEW,19,3,10.99,16
2472550,Conquistadorio,97,15,9.99,82
2402200,Hidden Kitten,25,3,3.99,22
1989270,Slay the Princess,4831,102,17.99,4729
2452100,Nephilim,5,4,19.99,1
2599270,Gem Defender: Soyjak Survivors,159,9,3.99,150
1818600,Bug Blazer,6,0,4.99,6
2303320,Three Minutes To Eight,68,20,11.24,48
1931940,Early-blooming black lily,164,34,18.99,130
2287560,Vengeance of Mr. Peppermint,64,10,15.99,54
2488510,FatalZone,911,334,4.99,577
1966720,Lethal Company,110177,1342,9.99,108835
1999870,Gears of Dragoon: Fragments of a New Era,38,5,34.99,33
2373460,Chess!,14,2,6.99,12
1441770,Moonlight In Garland,29,4,7.99,25
945770,Dark Envoy,240,68,29.99,172
2506110,The Guest,53,5,4.99,48
1710740,Dungeon Full Dive,25,8,29.99,17
949230,Cities: Skylines II,23875,15425,49.99,8450
2258500,CRYMACHINA,243,29,59.99,214
2131630,METAL GEAR SOLID - Master Collection Version,841,503,19.99,338
2424240,Pudding,60,5,3.99,55
2131640,METAL GEAR SOLID 2: Sons of Liberty - Master Collection Version,457,235,19.99,222
1558830,RIPOUT,227,46,24.99,181
1159830,Scene Investigators,298,77,24.99,221
2131650,METAL GEAR SOLID 3: Snake Eater - Master Collection Version,1126,505,19.99,621
2131680,METAL GEAR & METAL GEAR 2: Solid Snake,147,53,19.99,94
2605500,Case of the mysterious death of Keiko Haraeda,66,33,1.69,33
2306740,METAL GEAR SOLID: MASTER COLLECTION Vol.1 BONUS CONTENT,46,63,0.0,-17
2541190,G-MODEアーカイブス49 グレゴリーホラーショー,2,0,7.99,2
2515070,AQUARIUM,235,3,20.46,232
2204350,Midnight Heist,101,4,9.99,97
2536840,GINKA,1671,170,22.99,1501
1807210,Stray Souls,53,155,29.99,-102
2074370,REPLAY BOYS,20,0,9.99,20
2425740,The Three Kingdoms Era in China 2000 years ago,3,0,11.99,3
1757580,Open Wheel Manager 2,31,6,19.99,25
2490280,Square Dungeon 2,381,93,3.99,288
2541200,Japan Train Models - JR East Edition,4,0,13.99,4
2399830,ARK: Survival Ascended,20354,14079,44.99,6275
2510950,Fly Caster,3,0,9.99,3
2620500,imomushi,146,15,1.99,131
2144740,Ghostrunner 2,2553,252,39.99,2301
2392160,Abscission,23,2,8.99,21
2236070,Peaks of Yore,84,4,18.99,80
2620140,AVARIS3,3,0,44.99,3
2152580,Heroes Of Drakemire,2,0,19.99,2
1372150,Fish Game,188,11,24.99,177
1722660,Hamster on Rails,38,0,14.99,38
2309400,The Devourer: Hunted Souls,247,24,9.99,223
2430160,Taimanin Asagi,77,12,14.99,65
1957300,The Sirena Expedition,28,5,5.99,23
2438240,Demonic Episode,17,7,9.99,10
2618940,Desktop Pet Project,11,3,2.99,8
2627730,i Pick Skills,8,10,3.99,-2
2492600,Rampage Agents,33,3,9.99,30
1749770,Twofold,39,3,19.99,36
1040510,Princess of Zeven,71,16,12.99,55
2552330,AutoDepth Image Viewer,19,2,9.99,17
2582540,RoGlass,5,0,9.99,5
2497900,DON'T SCREAM,2150,1122,9.99,1028
2188570,The Rings of Powder,15,1,10.99,14
1603180,Mining Mechs,455,22,2.99,433
2445700,RPG Alchemy,18,7,2.99,11
653020,Lumins and Shades,2,0,14.99,2
1957670,Grand Strokers,15,0,9.99,15
2435320,Terra Toy,12,0,4.99,12
2642460,Stump Simulator,55,11,0.99,44
2490160,NecroAttack！,149,48,9.99,101
1964200,Phantom Rose 2 Sapphire,187,5,19.99,182
2552420,Tenioha! feat. Mami,26,0,16.99,26
2491130,Split square,4,0,2.49,4
2546150,Entities,29,19,14.99,10
1950930,The Golden Eyed Ghosts,22,7,19.99,15
2372350,"Bahamut2-Come on,Fight",15,1,12.74,14
2630080,They Are Coming,69,4,2.99,65
2225480,REMORE: INFESTED KINGDOM,70,7,14.99,63
2179690,Desktop Pet,14,0,3.99,14
2605640,Buried,132,29,2.99,103
2435090,Talented,111,8,1.99,103
2497940,Viking Chef: Feast Frenzy,2,0,14.99,2
1977170,Jusant,737,22,19.99,715
2593900,[Chilla's Art] The Kidnap | 誘拐事件,243,45,9.99,198
1446350,You Will Die Here Tonight,188,13,19.99,175
2633170,Front Office Football Nine,44,12,34.99,32
2638180,Hokkaido Game,114,2,1.99,112
2439780,Godzilla Voxel Wars,58,1,14.99,57
2562510,On Air Island : Survival Chat,15,0,11.99,15
2491670,Wanted Shadows,30,5,1.49,25
1761620,Headbangers: Rhythm Royale,420,107,19.99,313
2385720,The Police Mystery,17,8,16.99,9
2364610,Enypnion Redreamed,12,0,4.99,12
2237700,Football Legend,2,1,24.99,1
1913420,Fantasy of Caocao 2,286,35,8.99,251
2345190,Pixel Petals,3,0,0.99,3
2441500,Kid Bubblegum,4,0,5.99,4
843200,Alien Hominid Invasion,975,97,19.99,878
2569170,Widow in the Endless Labyrinth,56,18,14.99,38
2592330,Penguin Hatchery,3,0,2.99,3
2394350,aerofly RC 10 - RC Flight Simulator,6,4,79.99,2
1243850,This Bed We Made,544,42,24.99,502
2451030,Skibidi Verse,14,3,4.99,11
1285360,Alien Hominid HD,255,8,11.99,247
1636030,Crossfire: Sierra Squad,192,94,29.99,98
2103140,Magicraft,3076,358,9.99,2718
1333200,Song of Nunu: A League of Legends Story,1500,60,29.99,1440
2328730,Polimines 2,43,6,9.99,37
1676840,For The King II,5721,2437,24.99,3284
2602780,Filly Astray,76,6,9.99,70
2348610,Slime 3K: Rise Against Despot,471,74,4.99,397
2651230,A-GIRL,42,2,0.99,40
2238900,STAR OCEAN THE SECOND STORY R,2040,57,49.99,1983
2397500,The Smurfs 2 - The Prisoner of the Green Stone,26,1,29.99,25
1735700,Back to the Dawn,2258,218,19.99,2040
2601740,Drive Up,28,9,4.99,19
1849250,EA SPORTS™ WRC,2412,894,49.99,1518
1903670,Peaky Blinders: The King's Ransom Complete Edition,17,17,19.99,0
2513380,Logic Escape,9,1,8.99,8
2450820,Radiant Silvergun,76,11,19.99,65
2352000,Destroy The Monoliths,5,0,6.99,5
835960,The Talos Principle 2,5018,181,29.99,4837
1617220,Thirsty Suitors,87,1,29.99,86
2313720,Noun Town Language Learning,60,5,19.99,55
1898880,The Silent Swan,35,3,14.99,32
2571280,梦染深秋,46,13,3.99,33
1681430,RoboCop: Rogue City,6162,377,49.99,5785
2554800,Cactus Cowboy - Desert Warfare,19,0,14.99,19
2650800,新叶旅者与少年的回忆,33,1,3.99,32
2531340,OASIS: Tokyo,18,1,6.99,17
2475420,Parking Tycoon: Business Simulator,267,70,12.99,197
2385520,INVERSE,12,1,14.99,11
2187920,Iron Marines Invasion,101,25,14.99,76
2515210,SKIBIDI BACKROOMS,220,46,1.99,174
2433820,SUPRACORE,4,0,7.99,4
2392810,Wound Man,3,1,4.99,2
2224740,DreamWorks All-Star Kart Racing,38,18,39.99,20
2082580,Come Together,16,0,5.99,16
2399130,Streamer Girl Simulator,8,6,4.99,2
2351120,Ebenezer and the Invisible World,27,7,19.99,20
1575980,UsoNatsu ~The Summer Romance Bloomed From A Lie~,142,8,24.99,134
2659150,_message:,14,3,0.99,11
2072360,Delicious Dungeon,11,3,13.99,8
2333240,Logic Town,37,1,9.99,36
2632720,Greg's Deadly Draft,12,0,4.99,12
2529820,Wedding Witch,1207,139,4.99,1068
2653810,Pumpkin Game,9,1,1.99,8
2642890,KunKunNight,837,23,1.99,814
2326500,March of the Drunken Sailors,3,0,2.99,3
2324440,Delicious - Cooking and Romance,4,0,19.99,4
2651700,Pigeon in Hurry,10,7,64.99,3
2414190,You Must Become A Lich,11,3,6.99,8
2607840,Freeway Nightmare,10,8,64.99,2
2651610,AstroRunner,9,8,64.99,1
2244130,Ratopia,1342,169,19.99,1173
2452090,GREED IS GOOD,417,182,14.99,235
2443370,Witchcraft Survivors,21,1,4.99,20
2449040,Cursorblade,397,54,4.99,343
731040,The Invincible,1544,148,29.99,1396
2448420,Deadfall,26,1,9.99,25
2544760,Kuroinu 2 Redux,68,13,24.99,55
2285630,Survivors of the Dawn,159,35,7.99,124
2516430,Cyborg3003,26,2,6.99,24
2274110,The Elephant Collection,273,8,14.99,265
2483420,The book of death for dummies,4,0,9.99,4
2252570,Football Manager 2024,4659,671,59.99,3988
2260350,Elfboarders,0,2,12.99,-2
2527660,The Awakener: Forgotten Oath,106,27,16.99,79
1437400,Salt and Sacrifice,258,155,19.99,103
1793170,Racine,130,29,9.99,101
2616420,Hans,555,38,4.99,517
2536650,TYPECAST,103,3,4.99,100
1812370,Little Goody Two Shoes,477,21,19.99,456
2017080,Nickelodeon All-Star Brawl 2,611,105,49.99,506
2285820,Idling Gears,96,38,4.99,58
2384610,Franchise Hockey Manager 10,45,7,39.99,38
2464880,Terracards,219,23,8.99,196
1900890,Redgar: The Space Viking,18,0,14.99,18
1743390,YetiFree,12,0,4.99,12
2125090,Tintin Reporter - Cigars of the Pharaoh,59,51,39.99,8
2140020,Stronghold: Definitive Edition,4564,651,14.99,3913
2663520,Echo of Extinction,1,0,6.99,1
2395550,Desktop Girlfriend NEO,117,6,4.99,111
2112290,Tide of Thieves,4,0,9.99,4
2179850,Cobalt Core,968,23,19.99,945
2497200,Healer,54,18,6.99,36
2547930,Two Hour Escape Mystery: A Puzzling Voyage,12,1,4.99,11
704000,GUNHEAD,90,16,19.99,74
2620750,Incredible Dracula: Dark Carnival,1,0,6.99,1
916350,Saturnalia,15,1,19.99,14
2368190,Bem Feito,30,1,14.99,29
2086360,Double Dragon Advance,17,5,6.99,12
1603420,Doomsday Paradise,155,5,14.99,150
2529170,Storage Hustle,200,29,11.99,171
1337520,Risk of Rain Returns,21022,2193,14.99,18829
2140080,Pretty Overseer - Dating Sim,8,0,14.99,8
2086370,Super Double Dragon,11,3,6.99,8
2595780,Super Picture Cross,13,1,4.99,12
2375550,Like a Dragon Gaiden: The Man Who Erased His Name,5371,136,49.99,5235
1807090,Wantless : Solace at World’s End,38,2,17.99,36
2027960,Concealed,27,4,12.99,23
2623050,Berzerk: Recharged,10,12,9.99,-2
2238360,You Have No Time,13,0,4.99,13
1643310,Dungeons 4,1025,107,49.99,918
1305080,GearBlocks,61,2,14.99,59
1963570,Cuisineer,714,198,24.99,516
2195650,Lucky Island,3,1,8.99,2
2597280,Tomb Of AnuBI0S,3,0,9.99,3
2571780,Jewel Match Aquascapes 2 Collector's Edition,6,1,13.99,5
2622230,Kungfu,10,1,1.99,9
2271060,Last Memories,7,0,4.99,7
1501820,Ziggy's Cosmic Adventures,20,9,19.99,11
1759350,Space Trash Scavenger,208,16,19.99,192
2665110,Idle Tick,4,3,2.99,1
2296020,Atlantis Academy,2,0,7.99,2
2533370,Heads Up! Phones Down Edition,0,2,39.99,-2
2661210,WhaleGameOnline,45,2,2.99,43
2182630,Mob Factory,188,67,14.99,121
1034590,What The Duck,16,1,19.99,15
1518220,Spells & Secrets,118,14,24.99,104
1839060,Polylithic,40,8,14.99,32
2491040,Higurashi When They Cry Hou+,41,0,7.99,41
1151100,Hamster Scramble,30,0,11.99,30
2563540,英雄远征,9,4,3.99,5
1969310,Demeo Battles,22,7,19.99,15
1296340,Undercat,26,0,14.99,26
1981820,Strike Force Heroes,2033,469,19.99,1564
2195400,Shave & Stuff,12,0,14.99,12
2479960,Animal Planner,25,1,4.99,24
1638950,Zombie Builder Defense 2,139,23,9.99,116
2083210,Super Woden GP 2,464,28,12.99,436
2625380,Draft Day Sports: Pro Basketball 2024,1,0,39.99,1
1941980,Big Fat Battle,48,8,14.99,40
2174720,The Will of Arthur Flabbington,54,0,11.99,54
2559270,Gym Simulator 24,564,38,10.99,526
2452900,TerraForge,27,2,4.99,25
2403620,Air Twister,23,0,24.99,23
2398940,Ceiba,107,1,6.99,106
2622770,In Fair Spirits,4,0,8.99,4
2479610,Take the King!,6,0,6.99,6
2547400,The Spectral Web: Hitodama,20,0,2.99,20
2635680,I commissioned some cats 6,4,0,3.99,4
2194190,Ocelot Sunrise,15,1,4.99,14
1551630,Sujimon Quest,35,11,9.99,24
2666250,Dark Mysteries: The Soul Keeper Collector's Edition,8,0,5.99,8
2488340,Dream Town Island,91,3,10.99,88
2583550,死亡禁地   The Dead Zone,8,11,5.99,-3
2330870,CD 2: Trap Master,189,20,14.99,169
2576160,Echoes,9,1,3.99,8
2272120,Baker Street Breakouts: A Sherlockian Escape Adventure,12,0,9.99,12
2553050,Estate Agent Simulator,210,34,15.99,176
2254670,Dungeon Cleaner,5,1,3.99,4
1293170,Bzzzt,238,0,11.99,238
2506930,Cody's Nightmare,2,2,9.99,0
2364560,Demonheart: The Cursed Trial,34,0,19.99,34
2514960,Refind Self: The Personality Test Game,802,131,7.99,671
2007980,Misty's Shining Blacksmithing,31,7,14.99,24
1408080,Minigame Madness,24,7,9.99,17
2650010,Violet Kingdom,5,0,19.99,5
2552410,Liminal Border Part I,50,2,14.99,48
1822550,Microcivilization,450,43,17.99,407
2075580,Under A New Sun,33,8,16.99,25
2358040,Fantasy Craft,43,14,19.99,29
2638150,Choose Your Cutie,10,0,0.99,10
1470940,STAR FLEET II - Krellan Commander Version 2.0,37,0,9.99,37
1939220,Art of Golf,3,0,9.99,3
2630500,To Infinity,1,2,2.99,-1
1812560,SUPER CRAZY RHYTHM CASTLE,71,3,39.99,68
2262880,Heli-Cats,3,0,14.99,3
1931010,Spirittea,307,40,19.99,267
2562730,Samawa Idle,185,52,4.99,133
2663270,Endless Maze,4,0,0.99,4
2172180,Howl,12,0,14.99,12
2630300,The Imperial Capital Burns - Muv-Luv Alternative Total Eclipse,24,0,24.99,24
2540460,Faded Stories: Full Moon,6,1,9.99,5
2097620,Dream Knight,42,9,6.99,33
2477010,Ticket to Ride,49,38,14.99,11
2462790,Aether,8,0,4.99,8
2000760,Boiling Point: Road to Hell,49,16,9.99,33
1689500,Dune: Imperium,429,10,22.99,419
2334730,Death Must Die,3664,319,6.99,3345
2295970,UFO ROBOT GRENDIZER – The Feast of the Wolves,171,54,39.99,117
1661630,KarmaZoo,756,35,9.99,721
2060870,Invincible Presents: Atom Eve,149,7,9.99,142
1528970,Gods of the Twilight,15,0,19.99,15
2568930,Ultimate Solitaire Collection,5,0,24.99,5
2113680,The Dot,29,11,14.99,18
1803410,Checkmate Showdown,85,8,19.99,77
2205750,Waifu Fighter -Family Friendly,124,17,7.99,107
2649780,Nightmare Side: The Game,8,0,6.66,8
2392740,Cave Digger 2,4,5,14.99,-1
2305900,GUNFIELD,16,0,2.99,16
2593420,Trading Simulator,10,2,5.99,8
2081310,TOBOR,66,1,14.99,65
1274600,The Last Faith,1236,278,27.99,958
2182640,Countdown Timer,1,1,0.99,0
2541180,G-MODEアーカイブス+ 魔神転生 blind thinker,2,0,15.99,2
2409040,Tribes & Monsters,6,0,4.99,6
1914290,Sociable Soccer 24,40,14,29.99,26
2313160,Hodgepodge Hunch,14,4,4.99,10
1669320,Trash Panda,12,0,9.99,12
1249040,American Arcadia,598,30,19.99,568
2656900,Hot And Lovely : Tease,124,22,3.99,102
2559400,豆丁人 DOUDINGMAN,19,0,3.99,19
1812180,Zipp's Café,60,9,3.99,51
2005160,Naheulbeuk's Dungeon Master,438,170,24.99,268
2439710,Skybreakers,516,83,8.99,433
2445310,Cradles,40,27,3.99,13
2366400,Space Battle Royale,63,1,5.99,62
1320140,Small Saga,640,19,19.99,621
1020790,NARUTO X BORUTO Ultimate Ninja STORM CONNECTIONS,982,1036,59.99,-54
2136740,7th Domain,97,31,11.99,66
1686940,Bopl Battle,1039,21,9.99,1018
1482150,Made Marion,13,1,29.99,12
1170940,Outerstellar,41,3,18.99,38
1644940,Loddlenaut,531,8,19.99,523
2055410,The Kindeman Remedy,110,43,7.99,67
2404510,Lucky Hero,27,4,10.99,23
2254740,Persona 5 Tactica,879,163,59.99,716
1448000,迷离诡夜 blurred weird night,95,26,9.99,69
2433960,Snow Fortress 2,4,0,14.99,4
1627840,Universe For Sale,35,0,14.99,35
2008420,Flashback 2,27,34,39.99,-7
2561500,Tears of Adria,15,0,13.99,15
2668230,Spellarium 10,2,0,9.99,2
2404370,YOHANE THE PARHELION -BLAZE in the DEEPBLUE-,512,39,29.99,473
2621150,Lizard Survivors: Battle for Hyperborea,872,108,0.99,764
1814030,Offroad: Dead Planet,4,0,19.99,4
2667410,Heroes Wanted,86,11,10.99,75
2314820,Hira Hira Hihiru,165,1,24.99,164
2420620,Demon Slayer Shion,80,37,14.99,43
1970450,沙漠花开,27,1,8.99,26
2652930,CTRL+ALT+REPEAT,8,0,4.99,8
2560530,Hidden Cats in Rome,55,0,2.99,55
2144040,Dungeon Golf,39,4,16.99,35
2556160,Cute Farmer Life,54,1,4.99,53
2078350,Bluey: The Videogame,166,40,39.99,126
777390,Flyout,435,37,19.99,398
1592750,Anode Heart,125,2,17.99,123
1170230,Below the Stone,166,25,19.99,141
1844380,Warhammer Age of Sigmar: Realms of Ruin,694,313,59.99,381
2661940,Paradise Architect: Idle Tycoon,7,0,1.99,7
1111080,Ghost Feed,149,14,9.99,135
2503490,廃集落探索,4,3,4.99,1
2360250,Asterix & Obelix Slap Them All! 2,13,1,24.99,12
2675620,zombie sanctuary:Juliet,16,1,1.99,15
2561270,Skibidi Toilet Hero,78,15,1.99,63
2591520,Drunken way to Home,18,3,3.99,15
2392640,exclusion| 間引き,3,0,2.99,3
2661750,小世界模拟器3,4,2,5.99,2
2670770,Jewel Legends: Atlantis,4,0,5.99,4
1848520,Fruit Salad,139,3,1.99,136
2681180,MULTIPLAYER CAVEMEN,34,5,0.99,29
2363000,Apocalypse Run!,7,0,14.99,7
2339480,Thriller Garden,7,0,5.99,7
1677310,In Stars And Time,285,2,19.99,283
1708010,The Expanse: A Telltale Series,110,15,24.99,95
2598930,Game Store Simulator,24,4,4.99,20
2677930,SleepWalk,5,4,6.99,1
2683210,Watermelon Challenge,26,1,2.99,25
2309920,Lost Meridian,7,3,7.99,4
2329300,Ghost Mission,1,0,12.99,1
2600050,Horace Hagfish,4,0,6.99,4
1898500,Worldless,96,6,19.99,90
2453380,Supermarket Security Simulator,8,2,14.99,6
2588110,Playtown,51,17,7.99,34
1500740,Snail Simulator,46,0,1.99,46
2328780,Pro Basketball Manager 2024,19,6,29.99,13
1647920,Valfaris: Mecha Therion,82,2,19.99,80
2615380,The Legend of Yan Loong 1+2,14,0,12.99,14
2477690,SHOVE,5,0,9.99,5
2681920,末世孤镇 Doomsday Lonely town,0,1,3.99,-1
2658490,The Dark Survivors,9,2,0.99,7
2586110,Defenders Guild,2,1,6.99,1
1012570,Knuckle Sandwich,231,31,19.99,200
2529770,Chromosome Evil 2,19,1,19.99,18
2336330,Tower Song,14,0,19.99,14
2153720,Pixel Gun Master,4,1,9.99,3
2673080,Jurassic Park Classic Games Collection,14,4,29.99,10
2594020,Oxytone,4,0,12.99,4
2535780,Witch Cram Sorceries,4,2,6.99,2
2622850,Avium,7,1,9.99,6
2595080,Banana Co.,2,0,2.99,2
2683970,Ground Parkour : First Mission,3,0,4.99,3
2547860,6N23,6,0,0.99,6
2234960,Pygmalion,30,0,4.99,30
2628390,Deep Sleep,4,0,2.99,4
2689260,Super elastic,2,1,1.99,1
2643090,CyVenge,1,0,4.99,1
2589910,Timberman: The Big Adventure,2,0,4.24,2
2231170,Gravity Castle,5,0,11.99,5
2684420,BALL PIT KING 3D,4,0,1.99,4
2592710,The Protean Forest,8,0,8.99,8
2538100,鬼小队 GhostBros,3,2,0.99,1
2672350,Jewel Legends: Tree of Life,1,0,5.39,1
2615120,Falling for Beans,3,0,4.49,3
2642080,Spacecraft Tactics,1,0,7.64,1
2690290,24H Stories: The Blackout,7,2,4.99,5
2686690,Suika Shapes,12,0,2.99,12
1775460,LANDNAV,2,0,24.99,2
2659970,Lucky Mayor,9,2,5.94,7
1491390,Forest Grove,2,3,15.99,-1
1469610,Last Train Home,230,38,33.99,192
2143680,Noctuary,62,11,23.99,51
2680200,三千大世界(Three Thousand Worlds),1,2,8.99,-1
2482130,Final Resistance,27,2,3.19,25
2330210,Labrys,12,0,6.49,12
1949770,Rock Simulator 2,27,2,2.99,25
2409360,Pixel Cafe,17,0,11.69,17
2192790,The Walking Dead: Destinies,60,79,39.99,-19
2134770,SteamWorld Build,144,30,26.99,114
2672770,Hexle,1,0,5.39,1
1723680,LOFI Katana,1,0,13.59,1
2596100,Lycans,5,0,3.59,5
1512830,黑巢姐妹,51,1,10.79,50
2646500,All I Want for Christmas are Subgames,2,0,9.59,2
2004640,Svarog's Dream,86,15,21.0,71
2634760,Rulers of Aden,2,0,1.5,2
2399160,Soulash 2,52,6,16.19,46
2598670,Legend of the archer,10,5,17.99,5
2464400,The Wagadu Chronicles,18,12,19.96,6
2373800,Conclave Virtual Tabletop,16,4,17.99,12
2583320,Warplanes: Air Corp,0,2,14.99,-2
2608400,Regular Spacecraft - Defending the Mothership,5,0,0.99,5
2546690,Tram Simulator Urban Transit,36,29,19.99,7
1906830,While the Iron's Hot,29,6,19.99,23
2701630,Sweet Home: Look and Find Collector's Edition,1,0,5.39,1
2601620,Ungate,4,0,22.49,4
2247760,Revive & Prosper,15,2,17.99,13
2469080,Curse of Blood,80,3,17.99,77
2486740,Sledders,287,6,24.99,281
1567190,Shores of Plunder,6,0,17.99,6
2459180,Praise Dead,13,2,16.99,11
2686980,Planet Suika,1,0,2.54,1
2325770,Snowmen,11,1,4.99,10
2649990,貢がせろ！女苑ちゃん！！,28,1,6.29,27
1224700,Kingpin: Reloaded,68,135,14.99,-67
2089980,Extremely Powerful Capybaras,297,162,5.39,135
2434420,Arashi: Castles of Sin - Final Cut,4,14,29.99,-10
1831830,Chessarama,71,1,13.49,70
1240060,A Highland Song,101,4,16.19,97
2284800,Arms Race 2,7,0,19.99,7
2583830,手積み麻雀,18,5,4.99,13
2663600,溢爱~fragile love,11,1,1.69,10
2565600,Seybul Tech,23,0,3.99,23
2265310,Bug & Seek,31,0,12.74,31
2542470,Chain Reaction,1,0,2.99,1
2494450,The Last Soldier of the Ming Dynasty,89,9,13.49,80
1125510,Snacko,65,0,24.99,65
2414630,Hollow Cocoon,125,19,13.49,106
2289450,Idle Cave Miner,16,13,4.49,3
1268200,Espresso For The Demon,1,0,8.09,1
2659190,Endless Glory,1,0,4.99,1
2703550,Vigaro Runner,11,1,1.19,10
1149000,Monster Loves You Too!,2,0,14.99,2
1540210,Arizona Sunshine® 2,198,70,49.99,128
2715090,HIP GAME,2,1,1.79,1
2693200,Shadow Strike: Street Combat,0,1,5.39,-1
2656690,Sona-Nyl of the Violet Shadows Refrain,7,0,29.74,7
2513140,江华号,42,4,8.99,38
2522060,Stacks:Jungle!,3,0,4.99,3
2618850,Exp10sion,5,0,2.69,5
2186680,"Warhammer 40,000: Rogue Trader",2063,360,49.99,1703
1372880,The Day Before,3506,14077,39.99,-10571
2543050,Anon's Neko Waifus,49,4,3.99,45
1573860,Back Then,5,0,11.69,5
2614970,Blagmoz,1,0,8.49,1
2435600,The Dark Tones: Loss,3,0,4.24,3
1592720,Garbage Crew!,1,0,16.14,1
2562460,SUSHI SOUL UNIVERSE,13,0,5.39,13
2577180,DemonStar - Original Missions,56,4,9.99,52
2084300,Schism,16,0,8.09,16
2583620,"I Hate You, Please Suffer - Complete",4,0,11.04,4
1782670,Tru Or Die: Chiraq,42,18,29.99,24
2680330,HunterX: code name T,24,3,14.44,21
2306780,Spellshot,4,0,8.99,4
2413620,Pogo3D,41,1,6.79,40
2477780,Roguenarok,14,0,4.49,14
1879040,Mycosis,1,0,10.99,1
2685490,Detective Hayseed - The Cloning Madness,50,0,14.99,50
2202950,DarkMatter: The Strange Messenger,2,0,11.89,2
2656740,Endless Furry Tower Defense,3,0,0.89,3
2596670,SPIDER MALL !,16,2,4.49,14
2486930,Dark Riddle,17,0,4.89,17
1782420,Tales from The Dancing Moon,2,0,10.79,2
2475400,Buried Alive: Breathless Rescue,15,7,10.39,8
2152790,UNITED 1944,160,30,23.99,130
2571290,Golf Odyssey 2 DX,1,0,6.99,1
1551000,Captain Pawsome,6,6,11.99,0
2672300,The Castle,3,0,0.99,3
2155180,Pioneers of Pagonia,1105,137,25.49,968
2157560,Granblue Fantasy Versus: Rising,812,195,49.99,617
2361700,Destiny Star Girlfriend,22,1,11.99,21
2537770,Stay Still 2,16,10,3.99,6
2580390,Crossing Frontier: Fate Foretold,105,5,13.49,100
2620380,Art is Boom,6,0,2.99,6
2635070,The Brave Little Cloud,17,0,2.39,17
2642640,精灵幻境  Elven dreams,28,2,0.79,26
2715670,Crack it!,7,0,4.19,7
2614980,Square Logic,10,0,2.39,10
2002570,SeaOrama: World of Shipping,48,50,17.99,-2
2685610,Wanting Wings,5,0,29.74,5
1954720,Tameshi,6,0,4.79,6
1172180,Cosplay Club,15,1,18.99,14
2655390,Siege Island,3,0,4.24,3
2328310,CUSTOM MECH WARS,146,251,44.99,-105
2492030,RBM Studio's Gettysburg,5,0,4.99,5
2697640,Djikstra's Enigmatic Puzzle Cube,3,0,4.01,3
2287520,Five Nights at Freddy's: Help Wanted 2,862,84,39.99,778
2052410,WITCH ON THE HOLY NIGHT,658,13,35.99,645
2716520,CRASH TEST IDIOTS 2 (MULTIPLAYER),5,0,0.69,5
2573610,Roll for Life,4,0,7.19,4
1229890,Koumajou Remilia Ⅱ: Stranger's Requiem,9,0,29.99,9
2679200,幸存者少女/Survivor Girls,101,4,0.87,97
2658810,Katana Robo: RTA,1,1,6.79,0
1578440,QuietMansion1,4,1,2.99,3
1190970,House Flipper 2,1567,311,35.99,1256
2655010,Jewel Match Solitaire Winterscapes 2 - Collector's Edition,3,0,11.89,3
1473350,(the) Gnorp Apologue,267,5,6.29,262
1934900,My Slow Life with the Princess Knight and Her Devoted Handmaiden,26,0,11.99,26
2485890,ConSPYration,1,0,9.99,1
2306530,Reign of the Renegade,5,0,2.99,5
2061620,Mechanic Heroes,6,0,14.39,6
2279220,Diceheart,4,0,14.39,4
2405660,FarWest Colony,1,0,13.59,1
2002010,My Academy's Special Place,10,0,13.49,10
2569610,Turbo Chicken Simulator,14,0,4.99,14
2267990,Simulator Z,2,0,4.99,2
946920,PARANOID,30,48,22.49,-18
2443520,Purrfect Rescue,18,0,1.59,18
2440620,Rocococo ~ Audiogame Fantastique,1,0,7.99,1
2479030,Goliath Depot,28,0,5.94,28
2644520,Nightwatch,8,1,0.99,7
1726750,Hidden Cats in Santa's Realm,38,0,3.19,38
2359800,Medieval Idle: Quest,2,0,6.0,2
2716720,Make it! Takoyaki,2,0,2.99,2
2690580,Luminaria: Dark Echoes,18,0,7.99,18
2707280,Wargame Construction Set III: Age of Rifles 1846-1905,4,0,5.09,4
444570,Ultra Engine Pro,2,0,89.99,2
2164870,Sinister Entity,12,0,7.99,12
2231270,New Stars,1,2,18.89,-1
2583920,Ep.家族,1,3,6.99,-2
2702090,Star Command,2,0,5.09,2
2566020,Raindrop Sprinters,14,0,7.99,14
2520580,Up N' Down,18,4,3.39,14
2702050,Phantasie Memorial Set,2,0,8.49,2
2698590,Mosaic Mysteries,3,0,4.99,3
2593080,Tank Mayhem,4,0,3.99,4
2724810,Oil Coin,5,0,0.74,5
2268560,Zombie Survival Game Online,63,10,14.99,53
2682120,Movie Cinema Simulator,6,0,4.99,6
2685810,Micro macro farm,6,2,2.54,4
2335220,Dolls,7,0,7.19,7
2612220,Cosmic Armada,2,0,15.99,2
2499800,Garten of Banban 6,280,123,9.99,157
2514900,Your Journey of Survival,4,0,10.49,4
2475220,Deidthraw,9,0,4.68,9
2687600,Doppelgänger,5,0,12.99,5
2726740,Don't Text and Drive,2,0,4.99,2
2641350,YoloX - Crosshair Overlay,2,0,5.99,2
2702470,Poly Roam,18,9,9.89,9
2673450,Mr. Sanna Clozz,1,0,14.99,1
2482440,Leap up no Justu: Double,11,0,0.89,11
858030,Paranoia: Happiness is Mandatory,5,5,29.99,0
2704270,Dorasyeoda,4,2,8.49,2
1768650,Path of the Abyss,42,3,5.94,39
2383220,DETECTIVE - Stella Porta case,6,0,9.34,6
2432100,ONE.,57,10,15.99,47
2603740,Atoms and Time,2,0,5.99,2
2437230,Trim For Your Dream,4,0,14.2,4
2689640,Super Cube 3D,10,0,2.54,10
2707090,The Nefargad,4,0,7.99,4
2717080,Merry XMerge,18,0,0.89,18
2723480,GOI Survivors,4,0,4.49,4
2612360,StreamWare,21,0,5.99,21
2499990,The Rumble Fish +,7,0,7.19,7
2259530,A Spider to A Fly,6,0,3.59,6
2240720,NONOTOWN: Nonogram Logic Puzzle,1,0,5.09,1
2723620,DunJumb,0,2,2.54,-2
2727020,Orc's Bride,12,1,4.24,11
1862430,Repurpose,3,0,8.24,3
1212550,"EVECTOR, Acid Thirst",2,0,1.99,2
2661950,魔卡奇旅,3,0,4.99,3
1351480,Barely Racing,7,0,8.99,7
2697380,Arsenal,2,0,1.79,2
2123380,MOBIUS BAND*,5,0,7.64,5
2160220,Shipwrecked 64,71,3,7.99,68
2579540,The Fairway Club,10,1,1.19,9
2730650,逆乱封神之武王伐纣,20,1,2.99,19
1863300,∀stralbringer -Shaded Arkarium-,8,0,8.99,8
2699930,The Penguin Horror : Legacy of The pengcasso,0,6,2.99,-6
2736230,Ski Jump Challenge 2024,2,0,2.99,2
2702960,AdventureQuest 8-Bit: Dungeons & Doomknights,3,0,17.99,3
2699340,Mia's Hunt,15,2,5.99,13
2715790,Horizon of Horus,1,0,8.49,1
2487350,Alex Jones: NWO Wars,596,32,17.76,564
2287140,Mooselutions,13,0,4.99,13
2585110,Last Stand Delivery,46,0,5.94,46
2315020,Froguelike,19,1,2.99,18
2614000,TRAMCITY HAKODATE,6,0,14.99,6
2746630,Holly-Day Ice-Spionage,1,0,2.99,1
2666370,Lumenile: Found Footage,2,0,5.94,2
2596330,Micro Machines: Mini Challenge Mayhem,1,0,14.99,1
2719650,Project XSTING,5,0,7.99,5
2575120,CONTORTED,2,0,4.19,2
2704060,Ant Farm Simulator,1,1,0.99,0
2234690,The Day Before You Gone,11,0,7.64,11
2707500,ROKO'S BASILISK,9,0,1.79,9
2506140,Biohazard: Escape Room,1,1,9.99,0
2674230,I Bring The Chaos,9,0,2.69,9
2708480,Slippery Heights,10,0,4.89,10
2551920,Tools Up! Ultimate Edition,1,0,20.99,1
2710320,THE DESCENT,8,1,6.79,7
2633500,Dragon Throne: Battle of Red Cliffs,4,2,9.99,2
2738420,Backrooms: Eight Levels,1,0,0.74,1
